name	sample_age	pop	node_id	left	right	length
EUR_1	50000	EUR	0	12455894	12699700	243806
EUR_1	50000	EUR	0	25304959	25731778	426819
EUR_1	50000	EUR	0	26667389	26889089	221700
EUR_1	50000	EUR	0	35774588	36942294	1167706
EUR_1	50000	EUR	0	64174838	65117853	943015
EUR_1	50000	EUR	0	79828958	80856293	1027335
EUR_1	50000	EUR	0	87698843	87823295	124452
EUR_1	50000	EUR	0	89932145	90383350	451205
EUR_1	50000	EUR	1	7999419	8520776	521357
EUR_1	50000	EUR	1	10974065	11332170	358105
EUR_1	50000	EUR	1	12455894	13156642	700748
EUR_1	50000	EUR	1	20485822	20599265	113443
EUR_1	50000	EUR	1	25407744	25731778	324034
EUR_1	50000	EUR	1	67901085	68133542	232457
EUR_1	50000	EUR	1	71611713	72144333	532620
EUR_1	50000	EUR	1	98783532	98798033	14501
EUR_2	50000	EUR	2	8592006	8909640	317634
EUR_2	50000	EUR	2	20162666	20173124	10458
EUR_2	50000	EUR	2	71929715	73097619	1167904
EUR_2	50000	EUR	2	79098426	79191610	93184
EUR_2	50000	EUR	2	94793032	95396747	603715
EUR_2	50000	EUR	3	6865	3302065	3295200
EUR_2	50000	EUR	3	4523710	5555919	1032209
EUR_2	50000	EUR	3	28599684	29188175	588491
EUR_2	50000	EUR	3	41130943	41633929	502986
EUR_2	50000	EUR	3	56011576	56446968	435392
EUR_2	50000	EUR	3	91489890	91688404	198514
EUR_3	50000	EUR	4	7165286	7470321	305035
EUR_3	50000	EUR	4	8348919	8909640	560721
EUR_3	50000	EUR	4	23077679	24455017	1377338
EUR_3	50000	EUR	4	24967222	25305885	338663
EUR_3	50000	EUR	4	68601991	70125780	1523789
EUR_3	50000	EUR	4	72541440	72596829	55389
EUR_3	50000	EUR	4	87125883	87705828	579945
EUR_3	50000	EUR	5	684949	857350	172401
EUR_3	50000	EUR	5	5440927	5576022	135095
EUR_3	50000	EUR	5	10937483	11156413	218930
EUR_3	50000	EUR	5	34909866	35541207	631341
EUR_3	50000	EUR	5	36719548	36814684	95136
EUR_3	50000	EUR	5	56058315	57706838	1648523
EUR_3	50000	EUR	5	70549446	71304191	754745
EUR_3	50000	EUR	5	86984356	87823295	838939
EUR_3	50000	EUR	5	88734873	89719463	984590
EUR_3	50000	EUR	5	95774147	96227123	452976
EUR_4	50000	EUR	6	1142397	1997751	855354
EUR_4	50000	EUR	6	23550606	23554604	3998
EUR_4	50000	EUR	6	28599684	29138552	538868
EUR_4	50000	EUR	6	85353810	85649421	295611
EUR_4	50000	EUR	7	22890136	23651476	761340
EUR_4	50000	EUR	7	40298987	40523834	224847
EUR_4	50000	EUR	7	78762072	78790909	28837
EUR_5	50000	EUR	8	26809967	26863999	54032
EUR_5	50000	EUR	8	27746608	27997414	250806
EUR_5	50000	EUR	8	32694491	32768500	74009
EUR_5	50000	EUR	8	35883169	36885261	1002092
EUR_5	50000	EUR	8	65567788	66414533	846745
EUR_5	50000	EUR	9	12952250	13216293	264043
EUR_5	50000	EUR	9	21228299	21920356	692057
EUR_5	50000	EUR	9	23772307	25731778	1959471
EUR_5	50000	EUR	9	29201955	29396318	194363
EUR_5	50000	EUR	9	35697287	36846068	1148781
EUR_5	50000	EUR	9	71303321	71532195	228874
EUR_5	50000	EUR	9	84235412	84530742	295330
EUR_5	50000	EUR	9	90909358	91107582	198224
EUR_5	50000	EUR	9	96015399	96050085	34686
EUR_6	50000	EUR	10	32694491	32768500	74009
EUR_6	50000	EUR	10	39437446	39654799	217353
EUR_6	50000	EUR	10	88734873	90328288	1593415
EUR_6	50000	EUR	11	22005059	22637111	632052
EUR_6	50000	EUR	11	26986341	27055126	68785
EUR_6	50000	EUR	11	35796202	36507341	711139
EUR_6	50000	EUR	11	59061666	59762964	701298
EUR_6	50000	EUR	11	72146650	72290466	143816
EUR_6	50000	EUR	11	88734873	89766100	1031227
EUR_7	50000	EUR	12	5543034	6025803	482769
EUR_7	50000	EUR	12	31938761	32278572	339811
EUR_7	50000	EUR	12	49302638	49898958	596320
EUR_7	50000	EUR	12	54967512	56624815	1657303
EUR_7	50000	EUR	12	63341405	63344129	2724
EUR_7	50000	EUR	12	73808657	73981061	172404
EUR_7	50000	EUR	12	75781447	75948788	167341
EUR_7	50000	EUR	12	81419681	81607972	188291
EUR_7	50000	EUR	12	94793032	95396747	603715
EUR_7	50000	EUR	13	8848268	8909640	61372
EUR_7	50000	EUR	13	40297002	40339895	42893
EUR_7	50000	EUR	13	57712252	57974650	262398
EUR_7	50000	EUR	13	63714218	63908421	194203
EUR_8	50000	EUR	14	12455894	13156642	700748
EUR_8	50000	EUR	14	26986341	27716114	729773
EUR_8	50000	EUR	14	32694491	32768500	74009
EUR_8	50000	EUR	14	54645953	55024910	378957
EUR_8	50000	EUR	14	57198020	57706838	508818
EUR_8	50000	EUR	14	69577852	69638268	60416
EUR_8	50000	EUR	14	86285788	86556609	270821
EUR_8	50000	EUR	14	89202302	89225608	23306
EUR_8	50000	EUR	15	22005059	22536537	531478
EUR_8	50000	EUR	15	36619904	36698110	78206
EUR_8	50000	EUR	15	78439568	79648704	1209136
EUR_8	50000	EUR	15	86620325	87994899	1374574
EUR_9	50000	EUR	16	28327358	28576232	248874
EUR_9	50000	EUR	16	31547196	32051918	504722
EUR_9	50000	EUR	16	57427875	57706838	278963
EUR_9	50000	EUR	16	70928962	71081876	152914
EUR_9	50000	EUR	16	80935070	80986119	51049
EUR_9	50000	EUR	17	24807176	24866754	59578
EUR_9	50000	EUR	17	26749607	26895139	145532
EUR_9	50000	EUR	17	58569405	58694180	124775
EUR_9	50000	EUR	17	80866714	80867293	579
EUR_9	50000	EUR	17	85367233	86136701	769468
EUR_10	50000	EUR	18	2993729	4123228	1129499
EUR_10	50000	EUR	18	26986341	27716114	729773
EUR_10	50000	EUR	18	31985391	32168105	182714
EUR_10	50000	EUR	18	37368801	37983516	614715
EUR_10	50000	EUR	19	21228299	21920356	692057
EUR_10	50000	EUR	19	26411251	26863999	452748
EUR_10	50000	EUR	19	27746608	28033630	287022
EUR_10	50000	EUR	19	78092945	78221412	128467
EUR_11	50000	EUR	20	23432743	23651476	218733
EUR_11	50000	EUR	20	25730527	25852151	121624
EUR_11	50000	EUR	20	72171504	72213215	41711
EUR_11	50000	EUR	20	95174914	95723327	548413
EUR_11	50000	EUR	21	21113467	21972577	859110
EUR_11	50000	EUR	21	28324936	29052469	727533
EUR_11	50000	EUR	21	37932960	38168235	235275
EUR_11	50000	EUR	21	39269317	39808969	539652
EUR_11	50000	EUR	21	58506025	59299694	793669
EUR_11	50000	EUR	21	80182020	80986119	804099
EUR_11	50000	EUR	21	96015399	96619459	604060
EUR_12	50000	EUR	22	39671814	41316307	1644493
EUR_12	50000	EUR	22	44246361	44458750	212389
EUR_12	50000	EUR	22	67296718	67497662	200944
EUR_12	50000	EUR	22	67911516	68606301	694785
EUR_12	50000	EUR	22	79602714	79997687	394973
EUR_12	50000	EUR	22	92695441	92968521	273080
EUR_12	50000	EUR	22	93228855	95947502	2718647
EUR_12	50000	EUR	22	97514544	97628882	114338
EUR_12	50000	EUR	23	18210663	18396738	186075
EUR_12	50000	EUR	23	20190991	21156082	965091
EUR_12	50000	EUR	23	33461740	33673298	211558
EUR_12	50000	EUR	23	34845302	36869887	2024585
EUR_12	50000	EUR	23	58037974	58068519	30545
EUR_12	50000	EUR	23	70928962	71081876	152914
EUR_13	50000	EUR	24	64078243	64696403	618160
EUR_13	50000	EUR	24	77899371	77990492	91121
EUR_13	50000	EUR	24	81659632	81700533	40901
EUR_13	50000	EUR	24	89990035	90140445	150410
EUR_13	50000	EUR	25	10770620	11000864	230244
EUR_13	50000	EUR	25	28599684	29188175	588491
EUR_13	50000	EUR	25	64078243	64696403	618160
EUR_13	50000	EUR	25	82106246	82340897	234651
EUR_13	50000	EUR	25	89038169	89445720	407551
EUR_13	50000	EUR	25	90068526	90256768	188242
EUR_13	50000	EUR	25	99176254	99505504	329250
EUR_14	50000	EUR	26	42168822	42350688	181866
EUR_14	50000	EUR	26	43339317	43554072	214755
EUR_14	50000	EUR	26	55490787	56381884	891097
EUR_14	50000	EUR	26	86285788	87276505	990717
EUR_14	50000	EUR	27	1528788	1806727	277939
EUR_14	50000	EUR	27	10997729	11830975	833246
EUR_14	50000	EUR	27	13429221	13748448	319227
EUR_14	50000	EUR	27	17567972	18377402	809430
EUR_14	50000	EUR	27	55435423	56145360	709937
EUR_14	50000	EUR	27	67296718	67497662	200944
EUR_14	50000	EUR	27	68189875	68440127	250252
EUR_14	50000	EUR	27	89932145	92984341	3052196
EUR_15	50000	EUR	28	21244923	21324321	79398
EUR_15	50000	EUR	28	64078243	64696403	618160
EUR_15	50000	EUR	28	77899371	77990492	91121
EUR_15	50000	EUR	28	81659632	81700533	40901
EUR_15	50000	EUR	28	89990035	90140445	150410
EUR_15	50000	EUR	29	8502320	10926883	2424563
EUR_15	50000	EUR	29	12669763	13114734	444971
EUR_15	50000	EUR	29	24292148	24554402	262254
EUR_15	50000	EUR	29	31807358	31937261	129903
EUR_15	50000	EUR	29	33283624	33673298	389674
EUR_15	50000	EUR	29	37589400	38248030	658630
EUR_15	50000	EUR	29	51094505	52382432	1287927
EUR_15	50000	EUR	29	70669584	70937515	267931
EUR_15	50000	EUR	29	72347404	72373817	26413
EUR_15	50000	EUR	29	74289000	74903617	614617
EUR_15	50000	EUR	29	80355059	80381612	26553
EUR_15	50000	EUR	29	80602259	82004020	1401761
EUR_15	50000	EUR	29	96015399	96050085	34686
EUR_16	50000	EUR	30	26741734	26877751	136017
EUR_16	50000	EUR	30	29306591	29766792	460201
EUR_16	50000	EUR	30	93132291	93674966	542675
EUR_16	50000	EUR	30	95774147	96423009	648862
EUR_16	50000	EUR	31	13247857	14112508	864651
EUR_16	50000	EUR	31	22002114	22379522	377408
EUR_16	50000	EUR	31	64078243	64696403	618160
EUR_16	50000	EUR	31	81783325	82283340	500015
EUR_16	50000	EUR	31	93308720	94373672	1064952
EUR_17	50000	EUR	32	16013975	16157361	143386
EUR_17	50000	EUR	32	32694491	32768500	74009
EUR_17	50000	EUR	32	36257557	36622271	364714
EUR_17	50000	EUR	32	86713318	89227874	2514556
EUR_17	50000	EUR	33	0	285577	285577
EUR_17	50000	EUR	33	6094149	6338989	244840
EUR_17	50000	EUR	33	30954937	31304365	349428
EUR_17	50000	EUR	33	43254515	43262874	8359
EUR_17	50000	EUR	33	51256838	51431075	174237
EUR_17	50000	EUR	33	51732714	52024981	292267
EUR_17	50000	EUR	33	78385878	78600733	214855
EUR_17	50000	EUR	33	86700294	87210177	509883
EUR_17	50000	EUR	33	90862942	91345303	482361
EUR_18	50000	EUR	34	8502320	10926883	2424563
EUR_18	50000	EUR	34	12669763	13114734	444971
EUR_18	50000	EUR	34	57777714	58305211	527497
EUR_18	50000	EUR	34	64078243	64696403	618160
EUR_18	50000	EUR	34	68898471	69061081	162610
EUR_18	50000	EUR	34	80878309	80986119	107810
EUR_18	50000	EUR	34	86765345	86850001	84656
EUR_18	50000	EUR	34	98296025	98387947	91922
EUR_18	50000	EUR	35	22890136	23651476	761340
EUR_18	50000	EUR	35	26038717	26660045	621328
EUR_18	50000	EUR	35	31985391	32168105	182714
EUR_18	50000	EUR	35	70549446	71304191	754745
EUR_18	50000	EUR	35	72802907	73223816	420909
EUR_18	50000	EUR	35	75781447	76003284	221837
EUR_18	50000	EUR	35	84235412	84530742	295330
EUR_19	50000	EUR	36	77533136	79323614	1790478
EUR_19	50000	EUR	36	80993386	81157653	164267
EUR_19	50000	EUR	36	91489890	91688404	198514
EUR_19	50000	EUR	37	4486366	4618180	131814
EUR_19	50000	EUR	37	4977333	5017209	39876
EUR_19	50000	EUR	37	6128689	6338989	210300
EUR_19	50000	EUR	37	18303569	18368143	64574
EUR_19	50000	EUR	37	28327358	28576232	248874
EUR_19	50000	EUR	37	29401920	30687839	1285919
EUR_19	50000	EUR	37	30993569	31480006	486437
EUR_19	50000	EUR	37	31983216	33673298	1690082
EUR_19	50000	EUR	37	55435423	56145360	709937
EUR_19	50000	EUR	37	80355059	80381612	26553
EUR_19	50000	EUR	37	80602259	82004020	1401761
EUR_19	50000	EUR	37	88294036	88819650	525614
EUR_20	50000	EUR	38	11683865	11777661	93796
EUR_20	50000	EUR	38	12055753	13178737	1122984
EUR_20	50000	EUR	38	20190991	21561649	1370658
EUR_20	50000	EUR	38	67296718	67327241	30523
EUR_20	50000	EUR	38	81014143	82323436	1309293
EUR_20	50000	EUR	38	94220766	95634605	1413839
EUR_20	50000	EUR	39	24372241	26877751	2505510
EUR_20	50000	EUR	39	79006786	79707517	700731
EUR_21	50000	EUR	41	17427693	18368143	940450
EUR_21	50000	EUR	41	21877391	22557581	680190
EUR_21	50000	EUR	41	25857533	26142104	284571
EUR_21	50000	EUR	41	64808078	64818736	10658
EUR_21	50000	EUR	41	95681298	96331336	650038
EUR_22	50000	EUR	42	5170093	5620454	450361
EUR_22	50000	EUR	42	12905849	13166413	260564
EUR_22	50000	EUR	42	75260173	75950242	690069
EUR_22	50000	EUR	42	82143893	82340897	197004
EUR_22	50000	EUR	43	1328568	1465384	136816
EUR_22	50000	EUR	43	12428962	13316745	887783
EUR_22	50000	EUR	43	18866108	19107360	241252
EUR_22	50000	EUR	43	22304710	22387140	82430
EUR_22	50000	EUR	43	32694491	33054553	360062
EUR_22	50000	EUR	43	37589400	38248030	658630
EUR_23	50000	EUR	44	43183519	44295790	1112271
EUR_23	50000	EUR	44	68212528	69082650	870122
EUR_23	50000	EUR	44	76167502	76403656	236154
EUR_23	50000	EUR	45	6420328	6466588	46260
EUR_23	50000	EUR	45	32694491	32768500	74009
EUR_23	50000	EUR	45	40297002	40711140	414138
EUR_23	50000	EUR	45	78246564	78406487	159923
EUR_23	50000	EUR	45	80589917	80986119	396202
EUR_24	50000	EUR	46	23602808	24757234	1154426
EUR_24	50000	EUR	46	74441944	74738891	296947
EUR_24	50000	EUR	46	76558352	78659108	2100756
EUR_24	50000	EUR	47	32993432	33376721	383289
EUR_24	50000	EUR	47	42922160	43144641	222481
EUR_24	50000	EUR	47	72917067	73288715	371648
EUR_25	50000	EUR	48	21113467	21282925	169458
EUR_25	50000	EUR	48	32173113	32330889	157776
EUR_25	50000	EUR	48	78991702	79037415	45713
EUR_25	50000	EUR	48	98750261	99516606	766345
EUR_25	50000	EUR	49	1528788	1983081	454293
EUR_25	50000	EUR	49	54378036	54730663	352627
EUR_25	50000	EUR	49	87683482	89992844	2309362
EUR_25	50000	EUR	49	93539368	94318951	779583
EUR_25	50000	EUR	49	96195614	96591849	396235
EUR_26	50000	EUR	50	16013975	16157361	143386
EUR_26	50000	EUR	50	47819349	48530069	710720
EUR_26	50000	EUR	50	71817828	72154470	336642
EUR_26	50000	EUR	50	81245111	81606934	361823
EUR_26	50000	EUR	50	94094392	95051177	956785
EUR_26	50000	EUR	50	96460962	96851018	390056
EUR_26	50000	EUR	50	99176254	99684646	508392
EUR_26	50000	EUR	51	6865	1300519	1293654
EUR_26	50000	EUR	51	23889267	24121931	232664
EUR_26	50000	EUR	51	32694491	33407924	713433
EUR_26	50000	EUR	51	76401037	76695469	294432
EUR_26	50000	EUR	51	80447518	80532385	84867
EUR_26	50000	EUR	51	80602259	81085023	482764
EUR_27	50000	EUR	52	31807358	31937261	129903
EUR_27	50000	EUR	52	40580630	40599837	19207
EUR_27	50000	EUR	52	44498222	44535887	37665
EUR_27	50000	EUR	52	78096571	78140074	43503
EUR_27	50000	EUR	52	93308720	93978835	670115
EUR_27	50000	EUR	52	96090157	96345935	255778
EUR_27	50000	EUR	53	5990139	6961539	971400
EUR_27	50000	EUR	53	86285788	87719881	1434093
EUR_27	50000	EUR	53	90384145	90594578	210433
EUR_27	50000	EUR	53	92706169	93500620	794451
EUR_27	50000	EUR	53	93870672	94559172	688500
EUR_28	50000	EUR	54	1557211	1715571	158360
EUR_28	50000	EUR	54	37589400	38248030	658630
EUR_28	50000	EUR	54	81008192	81109930	101738
EUR_28	50000	EUR	54	94220766	94257253	36487
EUR_28	50000	EUR	54	96553839	96591849	38010
EUR_28	50000	EUR	55	10935726	11303745	368019
EUR_28	50000	EUR	55	39437446	39891106	453660
EUR_28	50000	EUR	55	64045063	65117853	1072790
EUR_28	50000	EUR	55	70676188	71444791	768603
EUR_28	50000	EUR	55	72372046	72582106	210060
EUR_28	50000	EUR	55	80447518	80532385	84867
EUR_28	50000	EUR	55	80602259	80858762	256503
EUR_29	50000	EUR	56	5728133	5817247	89114
EUR_29	50000	EUR	56	58118069	58305211	187142
EUR_29	50000	EUR	56	91564790	92171686	606896
EUR_29	50000	EUR	57	8592006	8909640	317634
EUR_29	50000	EUR	57	32694491	32768500	74009
EUR_29	50000	EUR	57	40861764	42210627	1348863
EUR_29	50000	EUR	57	77450400	77659441	209041
EUR_29	50000	EUR	57	81028646	81178805	150159
EUR_29	50000	EUR	57	86713318	88503315	1789997
EUR_29	50000	EUR	57	90862942	91345303	482361
EUR_30	50000	EUR	58	25863463	26211273	347810
EUR_30	50000	EUR	58	64078243	64696403	618160
EUR_30	50000	EUR	58	81160736	82323436	1162700
EUR_30	50000	EUR	58	91219314	91378194	158880
EUR_30	50000	EUR	59	1629698	2784114	1154416
EUR_30	50000	EUR	59	13247857	14112508	864651
EUR_30	50000	EUR	59	20981647	21120817	139170
EUR_30	50000	EUR	59	26411251	26734249	322998
EUR_30	50000	EUR	59	73066846	73794632	727786
EUR_31	50000	EUR	60	4739531	5312534	573003
EUR_31	50000	EUR	60	36257557	36622271	364714
EUR_31	50000	EUR	60	64562953	64696403	133450
EUR_31	50000	EUR	60	75644076	76677983	1033907
EUR_31	50000	EUR	60	77527179	77697806	170627
EUR_31	50000	EUR	61	27090812	27385544	294732
EUR_31	50000	EUR	61	60914146	61011065	96919
EUR_31	50000	EUR	61	89932145	91107582	1175437
EUR_31	50000	EUR	61	96015399	96050085	34686
EUR_32	50000	EUR	62	1557211	1715571	158360
EUR_32	50000	EUR	62	37589400	38248030	658630
EUR_32	50000	EUR	62	75644076	76358702	714626
EUR_32	50000	EUR	62	79828958	80856293	1027335
EUR_32	50000	EUR	62	95774147	96448413	674266
EUR_32	50000	EUR	63	4739531	5155667	416136
EUR_32	50000	EUR	63	11770044	11830975	60931
EUR_32	50000	EUR	63	21513176	21540757	27581
EUR_32	50000	EUR	63	90135034	92192218	2057184
EUR_33	50000	EUR	64	16113731	16497900	384169
EUR_33	50000	EUR	64	27746608	27876877	130269
EUR_33	50000	EUR	64	67296718	67497662	200944
EUR_33	50000	EUR	64	73376774	73629304	252530
EUR_33	50000	EUR	64	76393025	77315097	922072
EUR_33	50000	EUR	64	84235412	84530742	295330
EUR_33	50000	EUR	64	94891864	95228489	336625
EUR_33	50000	EUR	64	96553839	96591849	38010
EUR_33	50000	EUR	65	80182020	81040185	858165
EUR_33	50000	EUR	65	82039424	82283340	243916
EUR_33	50000	EUR	65	87727929	88600577	872648
EUR_34	50000	EUR	66	460268	699056	238788
EUR_34	50000	EUR	66	17938233	18285211	346978
EUR_34	50000	EUR	66	25537529	27819920	2282391
EUR_34	50000	EUR	66	28223945	28897308	673363
EUR_34	50000	EUR	66	39857074	39866148	9074
EUR_34	50000	EUR	66	58506025	59299694	793669
EUR_34	50000	EUR	66	81028646	81178805	150159
EUR_34	50000	EUR	66	93447577	93467052	19475
EUR_34	50000	EUR	67	5543034	6025803	482769
EUR_34	50000	EUR	67	6316331	6338989	22658
EUR_34	50000	EUR	67	29540548	30687839	1147291
EUR_34	50000	EUR	67	80466002	80714963	248961
EUR_35	50000	EUR	68	1142397	1997751	855354
EUR_35	50000	EUR	68	9644766	9873518	228752
EUR_35	50000	EUR	68	26871247	27385544	514297
EUR_35	50000	EUR	68	48753064	49064202	311138
EUR_35	50000	EUR	68	51868034	52440869	572835
EUR_35	50000	EUR	68	73830661	74518736	688075
EUR_35	50000	EUR	68	80918991	82323436	1404445
EUR_35	50000	EUR	68	91219314	91224133	4819
EUR_35	50000	EUR	68	99176254	1e+08	823746
EUR_35	50000	EUR	69	13247857	14112508	864651
EUR_35	50000	EUR	69	18511224	18671660	160436
EUR_35	50000	EUR	69	30674307	31218680	544373
EUR_35	50000	EUR	69	43254515	43554072	299557
EUR_35	50000	EUR	69	73830661	73859896	29235
EUR_35	50000	EUR	69	86620325	87994899	1374574
EUR_35	50000	EUR	69	96255802	96331336	75534
EUR_36	50000	EUR	70	25312993	25421081	108088
EUR_36	50000	EUR	70	32694491	32768500	74009
EUR_36	50000	EUR	70	73717416	74200210	482794
EUR_36	50000	EUR	70	75644076	76396815	752739
EUR_36	50000	EUR	70	79330409	79374345	43936
EUR_36	50000	EUR	70	96738484	97015086	276602
EUR_36	50000	EUR	70	98795679	99147629	351950
EUR_36	50000	EUR	71	17097270	17249592	152322
EUR_36	50000	EUR	71	33461740	33673298	211558
EUR_36	50000	EUR	71	34845302	36869887	2024585
EUR_36	50000	EUR	71	51604853	51701666	96813
EUR_36	50000	EUR	71	89038169	89445720	407551
EUR_37	50000	EUR	72	6420328	6500389	80061
EUR_37	50000	EUR	72	12428962	14763767	2334805
EUR_37	50000	EUR	72	34909866	35211346	301480
EUR_37	50000	EUR	72	51868034	52662927	794893
EUR_37	50000	EUR	72	56312000	57706838	1394838
EUR_37	50000	EUR	72	94220766	95391029	1170263
EUR_37	50000	EUR	73	7165286	7470321	305035
EUR_37	50000	EUR	73	8348919	8909640	560721
EUR_37	50000	EUR	73	44246361	44458750	212389
EUR_37	50000	EUR	73	47141151	47150742	9591
EUR_37	50000	EUR	73	52422643	52440869	18226
EUR_37	50000	EUR	73	75781447	76098663	317216
EUR_37	50000	EUR	73	78423267	79374345	951078
EUR_37	50000	EUR	73	87205044	87823295	618251
EUR_37	50000	EUR	73	92597397	92968521	371124
EUR_37	50000	EUR	73	93228855	93518992	290137
EUR_38	50000	EUR	74	2212128	3095754	883626
EUR_38	50000	EUR	74	26449599	26540201	90602
EUR_38	50000	EUR	74	36658365	36889331	230966
EUR_38	50000	EUR	74	71060329	71077824	17495
EUR_38	50000	EUR	74	83314965	83409861	94896
EUR_38	50000	EUR	74	89823186	90328288	505102
EUR_38	50000	EUR	74	93601452	93725532	124080
EUR_38	50000	EUR	75	4486366	4728459	242093
EUR_38	50000	EUR	75	17938233	18364781	426548
EUR_38	50000	EUR	75	18866108	19107360	241252
EUR_38	50000	EUR	75	25141713	25706789	565076
EUR_38	50000	EUR	75	26871247	27385544	514297
EUR_38	50000	EUR	75	40658738	40954211	295473
EUR_38	50000	EUR	75	67296718	67477254	180536
EUR_38	50000	EUR	75	71929715	72094655	164940
EUR_38	50000	EUR	75	86268104	88090062	1821958
EUR_38	50000	EUR	75	89044091	89292193	248102
EUR_39	50000	EUR	76	22304710	22442919	138209
EUR_39	50000	EUR	76	32694491	33410456	715965
EUR_39	50000	EUR	76	35107867	35815774	707907
EUR_39	50000	EUR	76	52268650	52420473	151823
EUR_39	50000	EUR	76	76846597	77315097	468500
EUR_39	50000	EUR	77	39983910	40603527	619617
EUR_39	50000	EUR	77	49702405	50246703	544298
EUR_39	50000	EUR	77	54023707	55209498	1185791
EUR_39	50000	EUR	77	89936235	90328288	392053
EUR_39	50000	EUR	77	95537399	95877401	340002
EUR_40	50000	EUR	78	26738079	27685286	947207
EUR_40	50000	EUR	78	31248747	31480006	231259
EUR_40	50000	EUR	78	31983216	33673298	1690082
EUR_40	50000	EUR	78	43090534	43221498	130964
EUR_40	50000	EUR	78	79816933	79936163	119230
EUR_40	50000	EUR	78	80355059	80381612	26553
EUR_40	50000	EUR	78	80602259	80719839	117580
EUR_40	50000	EUR	79	7999419	8909640	910221
EUR_40	50000	EUR	79	22890136	23651476	761340
EUR_40	50000	EUR	79	52350937	52556510	205573
EUR_40	50000	EUR	79	73426693	74894620	1467927
EUR_40	50000	EUR	79	96553839	96591849	38010
EUR_41	50000	EUR	80	78035358	78790909	755551
EUR_41	50000	EUR	80	82176864	82204112	27248
EUR_41	50000	EUR	80	85353810	85971472	617662
EUR_41	50000	EUR	81	23304091	23409450	105359
EUR_41	50000	EUR	81	30294716	30331598	36882
EUR_41	50000	EUR	81	48224943	48530069	305126
EUR_41	50000	EUR	81	58959385	59042592	83207
EUR_41	50000	EUR	81	71209848	71866839	656991
EUR_41	50000	EUR	81	94524674	94569133	44459
EUR_41	50000	EUR	81	98345996	98803153	457157
EUR_42	50000	EUR	82	52435491	52485956	50465
EUR_42	50000	EUR	82	64813686	64818736	5050
EUR_42	50000	EUR	82	75211239	75243411	32172
EUR_42	50000	EUR	83	8502320	8568973	66653
EUR_42	50000	EUR	83	20013527	20069676	56149
EUR_42	50000	EUR	83	42497953	42727569	229616
EUR_42	50000	EUR	83	76558352	77801707	1243355
EUR_43	50000	EUR	84	23077679	24094078	1016399
EUR_43	50000	EUR	84	24969231	25731778	762547
EUR_43	50000	EUR	84	26667389	26889089	221700
EUR_43	50000	EUR	84	56011576	56915001	903425
EUR_43	50000	EUR	84	65489038	66100753	611715
EUR_43	50000	EUR	84	79108068	79108734	666
EUR_43	50000	EUR	84	95774147	96448413	674266
EUR_43	50000	EUR	85	22890136	23651476	761340
EUR_43	50000	EUR	85	25730527	25852151	121624
EUR_43	50000	EUR	85	26411251	26516952	105701
EUR_43	50000	EUR	85	30954937	31099863	144926
EUR_43	50000	EUR	85	31938761	32113173	174412
EUR_43	50000	EUR	85	32694491	32959126	264635
EUR_43	50000	EUR	85	36409566	36754568	345002
EUR_44	50000	EUR	86	71110565	71444791	334226
EUR_44	50000	EUR	86	73830661	74064274	233613
EUR_44	50000	EUR	86	92903272	93888342	985070
EUR_44	50000	EUR	87	7165286	7246285	80999
EUR_44	50000	EUR	87	13247857	14112508	864651
EUR_44	50000	EUR	87	68624378	68906948	282570
EUR_44	50000	EUR	87	86636029	90082371	3446342
EUR_44	50000	EUR	87	94220766	95634605	1413839
EUR_44	50000	EUR	87	98008262	98040274	32012
EUR_45	50000	EUR	88	17567972	18377402	809430
EUR_45	50000	EUR	88	35091227	35315687	224460
EUR_45	50000	EUR	89	18210663	18396738	186075
EUR_45	50000	EUR	89	72605123	72653627	48504
EUR_46	50000	EUR	90	4020191	4334701	314510
EUR_46	50000	EUR	90	20724030	22531602	1807572
EUR_46	50000	EUR	90	22941567	23393673	452106
EUR_46	50000	EUR	90	49702405	49899399	196994
EUR_46	50000	EUR	90	59209233	59299694	90461
EUR_46	50000	EUR	90	64078243	64696403	618160
EUR_46	50000	EUR	90	71645547	72154470	508923
EUR_46	50000	EUR	90	82077651	82283340	205689
EUR_46	50000	EUR	90	89302860	90082371	779511
EUR_46	50000	EUR	91	1557211	2678972	1121761
EUR_46	50000	EUR	91	25312993	25745738	432745
EUR_46	50000	EUR	91	89843090	89919245	76155
EUR_46	50000	EUR	91	90003415	90328288	324873
EUR_47	50000	EUR	92	67423032	67497662	74630
EUR_47	50000	EUR	92	80182020	80733314	551294
EUR_47	50000	EUR	92	95587728	96331336	743608
EUR_47	50000	EUR	93	0	1426634	1426634
EUR_47	50000	EUR	93	24454628	24533995	79367
EUR_47	50000	EUR	93	28607292	28862931	255639
EUR_47	50000	EUR	93	57701865	57706838	4973
EUR_47	50000	EUR	93	63623102	63832686	209584
EUR_47	50000	EUR	93	71454555	72408079	953524
EUR_47	50000	EUR	93	75302971	76131519	828548
EUR_48	50000	EUR	94	9619874	10954432	1334558
EUR_48	50000	EUR	94	23772307	23860494	88187
EUR_48	50000	EUR	94	25312993	26126773	813780
EUR_48	50000	EUR	94	31478668	32942215	1463547
EUR_48	50000	EUR	94	35326448	35380115	53667
EUR_48	50000	EUR	94	51604853	51701666	96813
EUR_48	50000	EUR	94	57427875	57706838	278963
EUR_48	50000	EUR	95	11683865	11777661	93796
EUR_48	50000	EUR	95	12055753	13178737	1122984
EUR_48	50000	EUR	95	77450400	77659441	209041
EUR_48	50000	EUR	95	81028646	81178805	150159
EUR_48	50000	EUR	95	94220766	94259270	38504
EUR_48	50000	EUR	95	96553839	96591849	38010
EUR_49	50000	EUR	96	43085073	43149867	64794
EUR_49	50000	EUR	96	77235694	78659108	1423414
EUR_49	50000	EUR	96	94220766	94257253	36487
EUR_49	50000	EUR	96	96553839	96591849	38010
EUR_49	50000	EUR	97	13474225	13699487	225262
EUR_49	50000	EUR	97	32694491	32768500	74009
EUR_49	50000	EUR	97	44498222	44580721	82499
EUR_49	50000	EUR	97	65392350	65937821	545471
EUR_49	50000	EUR	97	76156948	76303464	146516
EUR_49	50000	EUR	97	80355059	80690660	335601
EUR_49	50000	EUR	97	92597397	92968521	371124
EUR_49	50000	EUR	97	93228855	96331336	3102481
EUR_50	50000	EUR	98	26880887	27326660	445773
EUR_50	50000	EUR	98	29833279	31377755	1544476
EUR_50	50000	EUR	98	54378036	54730663	352627
EUR_50	50000	EUR	98	96575801	97730711	1154910
EUR_50	50000	EUR	99	4172879	4711988	539109
EUR_50	50000	EUR	99	29409480	29766792	357312
EUR_50	50000	EUR	99	37589400	38293746	704346
EUR_50	50000	EUR	99	63887483	64406168	518685
EUR_50	50000	EUR	99	70928962	71081876	152914
EUR_51	40000	EUR	104	1353749	1512555	158806
EUR_51	40000	EUR	104	3763591	4134871	371280
EUR_51	40000	EUR	104	7193443	7246285	52842
EUR_51	40000	EUR	104	25325282	25351680	26398
EUR_51	40000	EUR	104	25454373	25731778	277405
EUR_51	40000	EUR	104	30985114	31015993	30879
EUR_51	40000	EUR	104	39806575	40087247	280672
EUR_51	40000	EUR	104	41017185	41024488	7303
EUR_51	40000	EUR	104	53559986	53570384	10398
EUR_51	40000	EUR	104	57210470	57291065	80595
EUR_51	40000	EUR	104	59520753	59626312	105559
EUR_51	40000	EUR	104	64049018	64195652	146634
EUR_51	40000	EUR	104	80161288	80278256	116968
EUR_51	40000	EUR	104	89683917	89979518	295601
EUR_51	40000	EUR	105	0	458986	458986
EUR_51	40000	EUR	105	1735950	2633469	897519
EUR_51	40000	EUR	105	5636439	5714839	78400
EUR_51	40000	EUR	105	13642509	13716216	73707
EUR_51	40000	EUR	105	23432743	23554604	121861
EUR_51	40000	EUR	105	25385795	25600157	214362
EUR_51	40000	EUR	105	31087987	31207166	119179
EUR_51	40000	EUR	105	31482381	31618309	135928
EUR_51	40000	EUR	105	52201202	52662927	461725
EUR_51	40000	EUR	105	57427875	57493786	65911
EUR_51	40000	EUR	105	57712252	57800472	88220
EUR_51	40000	EUR	105	68996935	69082650	85715
EUR_51	40000	EUR	105	75089161	75282527	193366
EUR_51	40000	EUR	105	77683499	77700986	17487
EUR_51	40000	EUR	105	78024433	78037381	12948
EUR_51	40000	EUR	105	79540256	79765225	224969
EUR_51	40000	EUR	105	87430114	87703960	273846
EUR_51	40000	EUR	105	88129452	88600577	471125
EUR_51	40000	EUR	105	88604072	88762816	158744
EUR_51	40000	EUR	105	95635926	95680595	44669
EUR_52	40000	EUR	106	1330157	1426634	96477
EUR_52	40000	EUR	106	8702684	8714283	11599
EUR_52	40000	EUR	106	25189085	25461211	272126
EUR_52	40000	EUR	106	32694491	32759145	64654
EUR_52	40000	EUR	106	63714218	63791798	77580
EUR_52	40000	EUR	106	65667212	65771518	104306
EUR_52	40000	EUR	106	70541408	70544348	2940
EUR_52	40000	EUR	106	79217313	79266344	49031
EUR_52	40000	EUR	106	87964655	88129782	165127
EUR_52	40000	EUR	106	89811259	90328288	517029
EUR_52	40000	EUR	106	91490500	91688404	197904
EUR_52	40000	EUR	106	92839624	93118749	279125
EUR_52	40000	EUR	107	4458174	4723754	265580
EUR_52	40000	EUR	107	8702684	8714283	11599
EUR_52	40000	EUR	107	9180036	9221404	41368
EUR_52	40000	EUR	107	11790082	12146779	356697
EUR_52	40000	EUR	107	29321833	29396318	74485
EUR_52	40000	EUR	107	31337719	31423113	85394
EUR_52	40000	EUR	107	35546975	35644241	97266
EUR_52	40000	EUR	107	54113043	54312072	199029
EUR_52	40000	EUR	107	86780633	86882700	102067
EUR_52	40000	EUR	107	87257405	87661974	404569
EUR_52	40000	EUR	107	87692546	88108509	415963
EUR_52	40000	EUR	107	93870672	93925519	54847
EUR_53	40000	EUR	108	10180585	10444494	263909
EUR_53	40000	EUR	108	11706658	11814111	107453
EUR_53	40000	EUR	108	13229731	13269474	39743
EUR_53	40000	EUR	108	13902919	14112508	209589
EUR_53	40000	EUR	108	18057439	18720971	663532
EUR_53	40000	EUR	108	21150173	21156082	5909
EUR_53	40000	EUR	108	53525713	53542101	16388
EUR_53	40000	EUR	108	59553546	59700527	146981
EUR_53	40000	EUR	108	71843746	72471635	627889
EUR_53	40000	EUR	108	74441944	74455862	13918
EUR_53	40000	EUR	108	77123560	77233615	110055
EUR_53	40000	EUR	108	77917107	78058706	141599
EUR_53	40000	EUR	108	79824188	79933512	109324
EUR_53	40000	EUR	108	87211398	87661974	450576
EUR_53	40000	EUR	108	88221167	88300295	79128
EUR_53	40000	EUR	108	91856433	92121205	264772
EUR_53	40000	EUR	108	93303963	93468959	164996
EUR_53	40000	EUR	108	93861531	93971212	109681
EUR_53	40000	EUR	109	1401139	1426634	25495
EUR_53	40000	EUR	109	3531284	3708303	177019
EUR_53	40000	EUR	109	17567972	18041675	473703
EUR_53	40000	EUR	109	23635283	24094707	459424
EUR_53	40000	EUR	109	27121166	27323243	202077
EUR_53	40000	EUR	109	30954937	31099863	144926
EUR_53	40000	EUR	109	31378054	31443518	65464
EUR_53	40000	EUR	109	32499856	32556505	56649
EUR_53	40000	EUR	109	52224085	52385462	161377
EUR_53	40000	EUR	109	59581791	59631623	49832
EUR_53	40000	EUR	109	68996935	69082650	85715
EUR_53	40000	EUR	109	87430114	87751923	321809
EUR_53	40000	EUR	109	93303963	93500620	196657
EUR_53	40000	EUR	109	95939328	96003832	64504
EUR_54	40000	EUR	110	2760825	3302065	541240
EUR_54	40000	EUR	110	5298404	5368708	70304
EUR_54	40000	EUR	110	12173429	12399696	226267
EUR_54	40000	EUR	110	18319348	18368143	48795
EUR_54	40000	EUR	110	18622886	18806641	183755
EUR_54	40000	EUR	110	21484294	21540757	56463
EUR_54	40000	EUR	110	22454245	22608307	154062
EUR_54	40000	EUR	110	23584099	23767868	183769
EUR_54	40000	EUR	110	24372241	24581630	209389
EUR_54	40000	EUR	110	32499856	32556505	56649
EUR_54	40000	EUR	110	54113043	54486006	372963
EUR_54	40000	EUR	110	67419029	67497662	78633
EUR_54	40000	EUR	110	78697685	79134588	436903
EUR_54	40000	EUR	110	79907021	79936163	29142
EUR_54	40000	EUR	110	80459207	80492209	33002
EUR_54	40000	EUR	110	88758012	88912575	154563
EUR_54	40000	EUR	110	91847626	91965764	118138
EUR_54	40000	EUR	111	6865	630079	623214
EUR_54	40000	EUR	111	8294108	8303499	9391
EUR_54	40000	EUR	111	22447291	22509864	62573
EUR_54	40000	EUR	111	24088240	24165242	77002
EUR_54	40000	EUR	111	40047500	40068128	20628
EUR_54	40000	EUR	111	72023307	72094242	70935
EUR_54	40000	EUR	111	77763550	77824773	61223
EUR_54	40000	EUR	111	79426808	79677897	251089
EUR_54	40000	EUR	111	80874989	81229503	354514
EUR_54	40000	EUR	111	88219640	88284136	64496
EUR_54	40000	EUR	111	89202072	89292193	90121
EUR_55	40000	EUR	112	8348919	8636070	287151
EUR_55	40000	EUR	112	8854878	9034715	179837
EUR_55	40000	EUR	112	16076048	16259327	183279
EUR_55	40000	EUR	112	16582116	16622814	40698
EUR_55	40000	EUR	112	18081536	18285747	204211
EUR_55	40000	EUR	112	23958336	23993830	35494
EUR_55	40000	EUR	112	25189085	25305885	116800
EUR_55	40000	EUR	112	30904434	31092945	188511
EUR_55	40000	EUR	112	35646131	35892995	246864
EUR_55	40000	EUR	112	39578272	39763237	184965
EUR_55	40000	EUR	112	49859367	50150288	290921
EUR_55	40000	EUR	112	59874205	60031854	157649
EUR_55	40000	EUR	112	60110145	60125448	15303
EUR_55	40000	EUR	112	75614044	75632489	18445
EUR_55	40000	EUR	112	77606973	77793446	186473
EUR_55	40000	EUR	112	78246564	78406487	159923
EUR_55	40000	EUR	112	80603617	80668801	65184
EUR_55	40000	EUR	112	90105966	90328288	222322
EUR_55	40000	EUR	112	93870672	94559172	688500
EUR_55	40000	EUR	113	21113467	21184949	71482
EUR_55	40000	EUR	113	22209913	22342984	133071
EUR_55	40000	EUR	113	25189085	25501390	312305
EUR_55	40000	EUR	113	28599684	29012214	412530
EUR_55	40000	EUR	113	69725404	69814380	88976
EUR_55	40000	EUR	113	75522893	75632489	109596
EUR_55	40000	EUR	113	76565220	76704870	139650
EUR_55	40000	EUR	113	79901897	79936163	34266
EUR_55	40000	EUR	113	89590663	90328288	737625
EUR_56	40000	EUR	114	12952250	13216293	264043
EUR_56	40000	EUR	114	21113467	21282925	169458
EUR_56	40000	EUR	114	25470999	25550792	79793
EUR_56	40000	EUR	114	25867195	26288345	421150
EUR_56	40000	EUR	114	44064495	44172311	107816
EUR_56	40000	EUR	114	54453008	54904011	451003
EUR_56	40000	EUR	114	78857604	79134588	276984
EUR_56	40000	EUR	114	86780633	86882700	102067
EUR_56	40000	EUR	114	88591200	88600577	9377
EUR_56	40000	EUR	114	91489890	91688404	198514
EUR_56	40000	EUR	114	94222691	94412962	190271
EUR_56	40000	EUR	114	95774147	95783303	9156
EUR_56	40000	EUR	115	11706658	11814111	107453
EUR_56	40000	EUR	115	21113467	21113899	432
EUR_56	40000	EUR	115	23958336	23984973	26637
EUR_56	40000	EUR	115	31437056	31648058	211002
EUR_56	40000	EUR	115	34054443	34074439	19996
EUR_56	40000	EUR	115	59578454	59762964	184510
EUR_56	40000	EUR	115	78423267	78454557	31290
EUR_56	40000	EUR	115	87211398	87661974	450576
EUR_56	40000	EUR	115	88221167	88300295	79128
EUR_56	40000	EUR	115	91856433	92121205	264772
EUR_57	40000	EUR	116	0	8391	8391
EUR_57	40000	EUR	116	2415974	3302065	886091
EUR_57	40000	EUR	116	5253381	5312534	59153
EUR_57	40000	EUR	116	18662379	18700590	38211
EUR_57	40000	EUR	116	25690605	25721940	31335
EUR_57	40000	EUR	116	39892540	39985121	92581
EUR_57	40000	EUR	116	63714218	63892461	178243
EUR_57	40000	EUR	116	73208408	73275645	67237
EUR_57	40000	EUR	116	73432614	73642412	209798
EUR_57	40000	EUR	116	79374336	79474513	100177
EUR_57	40000	EUR	116	87211398	87265850	54452
EUR_57	40000	EUR	116	91489890	91688404	198514
EUR_57	40000	EUR	116	93168828	93500620	331792
EUR_57	40000	EUR	116	93870672	94559172	688500
EUR_57	40000	EUR	117	10399704	10401556	1852
EUR_57	40000	EUR	117	21665357	21672220	6863
EUR_57	40000	EUR	117	26798389	26991485	193096
EUR_57	40000	EUR	117	32694491	32768500	74009
EUR_57	40000	EUR	117	32808818	32870350	61532
EUR_57	40000	EUR	117	37589400	37671802	82402
EUR_57	40000	EUR	117	57210470	57291065	80595
EUR_57	40000	EUR	117	68996935	69082650	85715
EUR_57	40000	EUR	117	73208408	73275645	67237
EUR_57	40000	EUR	117	73432614	73906350	473736
EUR_57	40000	EUR	117	79901897	79936163	34266
EUR_57	40000	EUR	117	81028646	81178805	150159
EUR_57	40000	EUR	117	89683917	89979518	295601
EUR_57	40000	EUR	117	90632469	91107582	475113
EUR_57	40000	EUR	117	91564790	91851112	286322
EUR_57	40000	EUR	117	94533847	95134856	601009
EUR_57	40000	EUR	117	96183359	96231628	48269
EUR_58	40000	EUR	118	25189085	25235709	46624
EUR_58	40000	EUR	118	51847301	52065556	218255
EUR_58	40000	EUR	118	54210889	54486006	275117
EUR_58	40000	EUR	118	64049018	64195652	146634
EUR_58	40000	EUR	118	72028182	72094242	66060
EUR_58	40000	EUR	118	77582997	77990492	407495
EUR_58	40000	EUR	118	80447518	80532385	84867
EUR_58	40000	EUR	118	80602259	81072544	470285
EUR_58	40000	EUR	118	89356914	90969654	1612740
EUR_58	40000	EUR	118	93466522	93483805	17283
EUR_58	40000	EUR	118	94816096	95103137	287041
EUR_58	40000	EUR	118	95774147	95880389	106242
EUR_58	40000	EUR	119	4648476	4677679	29203
EUR_58	40000	EUR	119	13097530	13297453	199923
EUR_58	40000	EUR	119	17879585	18041675	162090
EUR_58	40000	EUR	119	23432743	23554604	121861
EUR_58	40000	EUR	119	24308008	24866754	558746
EUR_58	40000	EUR	119	27746608	27772122	25514
EUR_58	40000	EUR	119	31378054	31443518	65464
EUR_58	40000	EUR	119	42280145	42475564	195419
EUR_58	40000	EUR	119	54342549	54730663	388114
EUR_58	40000	EUR	119	59561641	59762964	201323
EUR_58	40000	EUR	119	69780101	69860988	80887
EUR_58	40000	EUR	119	80244832	80278256	33424
EUR_58	40000	EUR	119	80447518	80532385	84867
EUR_58	40000	EUR	119	80602259	81206695	604436
EUR_58	40000	EUR	119	86780633	86882700	102067
EUR_58	40000	EUR	119	87257405	87661974	404569
EUR_58	40000	EUR	119	87692546	88108509	415963
EUR_58	40000	EUR	119	89989980	89998439	8459
EUR_59	40000	EUR	120	5121074	5222891	101817
EUR_59	40000	EUR	120	8348919	8636070	287151
EUR_59	40000	EUR	120	8734503	9034715	300212
EUR_59	40000	EUR	120	18662379	18700590	38211
EUR_59	40000	EUR	120	22422308	22608307	185999
EUR_59	40000	EUR	120	25228569	25305885	77316
EUR_59	40000	EUR	120	25867195	26412209	545014
EUR_59	40000	EUR	120	49932158	49947339	15181
EUR_59	40000	EUR	120	53525713	53570384	44671
EUR_59	40000	EUR	120	54750602	54904011	153409
EUR_59	40000	EUR	120	57210470	57291065	80595
EUR_59	40000	EUR	120	64049018	64406168	357150
EUR_59	40000	EUR	120	71544591	71678663	134072
EUR_59	40000	EUR	120	87727929	87888944	161015
EUR_59	40000	EUR	120	87953796	87994899	41103
EUR_59	40000	EUR	120	88077880	88172209	94329
EUR_59	40000	EUR	121	7999419	8032094	32675
EUR_59	40000	EUR	121	28599684	29012214	412530
EUR_59	40000	EUR	121	34054443	34074439	19996
EUR_59	40000	EUR	121	41238294	41347169	108875
EUR_59	40000	EUR	121	54113043	54486006	372963
EUR_59	40000	EUR	121	67894963	68059341	164378
EUR_59	40000	EUR	121	75587305	75712585	125280
EUR_59	40000	EUR	121	77763550	77824773	61223
EUR_59	40000	EUR	121	87514418	87706224	191806
EUR_59	40000	EUR	121	88758012	88913257	155245
EUR_59	40000	EUR	121	93870672	93948106	77434
EUR_60	40000	EUR	122	5253381	5312534	59153
EUR_60	40000	EUR	122	8702684	8714283	11599
EUR_60	40000	EUR	122	17097270	17322650	225380
EUR_60	40000	EUR	122	21013712	21156082	142370
EUR_60	40000	EUR	122	24892444	24906091	13647
EUR_60	40000	EUR	122	39543007	39654799	111792
EUR_60	40000	EUR	122	53525713	53570384	44671
EUR_60	40000	EUR	122	64049018	64406168	357150
EUR_60	40000	EUR	122	79566540	79964120	397580
EUR_60	40000	EUR	122	87514418	87706224	191806
EUR_60	40000	EUR	122	88758012	88913257	155245
EUR_60	40000	EUR	122	92893314	92968521	75207
EUR_60	40000	EUR	122	93870672	94559172	688500
EUR_60	40000	EUR	123	18662379	18700590	38211
EUR_60	40000	EUR	123	23704903	24093672	388769
EUR_60	40000	EUR	123	24363955	24489860	125905
EUR_60	40000	EUR	123	26798389	26911224	112835
EUR_60	40000	EUR	123	27746608	27974945	228337
EUR_60	40000	EUR	123	28111916	28139866	27950
EUR_60	40000	EUR	123	34993565	35110499	116934
EUR_60	40000	EUR	123	43529412	43582534	53122
EUR_60	40000	EUR	123	52431552	52434465	2913
EUR_60	40000	EUR	123	54569815	54865385	295570
EUR_60	40000	EUR	123	57712252	57782439	70187
EUR_60	40000	EUR	123	67419029	67497662	78633
EUR_60	40000	EUR	123	78319582	78331639	12057
EUR_60	40000	EUR	123	86508335	86539843	31508
EUR_60	40000	EUR	123	87075746	87209400	133654
EUR_60	40000	EUR	123	87341564	87432167	90603
EUR_60	40000	EUR	123	88908777	88972858	64081
EUR_60	40000	EUR	123	95635926	95829654	193728
EUR_61	40000	EUR	124	80083	124243	44160
EUR_61	40000	EUR	124	4458174	4492188	34014
EUR_61	40000	EUR	124	17185238	17206427	21189
EUR_61	40000	EUR	124	18030341	18372675	342334
EUR_61	40000	EUR	124	31079765	31099863	20098
EUR_61	40000	EUR	124	59023046	59098610	75564
EUR_61	40000	EUR	124	68996935	69082650	85715
EUR_61	40000	EUR	124	74871541	74903617	32076
EUR_61	40000	EUR	124	90991558	91107582	116024
EUR_61	40000	EUR	124	94816096	95103137	287041
EUR_61	40000	EUR	125	9180036	9449917	269881
EUR_61	40000	EUR	125	10356570	10462507	105937
EUR_61	40000	EUR	125	11532006	11814111	282105
EUR_61	40000	EUR	125	21528581	21672220	143639
EUR_61	40000	EUR	125	23584099	23598380	14281
EUR_61	40000	EUR	125	23704903	23761811	56908
EUR_61	40000	EUR	125	25066876	25088413	21537
EUR_61	40000	EUR	125	25189085	25692513	503428
EUR_61	40000	EUR	125	26849817	26889089	39272
EUR_61	40000	EUR	125	29273800	29311528	37728
EUR_61	40000	EUR	125	32694491	32759145	64654
EUR_61	40000	EUR	125	42137286	42161050	23764
EUR_61	40000	EUR	125	51914729	52065556	150827
EUR_61	40000	EUR	125	77606973	78037381	430408
EUR_61	40000	EUR	125	87897465	88600577	703112
EUR_61	40000	EUR	125	91564790	91851112	286322
EUR_61	40000	EUR	125	93553045	94056780	503735
EUR_61	40000	EUR	125	95635926	95829654	193728
EUR_62	40000	EUR	126	5519001	5822302	303301
EUR_62	40000	EUR	126	9016073	9138500	122427
EUR_62	40000	EUR	126	13229731	13378968	149237
EUR_62	40000	EUR	126	24749954	24757234	7280
EUR_62	40000	EUR	126	25335078	25731778	396700
EUR_62	40000	EUR	126	26667389	26889089	221700
EUR_62	40000	EUR	126	31478668	31553483	74815
EUR_62	40000	EUR	126	64247601	64487076	239475
EUR_62	40000	EUR	126	84755692	84777735	22043
EUR_62	40000	EUR	126	87271349	87574353	303004
EUR_62	40000	EUR	126	88797692	89035170	237478
EUR_62	40000	EUR	126	89241176	89508341	267165
EUR_62	40000	EUR	126	96348465	96458269	109804
EUR_62	40000	EUR	126	99883333	1e+08	116667
EUR_62	40000	EUR	127	8047139	8134326	87187
EUR_62	40000	EUR	127	16383279	16470198	86919
EUR_62	40000	EUR	127	17185238	17206427	21189
EUR_62	40000	EUR	127	18043301	18304746	261445
EUR_62	40000	EUR	127	23314801	23442163	127362
EUR_62	40000	EUR	127	30954937	31099863	144926
EUR_62	40000	EUR	127	34275078	34351822	76744
EUR_62	40000	EUR	127	36284487	36355432	70945
EUR_62	40000	EUR	127	41238294	41465882	227588
EUR_62	40000	EUR	127	57712252	57770082	57830
EUR_62	40000	EUR	127	59036216	59631623	595407
EUR_62	40000	EUR	127	73082356	73223816	141460
EUR_62	40000	EUR	127	76365488	76606551	241063
EUR_62	40000	EUR	127	79426808	80004343	577535
EUR_62	40000	EUR	127	89975800	90558518	582718
EUR_62	40000	EUR	127	91847626	91965764	118138
EUR_62	40000	EUR	127	95801307	95877627	76320
EUR_63	40000	EUR	128	412074	651927	239853
EUR_63	40000	EUR	128	5253381	5312534	59153
EUR_63	40000	EUR	128	17097270	17322650	225380
EUR_63	40000	EUR	128	18008907	18138228	129321
EUR_63	40000	EUR	128	21528581	21672220	143639
EUR_63	40000	EUR	128	23752602	23960117	207515
EUR_63	40000	EUR	128	25323974	25406574	82600
EUR_63	40000	EUR	128	39653839	40087247	433408
EUR_63	40000	EUR	128	64472560	64535465	62905
EUR_63	40000	EUR	128	83554127	83592822	38695
EUR_63	40000	EUR	128	88804587	88975974	171387
EUR_63	40000	EUR	128	92847341	92931513	84172
EUR_63	40000	EUR	128	93539368	93585074	45706
EUR_63	40000	EUR	129	8557044	9164904	607860
EUR_63	40000	EUR	129	31087987	31599611	511624
EUR_63	40000	EUR	129	33101391	33410456	309065
EUR_63	40000	EUR	129	41238294	41465882	227588
EUR_63	40000	EUR	129	52626149	52662927	36778
EUR_63	40000	EUR	129	56054561	56124373	69812
EUR_63	40000	EUR	129	69800148	69878277	78129
EUR_63	40000	EUR	129	70833729	70919640	85911
EUR_63	40000	EUR	129	73883377	73961854	78477
EUR_63	40000	EUR	129	79426808	80004343	577535
EUR_63	40000	EUR	129	87898544	88045341	146797
EUR_63	40000	EUR	129	93404771	93411339	6568
EUR_63	40000	EUR	129	96195614	96328290	132676
EUR_64	40000	EUR	130	9028319	9054846	26527
EUR_64	40000	EUR	130	17185238	17206427	21189
EUR_64	40000	EUR	130	18043301	18304746	261445
EUR_64	40000	EUR	130	21891229	21972577	81348
EUR_64	40000	EUR	130	37986594	38028381	41787
EUR_64	40000	EUR	130	51914729	52065556	150827
EUR_64	40000	EUR	130	59178462	59428313	249851
EUR_64	40000	EUR	130	73626709	74212177	585468
EUR_64	40000	EUR	130	76365488	76589702	224214
EUR_64	40000	EUR	130	78775364	78799963	24599
EUR_64	40000	EUR	130	88592869	89004089	411220
EUR_64	40000	EUR	130	89932145	90005466	73321
EUR_64	40000	EUR	130	91515938	91541672	25734
EUR_64	40000	EUR	131	3531284	3708303	177019
EUR_64	40000	EUR	131	15890559	16068960	178401
EUR_64	40000	EUR	131	18030341	18111453	81112
EUR_64	40000	EUR	131	21113467	21282925	169458
EUR_64	40000	EUR	131	25228569	25305885	77316
EUR_64	40000	EUR	131	26319359	26580898	261539
EUR_64	40000	EUR	131	32732266	32759145	26879
EUR_64	40000	EUR	131	35365218	35892995	527777
EUR_64	40000	EUR	131	36050639	36089268	38629
EUR_64	40000	EUR	131	39578272	39934383	356111
EUR_64	40000	EUR	131	57717015	57861351	144336
EUR_64	40000	EUR	131	77606973	78037381	430408
EUR_64	40000	EUR	131	88371824	88400825	29001
EUR_64	40000	EUR	131	88421059	88584453	163394
EUR_64	40000	EUR	131	88678056	89432620	754564
EUR_64	40000	EUR	131	90627118	91107582	480464
EUR_65	40000	EUR	132	175939	623465	447526
EUR_65	40000	EUR	132	1186882	1458375	271493
EUR_65	40000	EUR	132	1557873	1971318	413445
EUR_65	40000	EUR	132	2604445	2605797	1352
EUR_65	40000	EUR	132	5253381	5312534	59153
EUR_65	40000	EUR	132	17835931	17905432	69501
EUR_65	40000	EUR	132	39578272	40087247	508975
EUR_65	40000	EUR	132	42540155	42574352	34197
EUR_65	40000	EUR	132	52224085	52440869	216784
EUR_65	40000	EUR	132	53549607	53570384	20777
EUR_65	40000	EUR	132	57168116	57291065	122949
EUR_65	40000	EUR	132	78423267	78454557	31290
EUR_65	40000	EUR	132	80677842	80703491	25649
EUR_65	40000	EUR	132	92892702	93278656	385954
EUR_65	40000	EUR	132	93416072	93429042	12970
EUR_65	40000	EUR	132	94578018	94792065	214047
EUR_65	40000	EUR	133	3531284	3708303	177019
EUR_65	40000	EUR	133	11480169	11552093	71924
EUR_65	40000	EUR	133	16138511	16681323	542812
EUR_65	40000	EUR	133	22387409	22509864	122455
EUR_65	40000	EUR	133	23510119	23554604	44485
EUR_65	40000	EUR	133	23709810	24094707	384897
EUR_65	40000	EUR	133	25140534	25305885	165351
EUR_65	40000	EUR	133	30827905	31110320	282415
EUR_65	40000	EUR	133	59874205	60031854	157649
EUR_65	40000	EUR	133	60110145	60125448	15303
EUR_65	40000	EUR	133	71843746	72471635	627889
EUR_65	40000	EUR	133	73208408	73270327	61919
EUR_65	40000	EUR	133	73280417	73494142	213725
EUR_65	40000	EUR	133	87550109	87751923	201814
EUR_65	40000	EUR	133	88758012	88913257	155245
EUR_65	40000	EUR	133	89975800	90558518	582718
EUR_65	40000	EUR	133	93807011	94108231	301220
EUR_65	40000	EUR	133	95939328	96288208	348880
EUR_66	40000	EUR	134	1762556	1993052	230496
EUR_66	40000	EUR	134	2519034	2648737	129703
EUR_66	40000	EUR	134	10180585	10444494	263909
EUR_66	40000	EUR	134	16491038	16527592	36554
EUR_66	40000	EUR	134	23424856	23651476	226620
EUR_66	40000	EUR	134	25189085	25692513	503428
EUR_66	40000	EUR	134	25995113	26436121	441008
EUR_66	40000	EUR	134	43707629	43783123	75494
EUR_66	40000	EUR	134	83503362	83550130	46768
EUR_66	40000	EUR	134	87840112	87888944	48832
EUR_66	40000	EUR	134	90627118	91107582	480464
EUR_66	40000	EUR	134	93627465	93725532	98067
EUR_66	40000	EUR	134	93891415	93925519	34104
EUR_66	40000	EUR	135	10356570	10462507	105937
EUR_66	40000	EUR	135	14060449	14112508	52059
EUR_66	40000	EUR	135	25264173	25265065	892
EUR_66	40000	EUR	135	27239978	27385544	145566
EUR_66	40000	EUR	135	28778721	28910496	131775
EUR_66	40000	EUR	135	30827905	31110320	282415
EUR_66	40000	EUR	135	32694491	32714627	20136
EUR_66	40000	EUR	135	52268650	52304163	35513
EUR_66	40000	EUR	135	53821064	53871804	50740
EUR_66	40000	EUR	135	89989980	89998439	8459
EUR_66	40000	EUR	135	91490500	91688404	197904
EUR_67	40000	EUR	136	1142397	1503422	361025
EUR_67	40000	EUR	136	2561078	2642124	81046
EUR_67	40000	EUR	136	8622945	8909640	286695
EUR_67	40000	EUR	136	9149188	9164904	15716
EUR_67	40000	EUR	136	11259640	11424907	165267
EUR_67	40000	EUR	136	25146308	25297928	151620
EUR_67	40000	EUR	136	32694491	32907000	212509
EUR_67	40000	EUR	136	40953591	41037792	84201
EUR_67	40000	EUR	136	52224085	52440869	216784
EUR_67	40000	EUR	136	53821064	53871804	50740
EUR_67	40000	EUR	136	79217313	79266344	49031
EUR_67	40000	EUR	136	87964655	88129782	165127
EUR_67	40000	EUR	136	89811259	90328288	517029
EUR_67	40000	EUR	136	91490500	91688404	197904
EUR_67	40000	EUR	136	92839624	93118749	279125
EUR_67	40000	EUR	137	4458174	4723754	265580
EUR_67	40000	EUR	137	8294108	8303499	9391
EUR_67	40000	EUR	137	11532006	11814111	282105
EUR_67	40000	EUR	137	25066876	25088413	21537
EUR_67	40000	EUR	137	30985114	31015993	30879
EUR_67	40000	EUR	137	32694491	32714627	20136
EUR_67	40000	EUR	137	70834228	71500666	666438
EUR_67	40000	EUR	137	75522893	75632489	109596
EUR_67	40000	EUR	137	81269042	81454175	185133
EUR_67	40000	EUR	137	90991558	91107582	116024
EUR_67	40000	EUR	137	94239181	94337048	97867
EUR_67	40000	EUR	137	94348955	94544971	196016
EUR_68	40000	EUR	138	8348919	8636070	287151
EUR_68	40000	EUR	138	8854878	9034715	179837
EUR_68	40000	EUR	138	13629898	13678187	48289
EUR_68	40000	EUR	138	18043301	18304746	261445
EUR_68	40000	EUR	138	23058641	23096716	38075
EUR_68	40000	EUR	138	23346980	23468049	121069
EUR_68	40000	EUR	138	24749954	24757234	7280
EUR_68	40000	EUR	138	32694491	32801534	107043
EUR_68	40000	EUR	138	41238294	41260225	21931
EUR_68	40000	EUR	138	59561641	59762964	201323
EUR_68	40000	EUR	138	88082386	88830128	747742
EUR_68	40000	EUR	139	231137	387995	156858
EUR_68	40000	EUR	139	4310705	4331350	20645
EUR_68	40000	EUR	139	13229731	13378968	149237
EUR_68	40000	EUR	139	25867195	25893125	25930
EUR_68	40000	EUR	139	27746608	27781381	34773
EUR_68	40000	EUR	139	43520906	43522582	1676
EUR_68	40000	EUR	139	58037974	58068519	30545
EUR_68	40000	EUR	139	74441944	74455862	13918
EUR_68	40000	EUR	139	77115754	77126614	10860
EUR_68	40000	EUR	139	77733985	77927414	193429
EUR_68	40000	EUR	139	88473395	88590868	117473
EUR_68	40000	EUR	139	89356914	89929463	572549
EUR_68	40000	EUR	139	91490500	91688404	197904
EUR_68	40000	EUR	139	93749592	93902122	152530
EUR_68	40000	EUR	139	95774147	95781842	7695
EUR_69	40000	EUR	140	23432743	23554604	121861
EUR_69	40000	EUR	140	27239978	27269831	29853
EUR_69	40000	EUR	140	36887403	37080521	193118
EUR_69	40000	EUR	140	49702405	50246703	544298
EUR_69	40000	EUR	140	51850918	52065556	214638
EUR_69	40000	EUR	140	52358663	52420473	61810
EUR_69	40000	EUR	140	73439734	73753239	313505
EUR_69	40000	EUR	140	77288243	77302966	14723
EUR_69	40000	EUR	140	80447518	80532385	84867
EUR_69	40000	EUR	140	80602259	81206695	604436
EUR_69	40000	EUR	140	99165891	99280798	114907
EUR_69	40000	EUR	141	13574314	13635433	61119
EUR_69	40000	EUR	141	13640984	13678187	37203
EUR_69	40000	EUR	141	14051019	14112508	61489
EUR_69	40000	EUR	141	22429343	22533171	103828
EUR_69	40000	EUR	141	24109296	24211824	102528
EUR_69	40000	EUR	141	26375604	26436121	60517
EUR_69	40000	EUR	141	30889388	31145710	256322
EUR_69	40000	EUR	141	39847102	40083980	236878
EUR_69	40000	EUR	141	57712252	57782439	70187
EUR_69	40000	EUR	141	68996935	69082650	85715
EUR_69	40000	EUR	141	76022322	76143984	121662
EUR_69	40000	EUR	141	86620325	87051737	431412
EUR_69	40000	EUR	141	87438359	87488739	50380
EUR_69	40000	EUR	141	93948380	94092405	144025
EUR_69	40000	EUR	141	94847486	94943556	96070
EUR_70	40000	EUR	142	11480169	11552093	71924
EUR_70	40000	EUR	142	16138511	16681323	542812
EUR_70	40000	EUR	142	27746608	28026498	279890
EUR_70	40000	EUR	142	35366354	35413680	47326
EUR_70	40000	EUR	142	36284487	36411891	127404
EUR_70	40000	EUR	142	42280145	42823699	543554
EUR_70	40000	EUR	142	52268650	52373523	104873
EUR_70	40000	EUR	142	53525713	53544702	18989
EUR_70	40000	EUR	142	57136159	57291065	154906
EUR_70	40000	EUR	142	59553546	59700527	146981
EUR_70	40000	EUR	142	64314501	64533989	219488
EUR_70	40000	EUR	142	68996935	69082650	85715
EUR_70	40000	EUR	142	72023307	72094242	70935
EUR_70	40000	EUR	142	81028646	81178805	150159
EUR_70	40000	EUR	142	81355040	81409551	54511
EUR_70	40000	EUR	142	88219640	88362519	142879
EUR_70	40000	EUR	143	8967212	9054846	87634
EUR_70	40000	EUR	143	13574314	13635433	61119
EUR_70	40000	EUR	143	13640984	13678187	37203
EUR_70	40000	EUR	143	24146634	24211824	65190
EUR_70	40000	EUR	143	24749954	24757234	7280
EUR_70	40000	EUR	143	27755269	27841352	86083
EUR_70	40000	EUR	143	30904434	31092945	188511
EUR_70	40000	EUR	143	36284487	36321671	37184
EUR_70	40000	EUR	143	42052732	42259154	206422
EUR_70	40000	EUR	143	53525713	53570384	44671
EUR_70	40000	EUR	143	69725404	69831252	105848
EUR_70	40000	EUR	143	70914239	71152787	238548
EUR_70	40000	EUR	143	74441944	74455862	13918
EUR_70	40000	EUR	143	79540256	79765225	224969
EUR_70	40000	EUR	143	90386003	90799928	413925
EUR_70	40000	EUR	143	93948380	94092405	144025
EUR_70	40000	EUR	143	94847486	94943556	96070
EUR_71	40000	EUR	144	13902919	14112508	209589
EUR_71	40000	EUR	144	23156936	23184805	27869
EUR_71	40000	EUR	144	33128144	33513276	385132
EUR_71	40000	EUR	144	34845302	35027869	182567
EUR_71	40000	EUR	144	40953591	41037792	84201
EUR_71	40000	EUR	144	52254997	52662927	407930
EUR_71	40000	EUR	144	74193428	74575318	381890
EUR_71	40000	EUR	144	74780511	74868961	88450
EUR_71	40000	EUR	144	78423267	79062108	638841
EUR_71	40000	EUR	144	79901897	79936163	34266
EUR_71	40000	EUR	144	88221167	88224922	3755
EUR_71	40000	EUR	144	91018779	91107582	88803
EUR_71	40000	EUR	144	93981861	94439046	457185
EUR_71	40000	EUR	144	95172719	95391485	218766
EUR_71	40000	EUR	144	95774147	95966697	192550
EUR_71	40000	EUR	145	8967212	9054846	87634
EUR_71	40000	EUR	145	23496585	23554604	58019
EUR_71	40000	EUR	145	25675502	25745738	70236
EUR_71	40000	EUR	145	31582942	31648058	65116
EUR_71	40000	EUR	145	32694491	32759145	64654
EUR_71	40000	EUR	145	54113043	54228142	115099
EUR_71	40000	EUR	145	57712252	57861351	149099
EUR_71	40000	EUR	145	58863206	59631623	768417
EUR_71	40000	EUR	145	74751340	74874398	123058
EUR_71	40000	EUR	145	76515893	76779583	263690
EUR_71	40000	EUR	145	79678655	79687804	9149
EUR_71	40000	EUR	145	79948679	80034351	85672
EUR_71	40000	EUR	145	88025602	88341164	315562
EUR_71	40000	EUR	145	90991558	91107582	116024
EUR_72	40000	EUR	146	17567972	17978813	410841
EUR_72	40000	EUR	146	25867195	25937995	70800
EUR_72	40000	EUR	146	32694491	32768500	74009
EUR_72	40000	EUR	146	32808818	32870350	61532
EUR_72	40000	EUR	146	39578272	40023468	445196
EUR_72	40000	EUR	146	83503362	83550130	46768
EUR_72	40000	EUR	146	87257405	87994899	737494
EUR_72	40000	EUR	146	88077880	88172209	94329
EUR_72	40000	EUR	146	91490500	91688404	197904
EUR_72	40000	EUR	146	92839624	93411339	571715
EUR_72	40000	EUR	147	7999419	8032094	32675
EUR_72	40000	EUR	147	18211220	18285211	73991
EUR_72	40000	EUR	147	18804103	18882238	78135
EUR_72	40000	EUR	147	23131382	23541850	410468
EUR_72	40000	EUR	147	38026726	38028381	1655
EUR_72	40000	EUR	147	39847102	40083980	236878
EUR_72	40000	EUR	147	41161176	41182266	21090
EUR_72	40000	EUR	147	43520906	43653793	132887
EUR_72	40000	EUR	147	57288509	57291065	2556
EUR_72	40000	EUR	147	57712252	57861351	149099
EUR_72	40000	EUR	147	64049018	64195652	146634
EUR_72	40000	EUR	147	74020413	74094072	73659
EUR_72	40000	EUR	147	77606973	77700986	94013
EUR_72	40000	EUR	147	79536206	79964120	427914
EUR_72	40000	EUR	147	81205893	81229503	23610
EUR_72	40000	EUR	147	88890597	89086538	195941
EUR_72	40000	EUR	147	93948380	94092405	144025
EUR_72	40000	EUR	147	95853274	96330127	476853
EUR_73	40000	EUR	148	23156936	23184805	27869
EUR_73	40000	EUR	148	51850918	52065556	214638
EUR_73	40000	EUR	148	52358663	52420473	61810
EUR_73	40000	EUR	148	63840934	63892461	51527
EUR_73	40000	EUR	149	1114241	1458375	344134
EUR_73	40000	EUR	149	1557873	1971318	413445
EUR_73	40000	EUR	149	2604445	2605797	1352
EUR_73	40000	EUR	149	5253381	5312534	59153
EUR_73	40000	EUR	149	12952250	13216293	264043
EUR_73	40000	EUR	149	58863206	59382875	519669
EUR_73	40000	EUR	149	59578454	59604764	26310
EUR_73	40000	EUR	149	68407478	68436991	29513
EUR_73	40000	EUR	149	76365488	76565447	199959
EUR_73	40000	EUR	149	78246564	78406487	159923
EUR_73	40000	EUR	149	83503362	83550130	46768
EUR_73	40000	EUR	149	89989980	89998439	8459
EUR_73	40000	EUR	149	91490500	91688404	197904
EUR_73	40000	EUR	149	92839624	92969240	129616
EUR_73	40000	EUR	149	93003061	93124823	121762
EUR_73	40000	EUR	149	93324220	93647010	322790
EUR_73	40000	EUR	149	96379020	97008044	629024
EUR_74	40000	EUR	150	5298404	5368708	70304
EUR_74	40000	EUR	150	7287218	7640434	353216
EUR_74	40000	EUR	150	12952250	13216293	264043
EUR_74	40000	EUR	150	22387409	22509864	122455
EUR_74	40000	EUR	150	25392757	25745738	352981
EUR_74	40000	EUR	150	32694491	32928964	234473
EUR_74	40000	EUR	150	35398401	35528765	130364
EUR_74	40000	EUR	150	37986594	38028381	41787
EUR_74	40000	EUR	150	42502674	42526580	23906
EUR_74	40000	EUR	150	53525713	53570384	44671
EUR_74	40000	EUR	150	72359726	72373817	14091
EUR_74	40000	EUR	150	78319582	78331639	12057
EUR_74	40000	EUR	150	88025602	88341164	315562
EUR_74	40000	EUR	150	93308720	93414056	105336
EUR_74	40000	EUR	150	93749592	93982987	233395
EUR_74	40000	EUR	150	95853274	96330127	476853
EUR_74	40000	EUR	151	1353749	1512555	158806
EUR_74	40000	EUR	151	10399704	10402156	2452
EUR_74	40000	EUR	151	24975030	24988911	13881
EUR_74	40000	EUR	151	25394504	25600157	205653
EUR_74	40000	EUR	151	36634451	37180056	545605
EUR_74	40000	EUR	151	52268650	52420473	151823
EUR_74	40000	EUR	151	80863277	80899276	35999
EUR_74	40000	EUR	151	84755692	84919115	163423
EUR_74	40000	EUR	151	86780633	86882700	102067
EUR_74	40000	EUR	151	91489890	91688404	198514
EUR_75	40000	EUR	152	5789806	5822302	32496
EUR_75	40000	EUR	152	8348919	8588805	239886
EUR_75	40000	EUR	152	23584099	23598380	14281
EUR_75	40000	EUR	152	23704903	23761811	56908
EUR_75	40000	EUR	152	25140534	25305885	165351
EUR_75	40000	EUR	152	31008086	31134053	125967
EUR_75	40000	EUR	152	31996371	32069649	73278
EUR_75	40000	EUR	152	54342549	54730663	388114
EUR_75	40000	EUR	152	74751340	74874398	123058
EUR_75	40000	EUR	152	77751346	77881732	130386
EUR_75	40000	EUR	152	80569469	80662794	93325
EUR_75	40000	EUR	152	86620325	87051737	431412
EUR_75	40000	EUR	152	87438359	87488739	50380
EUR_75	40000	EUR	152	93680632	93745400	64768
EUR_75	40000	EUR	152	94712910	94767857	54947
EUR_75	40000	EUR	153	18622886	18806641	183755
EUR_75	40000	EUR	153	30804231	30963035	158804
EUR_75	40000	EUR	153	40410992	40602505	191513
EUR_75	40000	EUR	153	58925219	59190527	265308
EUR_75	40000	EUR	153	64049018	64195652	146634
EUR_75	40000	EUR	153	76365488	76589702	224214
EUR_75	40000	EUR	153	77606973	77885640	278667
EUR_75	40000	EUR	153	87727929	87888944	161015
EUR_75	40000	EUR	153	90991558	91024151	32593
EUR_75	40000	EUR	153	91856433	92121205	264772
EUR_75	40000	EUR	153	93539368	93585074	45706
EUR_75	40000	EUR	153	95814814	95829654	14840
EUR_76	40000	EUR	154	8702684	8714283	11599
EUR_76	40000	EUR	154	24372241	24581630	209389
EUR_76	40000	EUR	154	32694491	32980559	286068
EUR_76	40000	EUR	154	34993565	34996814	3249
EUR_76	40000	EUR	154	43529412	43582534	53122
EUR_76	40000	EUR	154	57912753	58262406	349653
EUR_76	40000	EUR	154	73488506	73702901	214395
EUR_76	40000	EUR	154	87444841	87454390	9549
EUR_76	40000	EUR	154	88219640	88972858	753218
EUR_76	40000	EUR	154	90991558	91107582	116024
EUR_76	40000	EUR	155	18159953	18162842	2889
EUR_76	40000	EUR	155	22890136	23102437	212301
EUR_76	40000	EUR	155	23635283	23781066	145783
EUR_76	40000	EUR	155	28963839	29052469	88630
EUR_76	40000	EUR	155	32694491	32714627	20136
EUR_76	40000	EUR	155	74193428	74575318	381890
EUR_76	40000	EUR	155	74780511	74918791	138280
EUR_76	40000	EUR	155	77606973	77700986	94013
EUR_76	40000	EUR	155	78024433	78037381	12948
EUR_76	40000	EUR	155	78423267	78538470	115203
EUR_76	40000	EUR	155	80135541	80225291	89750
EUR_76	40000	EUR	155	87897465	88600577	703112
EUR_76	40000	EUR	155	91564790	91851112	286322
EUR_77	40000	EUR	156	4458174	4461742	3568
EUR_77	40000	EUR	156	16383279	16504686	121407
EUR_77	40000	EUR	156	18081536	18285747	204211
EUR_77	40000	EUR	156	22209913	22509864	299951
EUR_77	40000	EUR	156	25323974	25378298	54324
EUR_77	40000	EUR	156	29653978	29766792	112814
EUR_77	40000	EUR	156	39662392	40087247	424855
EUR_77	40000	EUR	156	41319133	41615358	296225
EUR_77	40000	EUR	156	70541408	70544348	2940
EUR_77	40000	EUR	156	72372477	72471635	99158
EUR_77	40000	EUR	156	73208408	73275645	67237
EUR_77	40000	EUR	156	84770173	84919115	148942
EUR_77	40000	EUR	156	87257405	87321376	63971
EUR_77	40000	EUR	156	90991558	91107582	116024
EUR_77	40000	EUR	156	92839624	93411339	571715
EUR_77	40000	EUR	156	96431824	96458269	26445
EUR_77	40000	EUR	157	8521996	8766263	244267
EUR_77	40000	EUR	157	21015460	21274841	259381
EUR_77	40000	EUR	157	26798389	26991485	193096
EUR_77	40000	EUR	157	39832129	40138815	306686
EUR_77	40000	EUR	157	42280145	42823699	543554
EUR_77	40000	EUR	157	50212896	50223414	10518
EUR_77	40000	EUR	157	68624378	68717300	92922
EUR_77	40000	EUR	157	72033351	72094242	60891
EUR_77	40000	EUR	157	74019705	74084436	64731
EUR_77	40000	EUR	157	78697685	79088059	390374
EUR_77	40000	EUR	157	88082386	88332304	249918
EUR_78	40000	EUR	158	9413335	9449917	36582
EUR_78	40000	EUR	158	12952250	13216293	264043
EUR_78	40000	EUR	158	27746608	27974945	228337
EUR_78	40000	EUR	158	58057212	58136140	78928
EUR_78	40000	EUR	158	70877012	71152787	275775
EUR_78	40000	EUR	158	73446858	73584382	137524
EUR_78	40000	EUR	158	77733985	78037381	303396
EUR_78	40000	EUR	158	78423267	79062108	638841
EUR_78	40000	EUR	158	80447518	80532385	84867
EUR_78	40000	EUR	158	80602259	81206695	604436
EUR_78	40000	EUR	158	81355040	81409551	54511
EUR_78	40000	EUR	158	88219640	88972858	753218
EUR_78	40000	EUR	158	90991558	91107582	116024
EUR_78	40000	EUR	158	93680632	93745400	64768
EUR_78	40000	EUR	158	99177558	99280798	103240
EUR_78	40000	EUR	158	99972505	1e+08	27495
EUR_78	40000	EUR	159	5543034	6025803	482769
EUR_78	40000	EUR	159	23058641	23096716	38075
EUR_78	40000	EUR	159	23346980	23468049	121069
EUR_78	40000	EUR	159	24749954	24757234	7280
EUR_78	40000	EUR	159	26051372	26209562	158190
EUR_78	40000	EUR	159	57168116	57291065	122949
EUR_78	40000	EUR	159	72023307	72094242	70935
EUR_78	40000	EUR	159	77763550	77824773	61223
EUR_78	40000	EUR	159	86780633	86882700	102067
EUR_78	40000	EUR	159	88591200	88600577	9377
EUR_78	40000	EUR	159	90991558	91107582	116024
EUR_78	40000	EUR	159	91847626	91965764	118138
EUR_78	40000	EUR	159	99165891	99257664	91773
EUR_79	40000	EUR	160	12952250	13216293	264043
EUR_79	40000	EUR	160	25627344	25731778	104434
EUR_79	40000	EUR	160	31378054	31443518	65464
EUR_79	40000	EUR	160	38026726	38028381	1655
EUR_79	40000	EUR	160	43359651	43582534	222883
EUR_79	40000	EUR	160	59561641	59762964	201323
EUR_79	40000	EUR	160	68657536	68717300	59764
EUR_79	40000	EUR	160	73208408	73586325	377917
EUR_79	40000	EUR	160	75781447	75845332	63885
EUR_79	40000	EUR	160	87375964	87432167	56203
EUR_79	40000	EUR	160	88964766	89227874	263108
EUR_79	40000	EUR	161	10399704	10402156	2452
EUR_79	40000	EUR	161	13928615	14112508	183893
EUR_79	40000	EUR	161	17288353	17397614	109261
EUR_79	40000	EUR	161	25189085	25305885	116800
EUR_79	40000	EUR	161	29321833	29396318	74485
EUR_79	40000	EUR	161	81028646	81178805	150159
EUR_79	40000	EUR	161	90386003	90799928	413925
EUR_79	40000	EUR	161	93601452	93725532	124080
EUR_79	40000	EUR	161	93990293	94544971	554678
EUR_79	40000	EUR	161	95802576	95960093	157517
EUR_80	40000	EUR	162	1735950	2633469	897519
EUR_80	40000	EUR	162	5636439	5822302	185863
EUR_80	40000	EUR	162	18815917	18882238	66321
EUR_80	40000	EUR	162	23983941	23993830	9889
EUR_80	40000	EUR	162	30804231	31025284	221053
EUR_80	40000	EUR	162	32694491	32714627	20136
EUR_80	40000	EUR	162	59215968	59309331	93363
EUR_80	40000	EUR	162	73446858	73584382	137524
EUR_80	40000	EUR	162	88428200	88584453	156253
EUR_80	40000	EUR	162	88678056	89432620	754564
EUR_80	40000	EUR	163	4648476	4677679	29203
EUR_80	40000	EUR	163	12903506	13143115	239609
EUR_80	40000	EUR	163	18057439	18720971	663532
EUR_80	40000	EUR	163	23118829	23215111	96282
EUR_80	40000	EUR	163	23958336	23984973	26637
EUR_80	40000	EUR	163	25995113	26169524	174411
EUR_80	40000	EUR	163	27104809	27178355	73546
EUR_80	40000	EUR	163	31437056	31648058	211002
EUR_80	40000	EUR	163	34054443	34074439	19996
EUR_80	40000	EUR	163	52168283	52427775	259492
EUR_80	40000	EUR	163	57168116	57291065	122949
EUR_80	40000	EUR	163	65287348	65407739	120391
EUR_80	40000	EUR	163	72023307	72094242	70935
EUR_80	40000	EUR	163	73531540	73584382	52842
EUR_80	40000	EUR	163	74133727	74738891	605164
EUR_80	40000	EUR	163	89730796	89789983	59187
EUR_80	40000	EUR	163	93981861	94412962	431101
EUR_80	40000	EUR	163	95774147	95880389	106242
EUR_81	40000	EUR	164	1762556	2455877	693321
EUR_81	40000	EUR	164	7287218	7640434	353216
EUR_81	40000	EUR	164	23298181	23651476	353295
EUR_81	40000	EUR	164	26392689	26436121	43432
EUR_81	40000	EUR	164	32694491	32759145	64654
EUR_81	40000	EUR	164	37051655	37180056	128401
EUR_81	40000	EUR	164	42502674	42532018	29344
EUR_81	40000	EUR	164	53821064	54247633	426569
EUR_81	40000	EUR	164	57168116	57291065	122949
EUR_81	40000	EUR	164	59178462	59631623	453161
EUR_81	40000	EUR	164	73245213	73275933	30720
EUR_81	40000	EUR	164	74019705	74094072	74367
EUR_81	40000	EUR	164	77606973	78037381	430408
EUR_81	40000	EUR	164	79877405	79954811	77406
EUR_81	40000	EUR	164	80459207	80492209	33002
EUR_81	40000	EUR	164	87514418	87706224	191806
EUR_81	40000	EUR	164	89420670	90328288	907618
EUR_81	40000	EUR	164	91490500	91688404	197904
EUR_81	40000	EUR	164	92839624	93118749	279125
EUR_81	40000	EUR	164	96379020	97008044	629024
EUR_81	40000	EUR	165	16202082	16527592	325510
EUR_81	40000	EUR	165	25464518	25731778	267260
EUR_81	40000	EUR	165	27288461	27323243	34782
EUR_81	40000	EUR	165	32694491	32714627	20136
EUR_81	40000	EUR	165	32729550	32768500	38950
EUR_81	40000	EUR	165	32808818	32870350	61532
EUR_81	40000	EUR	165	52268650	52420473	151823
EUR_81	40000	EUR	165	63714218	63892461	178243
EUR_81	40000	EUR	165	77606973	78037381	430408
EUR_81	40000	EUR	165	83554127	83592822	38695
EUR_82	40000	EUR	166	9413335	9449917	36582
EUR_82	40000	EUR	166	12952250	13216293	264043
EUR_82	40000	EUR	166	25690605	25904510	213905
EUR_82	40000	EUR	166	29693031	29706829	13798
EUR_82	40000	EUR	166	32667412	32870350	202938
EUR_82	40000	EUR	166	39578272	39843490	265218
EUR_82	40000	EUR	166	54005226	54075933	70707
EUR_82	40000	EUR	166	74133727	74738891	605164
EUR_82	40000	EUR	166	83503362	83550130	46768
EUR_82	40000	EUR	166	85353810	85788658	434848
EUR_82	40000	EUR	166	88473395	88590868	117473
EUR_82	40000	EUR	166	89276688	89445720	169032
EUR_82	40000	EUR	166	95635926	95680595	44669
EUR_82	40000	EUR	166	99165891	99190188	24297
EUR_82	40000	EUR	167	1209400	1458375	248975
EUR_82	40000	EUR	167	7999419	8207134	207715
EUR_82	40000	EUR	167	13574314	13634873	60559
EUR_82	40000	EUR	167	17805485	18041675	236190
EUR_82	40000	EUR	167	25190794	25305885	115091
EUR_82	40000	EUR	167	26422263	26580898	158635
EUR_82	40000	EUR	167	29693031	29706829	13798
EUR_82	40000	EUR	167	73243224	73275645	32421
EUR_82	40000	EUR	167	73432614	73771912	339298
EUR_82	40000	EUR	167	88087834	88857251	769417
EUR_82	40000	EUR	167	89989980	89998439	8459
EUR_83	40000	EUR	168	4931821	5822302	890481
EUR_83	40000	EUR	168	17938233	17940601	2368
EUR_83	40000	EUR	168	23314801	23442163	127362
EUR_83	40000	EUR	168	25228569	25305885	77316
EUR_83	40000	EUR	168	26319359	26580898	261539
EUR_83	40000	EUR	168	29321833	29396318	74485
EUR_83	40000	EUR	168	35217748	35413680	195932
EUR_83	40000	EUR	168	36284487	36460007	175520
EUR_83	40000	EUR	168	42280145	42574352	294207
EUR_83	40000	EUR	168	64432046	64487076	55030
EUR_83	40000	EUR	168	72023307	72094242	70935
EUR_83	40000	EUR	168	81028646	81178805	150159
EUR_83	40000	EUR	168	81355040	81409551	54511
EUR_83	40000	EUR	168	89067780	89099823	32043
EUR_83	40000	EUR	168	93862525	93912468	49943
EUR_83	40000	EUR	169	506666	1079953	573287
EUR_83	40000	EUR	169	1157833	1191560	33727
EUR_83	40000	EUR	169	11480169	11492904	12735
EUR_83	40000	EUR	169	21113467	21113899	432
EUR_83	40000	EUR	169	23958336	23984973	26637
EUR_83	40000	EUR	169	39578272	39688540	110268
EUR_83	40000	EUR	169	69780101	69860988	80887
EUR_83	40000	EUR	169	80244832	80278256	33424
EUR_83	40000	EUR	169	80447518	80532385	84867
EUR_83	40000	EUR	169	80602259	81206695	604436
EUR_83	40000	EUR	169	86780633	86882700	102067
EUR_83	40000	EUR	169	87257405	87661974	404569
EUR_83	40000	EUR	169	87692546	88108509	415963
EUR_83	40000	EUR	169	89067780	89099823	32043
EUR_83	40000	EUR	169	94109567	94318951	209384
EUR_84	40000	EUR	170	7373150	7627455	254305
EUR_84	40000	EUR	170	9180036	9221404	41368
EUR_84	40000	EUR	170	11706658	11767415	60757
EUR_84	40000	EUR	170	12952250	13216293	264043
EUR_84	40000	EUR	170	23958336	23993830	35494
EUR_84	40000	EUR	170	25140534	25297928	157394
EUR_84	40000	EUR	170	52224085	52440869	216784
EUR_84	40000	EUR	170	59553546	59700527	146981
EUR_84	40000	EUR	170	75089161	75354263	265102
EUR_84	40000	EUR	170	77606973	78037381	430408
EUR_84	40000	EUR	170	80863277	80899276	35999
EUR_84	40000	EUR	170	87211398	87683106	471708
EUR_84	40000	EUR	170	88782954	88806284	23330
EUR_84	40000	EUR	170	93601452	93725532	124080
EUR_84	40000	EUR	170	95774147	95947015	172868
EUR_84	40000	EUR	170	96005104	96346551	341447
EUR_84	40000	EUR	170	99883333	1e+08	116667
EUR_84	40000	EUR	171	13114137	13216293	102156
EUR_84	40000	EUR	171	32667412	32870350	202938
EUR_84	40000	EUR	171	39578272	39763237	184965
EUR_84	40000	EUR	171	54533213	54612977	79764
EUR_84	40000	EUR	171	57712252	57806900	94648
EUR_84	40000	EUR	171	58569405	58694180	124775
EUR_84	40000	EUR	171	64432046	64487076	55030
EUR_84	40000	EUR	171	89273347	89419331	145984
EUR_84	40000	EUR	171	93749592	94120065	370473
EUR_85	40000	EUR	172	9028319	9054846	26527
EUR_85	40000	EUR	172	17889447	17894355	4908
EUR_85	40000	EUR	172	23424856	23454893	30037
EUR_85	40000	EUR	172	23958336	23993830	35494
EUR_85	40000	EUR	172	24975030	25040025	64995
EUR_85	40000	EUR	172	25264173	25308551	44378
EUR_85	40000	EUR	172	32694491	32759145	64654
EUR_85	40000	EUR	172	44064495	44172311	107816
EUR_85	40000	EUR	172	64045063	64588795	543732
EUR_85	40000	EUR	172	71700744	71820558	119814
EUR_85	40000	EUR	172	73280417	73494142	213725
EUR_85	40000	EUR	172	73896773	73906350	9577
EUR_85	40000	EUR	172	76351824	76397042	45218
EUR_85	40000	EUR	172	80569469	80662628	93159
EUR_85	40000	EUR	172	83503362	83550130	46768
EUR_85	40000	EUR	172	87257405	87994899	737494
EUR_85	40000	EUR	172	88077880	88172209	94329
EUR_85	40000	EUR	172	93863957	94381472	517515
EUR_85	40000	EUR	172	95774147	96346551	572404
EUR_85	40000	EUR	173	11532006	11563366	31360
EUR_85	40000	EUR	173	16202082	16527592	325510
EUR_85	40000	EUR	173	21015460	21274841	259381
EUR_85	40000	EUR	173	23752602	24866754	1114152
EUR_85	40000	EUR	173	36825706	37162090	336384
EUR_85	40000	EUR	173	40130671	40522936	392265
EUR_85	40000	EUR	173	40580630	40833757	253127
EUR_85	40000	EUR	173	78096571	78140074	43503
EUR_85	40000	EUR	173	89135269	89145996	10727
EUR_85	40000	EUR	173	89223982	89227874	3892
EUR_85	40000	EUR	173	91564790	91594939	30149
EUR_85	40000	EUR	173	93324220	93647010	322790
EUR_85	40000	EUR	173	94299216	94538611	239395
EUR_86	40000	EUR	174	5253381	5312534	59153
EUR_86	40000	EUR	174	17901269	18882238	980969
EUR_86	40000	EUR	174	23635283	23781066	145783
EUR_86	40000	EUR	174	27843592	27876877	33285
EUR_86	40000	EUR	174	31113073	31618309	505236
EUR_86	40000	EUR	174	34909866	35104006	194140
EUR_86	40000	EUR	174	57216944	57291065	74121
EUR_86	40000	EUR	174	84900283	84919115	18832
EUR_86	40000	EUR	174	86508335	86539843	31508
EUR_86	40000	EUR	174	87075746	87263544	187798
EUR_86	40000	EUR	174	91489890	91688404	198514
EUR_86	40000	EUR	175	8348919	8636070	287151
EUR_86	40000	EUR	175	8854878	9034715	179837
EUR_86	40000	EUR	175	9413335	9449917	36582
EUR_86	40000	EUR	175	12952250	13216293	264043
EUR_86	40000	EUR	175	23165132	23267376	102244
EUR_86	40000	EUR	175	24975030	24988911	13881
EUR_86	40000	EUR	175	25385795	25600157	214362
EUR_86	40000	EUR	175	32440067	32457287	17220
EUR_86	40000	EUR	175	40953591	41037792	84201
EUR_86	40000	EUR	175	57712252	57749753	37501
EUR_86	40000	EUR	175	72359726	72373817	14091
EUR_86	40000	EUR	175	76118231	76143984	25753
EUR_86	40000	EUR	175	86620325	87051737	431412
EUR_86	40000	EUR	175	87438359	87488739	50380
EUR_86	40000	EUR	175	88357123	89157587	800464
EUR_86	40000	EUR	175	89276688	89445720	169032
EUR_86	40000	EUR	175	93601452	93725532	124080
EUR_86	40000	EUR	175	93891415	93925519	34104
EUR_87	40000	EUR	176	25323974	25378298	54324
EUR_87	40000	EUR	176	75110846	75189189	78343
EUR_87	40000	EUR	176	86960491	87348001	387510
EUR_87	40000	EUR	176	93862525	93912468	49943
EUR_87	40000	EUR	177	13902919	14112508	209589
EUR_87	40000	EUR	177	23156936	23184805	27869
EUR_87	40000	EUR	177	56378802	56480618	101816
EUR_87	40000	EUR	177	58863206	59631623	768417
EUR_87	40000	EUR	177	70289889	70396556	106667
EUR_87	40000	EUR	177	76565220	76704870	139650
EUR_87	40000	EUR	177	79901897	79936163	34266
EUR_87	40000	EUR	177	93907950	94439046	531096
EUR_87	40000	EUR	177	95172719	95391485	218766
EUR_87	40000	EUR	177	96220670	96346551	125881
EUR_88	40000	EUR	178	5543034	6025803	482769
EUR_88	40000	EUR	178	13212809	13216293	3484
EUR_88	40000	EUR	178	26281245	26361294	80049
EUR_88	40000	EUR	178	33101391	33410456	309065
EUR_88	40000	EUR	178	70289889	70396556	106667
EUR_88	40000	EUR	178	87444841	87656802	211961
EUR_88	40000	EUR	178	88928912	88972858	43946
EUR_88	40000	EUR	178	94578018	94792065	214047
EUR_88	40000	EUR	179	5298404	5368708	70304
EUR_88	40000	EUR	179	18057439	18720971	663532
EUR_88	40000	EUR	179	23635283	23804270	168987
EUR_88	40000	EUR	179	24806950	24834924	27974
EUR_88	40000	EUR	179	25189085	25235709	46624
EUR_88	40000	EUR	179	73243224	73275645	32421
EUR_88	40000	EUR	179	73432614	73771912	339298
EUR_88	40000	EUR	179	91490500	91688404	197904
EUR_88	40000	EUR	179	92839624	93411339	571715
EUR_88	40000	EUR	179	99165891	99256465	90574
EUR_89	40000	EUR	180	2839866	3302065	462199
EUR_89	40000	EUR	180	22520588	22557581	36993
EUR_89	40000	EUR	180	32694491	32759145	64654
EUR_89	40000	EUR	180	36284487	36460007	175520
EUR_89	40000	EUR	180	78450355	78519690	69335
EUR_89	40000	EUR	180	81028646	81178805	150159
EUR_89	40000	EUR	181	17938233	17940601	2368
EUR_89	40000	EUR	181	30904434	31092945	188511
EUR_89	40000	EUR	181	36284487	36409286	124799
EUR_89	40000	EUR	181	57427875	57493786	65911
EUR_89	40000	EUR	181	73536039	73672239	136200
EUR_89	40000	EUR	181	74391961	74575318	183357
EUR_89	40000	EUR	181	74780511	75354263	573752
EUR_89	40000	EUR	181	76351824	76403656	51832
EUR_89	40000	EUR	181	80221926	80371833	149907
EUR_89	40000	EUR	181	81186086	81570760	384674
EUR_89	40000	EUR	181	82022289	82195084	172795
EUR_89	40000	EUR	181	96348465	96458269	109804
EUR_89	40000	EUR	181	99883333	1e+08	116667
EUR_90	40000	EUR	182	32440067	32457287	17220
EUR_90	40000	EUR	182	35001631	35184595	182964
EUR_90	40000	EUR	182	35801080	35892995	91915
EUR_90	40000	EUR	182	58946557	58969287	22730
EUR_90	40000	EUR	182	77123560	77201541	77981
EUR_90	40000	EUR	182	77606973	77655195	48222
EUR_90	40000	EUR	182	84235412	84320852	85440
EUR_90	40000	EUR	182	88371824	88910057	538233
EUR_90	40000	EUR	182	89108008	89235318	127310
EUR_90	40000	EUR	182	93344148	93647010	302862
EUR_90	40000	EUR	183	17288353	17397614	109261
EUR_90	40000	EUR	183	18358415	18582716	224301
EUR_90	40000	EUR	183	23028741	23057271	28530
EUR_90	40000	EUR	183	35434558	35528765	94207
EUR_90	40000	EUR	183	44064495	44172311	107816
EUR_90	40000	EUR	183	52224085	52440869	216784
EUR_90	40000	EUR	183	78096571	78140074	43503
EUR_90	40000	EUR	183	89135269	89145996	10727
EUR_90	40000	EUR	183	89223982	89227874	3892
EUR_90	40000	EUR	183	91564790	91851112	286322
EUR_91	40000	EUR	184	5018475	5039122	20647
EUR_91	40000	EUR	184	23432743	23554604	121861
EUR_91	40000	EUR	184	25265405	25305885	40480
EUR_91	40000	EUR	184	29321833	29396318	74485
EUR_91	40000	EUR	184	32694491	32709202	14711
EUR_91	40000	EUR	184	52572348	52662927	90579
EUR_91	40000	EUR	184	57818814	57861351	42537
EUR_91	40000	EUR	184	64074044	64789833	715789
EUR_91	40000	EUR	184	76565220	76704870	139650
EUR_91	40000	EUR	184	80161288	80278256	116968
EUR_91	40000	EUR	184	86916801	87051737	134936
EUR_91	40000	EUR	184	90776367	90969654	193287
EUR_91	40000	EUR	184	91847626	91965764	118138
EUR_91	40000	EUR	184	95802576	95960093	157517
EUR_91	40000	EUR	185	1331884	1685328	353444
EUR_91	40000	EUR	185	7999419	8032094	32675
EUR_91	40000	EUR	185	18211220	18285211	73991
EUR_91	40000	EUR	185	18804103	18882238	78135
EUR_91	40000	EUR	185	23635283	24094707	459424
EUR_91	40000	EUR	185	25228569	25305885	77316
EUR_91	40000	EUR	185	25867195	26436121	568926
EUR_91	40000	EUR	185	54113043	54612977	499934
EUR_91	40000	EUR	185	57198020	57230003	31983
EUR_91	40000	EUR	185	68624378	68717300	92922
EUR_91	40000	EUR	185	75522893	75632489	109596
EUR_91	40000	EUR	185	79842561	80034351	191790
EUR_91	40000	EUR	185	81205893	81229503	23610
EUR_91	40000	EUR	185	94533847	95134856	601009
EUR_91	40000	EUR	185	95853274	96458269	604995
EUR_92	40000	EUR	186	8047139	8134326	87187
EUR_92	40000	EUR	186	16383279	16470198	86919
EUR_92	40000	EUR	186	17185238	17206427	21189
EUR_92	40000	EUR	186	18043301	18304746	261445
EUR_92	40000	EUR	186	23314801	23442163	127362
EUR_92	40000	EUR	186	30954937	31099863	144926
EUR_92	40000	EUR	186	34275078	34351822	76744
EUR_92	40000	EUR	186	36284487	36460007	175520
EUR_92	40000	EUR	186	54113043	54486006	372963
EUR_92	40000	EUR	186	58863206	59098610	235404
EUR_92	40000	EUR	186	79901897	79936163	34266
EUR_92	40000	EUR	186	94907107	95114908	207801
EUR_92	40000	EUR	186	95635926	95829654	193728
EUR_92	40000	EUR	186	96208028	96272917	64889
EUR_92	40000	EUR	187	0	297242	297242
EUR_92	40000	EUR	187	9028319	9054846	26527
EUR_92	40000	EUR	187	11706658	11814111	107453
EUR_92	40000	EUR	187	23156936	23184805	27869
EUR_92	40000	EUR	187	35217748	35413680	195932
EUR_92	40000	EUR	187	52274091	52324546	50455
EUR_92	40000	EUR	187	71544591	71678663	134072
EUR_92	40000	EUR	187	89292536	89445720	153184
EUR_92	40000	EUR	187	93550532	93647010	96478
EUR_93	40000	EUR	188	999494	1458375	458881
EUR_93	40000	EUR	188	10399704	10402156	2452
EUR_93	40000	EUR	188	13902919	14112508	209589
EUR_93	40000	EUR	188	17889447	18882238	992791
EUR_93	40000	EUR	188	21184575	21282925	98350
EUR_93	40000	EUR	188	24892444	24906091	13647
EUR_93	40000	EUR	188	29693031	29706829	13798
EUR_93	40000	EUR	188	40953591	41037792	84201
EUR_93	40000	EUR	188	54403505	54904011	500506
EUR_93	40000	EUR	188	58994813	59631623	636810
EUR_93	40000	EUR	188	75522893	75632489	109596
EUR_93	40000	EUR	188	86780633	86882700	102067
EUR_93	40000	EUR	188	89067780	89099823	32043
EUR_93	40000	EUR	188	93123434	93185797	62363
EUR_93	40000	EUR	188	94918488	95103137	184649
EUR_93	40000	EUR	189	9016073	9197256	181183
EUR_93	40000	EUR	189	25584659	25745738	161079
EUR_93	40000	EUR	189	30827905	31110320	282415
EUR_93	40000	EUR	189	52431552	52434465	2913
EUR_93	40000	EUR	189	54569815	54865385	295570
EUR_93	40000	EUR	189	57712252	57782439	70187
EUR_93	40000	EUR	189	87444841	87656802	211961
EUR_93	40000	EUR	189	88928912	88972858	43946
EUR_93	40000	EUR	189	91018779	91107582	88803
EUR_93	40000	EUR	189	93749592	93902122	152530
EUR_94	40000	EUR	190	4245173	4273461	28288
EUR_94	40000	EUR	190	11790082	12146779	356697
EUR_94	40000	EUR	190	14060449	14112508	52059
EUR_94	40000	EUR	190	18298581	18720971	422390
EUR_94	40000	EUR	190	27760213	27841352	81139
EUR_94	40000	EUR	190	30904434	31092945	188511
EUR_94	40000	EUR	190	52168283	52662927	494644
EUR_94	40000	EUR	190	59553546	59700527	146981
EUR_94	40000	EUR	190	75781447	75810875	29428
EUR_94	40000	EUR	190	77606973	78058706	451733
EUR_94	40000	EUR	190	79203104	79266344	63240
EUR_94	40000	EUR	190	93601452	93725532	124080
EUR_94	40000	EUR	191	231137	295641	64504
EUR_94	40000	EUR	191	12952250	13216293	264043
EUR_94	40000	EUR	191	22429343	22533171	103828
EUR_94	40000	EUR	191	24109296	24211824	102528
EUR_94	40000	EUR	191	26375604	26436121	60517
EUR_94	40000	EUR	191	31102544	31244622	142078
EUR_94	40000	EUR	191	32767431	33016465	249034
EUR_94	40000	EUR	191	57712252	57861351	149099
EUR_94	40000	EUR	191	59279449	59631623	352174
EUR_94	40000	EUR	191	75644076	75770414	126338
EUR_94	40000	EUR	191	78958336	79062108	103772
EUR_94	40000	EUR	191	80863277	80899276	35999
EUR_94	40000	EUR	191	87211398	88109220	897822
EUR_94	40000	EUR	191	88890597	89086538	195941
EUR_94	40000	EUR	191	89932145	90005466	73321
EUR_94	40000	EUR	191	90991558	91107582	116024
EUR_94	40000	EUR	191	91633048	91688404	55356
EUR_94	40000	EUR	191	93601452	93725532	124080
EUR_94	40000	EUR	191	94764637	94952721	188084
EUR_94	40000	EUR	191	99165891	99280798	114907
EUR_95	40000	EUR	192	506666	1079953	573287
EUR_95	40000	EUR	192	1157833	1191560	33727
EUR_95	40000	EUR	192	9180036	9221404	41368
EUR_95	40000	EUR	192	25627344	25731778	104434
EUR_95	40000	EUR	192	59553546	59700527	146981
EUR_95	40000	EUR	192	73208408	73270327	61919
EUR_95	40000	EUR	192	73280417	73494142	213725
EUR_95	40000	EUR	192	75522893	75632489	109596
EUR_95	40000	EUR	192	80161288	80278256	116968
EUR_95	40000	EUR	192	83370620	83384810	14190
EUR_95	40000	EUR	192	89067780	89099823	32043
EUR_95	40000	EUR	192	90084515	90140445	55930
EUR_95	40000	EUR	193	2391690	2633469	241779
EUR_95	40000	EUR	193	5636439	5683801	47362
EUR_95	40000	EUR	193	39847102	39998132	151030
EUR_95	40000	EUR	193	70877012	71025615	148603
EUR_95	40000	EUR	193	74031593	74094072	62479
EUR_95	40000	EUR	193	77147377	77183935	36558
EUR_95	40000	EUR	193	84235412	84320852	85440
EUR_95	40000	EUR	193	87430114	87751923	321809
EUR_95	40000	EUR	193	93680632	93745400	64768
EUR_95	40000	EUR	193	99165891	99280798	114907
EUR_96	40000	EUR	194	8557044	9164904	607860
EUR_96	40000	EUR	194	18358415	18582716	224301
EUR_96	40000	EUR	194	21928836	21976922	48086
EUR_96	40000	EUR	194	22711689	22721112	9423
EUR_96	40000	EUR	194	25817587	25896396	78809
EUR_96	40000	EUR	194	39639062	39985121	346059
EUR_96	40000	EUR	194	43520906	43653793	132887
EUR_96	40000	EUR	194	58037974	58068519	30545
EUR_96	40000	EUR	194	58863206	59631623	768417
EUR_96	40000	EUR	194	74031593	74094072	62479
EUR_96	40000	EUR	194	77147377	77183935	36558
EUR_96	40000	EUR	194	80965087	81229503	264416
EUR_96	40000	EUR	194	89989980	89998439	8459
EUR_96	40000	EUR	194	99165891	99257664	91773
EUR_96	40000	EUR	195	5869977	5924842	54865
EUR_96	40000	EUR	195	12654716	12679639	24923
EUR_96	40000	EUR	195	18057439	18720971	663532
EUR_96	40000	EUR	195	30954937	31099863	144926
EUR_96	40000	EUR	195	35365218	35892995	527777
EUR_96	40000	EUR	195	36050639	36089268	38629
EUR_96	40000	EUR	195	39578272	39934383	356111
EUR_96	40000	EUR	195	70289889	70396556	106667
EUR_96	40000	EUR	195	81083465	81206695	123230
EUR_96	40000	EUR	195	83503362	83550130	46768
EUR_96	40000	EUR	195	89273347	89419331	145984
EUR_96	40000	EUR	195	91847626	91965764	118138
EUR_97	40000	EUR	196	1330157	1426634	96477
EUR_97	40000	EUR	196	9306790	9508417	201627
EUR_97	40000	EUR	196	12903506	13178737	275231
EUR_97	40000	EUR	196	16080883	16681323	600440
EUR_97	40000	EUR	196	18211220	18285211	73991
EUR_97	40000	EUR	196	23165132	23442163	277031
EUR_97	40000	EUR	196	25882194	25904510	22316
EUR_97	40000	EUR	196	29352577	29579668	227091
EUR_97	40000	EUR	196	31179358	31284900	105542
EUR_97	40000	EUR	196	58569405	58694180	124775
EUR_97	40000	EUR	196	64118066	64303963	185897
EUR_97	40000	EUR	196	94692294	94792065	99771
EUR_97	40000	EUR	197	64247601	64487076	239475
EUR_97	40000	EUR	197	73208408	73272664	64256
EUR_97	40000	EUR	197	73830661	73986181	155520
EUR_97	40000	EUR	197	75277319	75352040	74721
EUR_97	40000	EUR	197	76022322	76143984	121662
EUR_97	40000	EUR	197	76577005	76582454	5449
EUR_97	40000	EUR	197	78697685	79134588	436903
EUR_97	40000	EUR	197	79621494	79687804	66310
EUR_97	40000	EUR	197	89449131	89635604	186473
EUR_97	40000	EUR	197	89811998	90328288	516290
EUR_97	40000	EUR	197	90991558	91107582	116024
EUR_97	40000	EUR	197	93862525	94381472	518947
EUR_98	40000	EUR	198	5298404	5368708	70304
EUR_98	40000	EUR	198	12980469	13563211	582742
EUR_98	40000	EUR	198	15993626	16259327	265701
EUR_98	40000	EUR	198	21150173	21156082	5909
EUR_98	40000	EUR	198	21200799	21274841	74042
EUR_98	40000	EUR	198	23752602	24866754	1114152
EUR_98	40000	EUR	198	42214806	42259154	44348
EUR_98	40000	EUR	198	52572348	52662927	90579
EUR_98	40000	EUR	198	79426808	79677897	251089
EUR_98	40000	EUR	198	81186086	81570760	384674
EUR_98	40000	EUR	198	93324220	93429042	104822
EUR_98	40000	EUR	198	93713166	93771010	57844
EUR_98	40000	EUR	198	95010882	95103137	92255
EUR_98	40000	EUR	199	8294108	8606145	312037
EUR_98	40000	EUR	199	17887730	17995472	107742
EUR_98	40000	EUR	199	18159953	18285211	125258
EUR_98	40000	EUR	199	21891229	21972577	81348
EUR_98	40000	EUR	199	25806508	25904510	98002
EUR_98	40000	EUR	199	36825706	37162090	336384
EUR_98	40000	EUR	199	40130671	40522936	392265
EUR_98	40000	EUR	199	40580630	40833757	253127
EUR_98	40000	EUR	199	53525713	53570384	44671
EUR_98	40000	EUR	199	56378802	56480618	101816
EUR_98	40000	EUR	199	57712252	57861351	149099
EUR_98	40000	EUR	199	68212528	68360598	148070
EUR_98	40000	EUR	199	72288615	72471635	183020
EUR_98	40000	EUR	199	73488506	73702901	214395
EUR_98	40000	EUR	199	75863776	75944169	80393
EUR_98	40000	EUR	199	79815074	79964120	149046
EUR_98	40000	EUR	199	86764267	86871442	107175
EUR_98	40000	EUR	199	87211398	88109220	897822
EUR_98	40000	EUR	199	91490500	91688404	197904
EUR_98	40000	EUR	199	92839624	93411339	571715
EUR_98	40000	EUR	199	96289873	96531190	241317
EUR_99	40000	EUR	200	3763591	4134871	371280
EUR_99	40000	EUR	200	13399619	13682425	282806
EUR_99	40000	EUR	200	18229012	18368143	139131
EUR_99	40000	EUR	200	27104809	27323243	218434
EUR_99	40000	EUR	200	30904434	31058545	154111
EUR_99	40000	EUR	200	32694491	32714627	20136
EUR_99	40000	EUR	200	34993565	35110499	116934
EUR_99	40000	EUR	200	41319133	41434185	115052
EUR_99	40000	EUR	200	68624378	68717300	92922
EUR_99	40000	EUR	200	79203104	79266344	63240
EUR_99	40000	EUR	200	85520555	85827016	306461
EUR_99	40000	EUR	200	87366151	87455574	89423
EUR_99	40000	EUR	200	89067780	89099823	32043
EUR_99	40000	EUR	200	90627118	91032380	405262
EUR_99	40000	EUR	200	92990736	93411339	420603
EUR_99	40000	EUR	201	10356570	10462507	105937
EUR_99	40000	EUR	201	13574314	13635433	61119
EUR_99	40000	EUR	201	13640984	13678187	37203
EUR_99	40000	EUR	201	26319359	26580898	261539
EUR_99	40000	EUR	201	52268650	52420473	151823
EUR_99	40000	EUR	201	54113043	54486006	372963
EUR_99	40000	EUR	201	58863206	59215777	352571
EUR_99	40000	EUR	201	75110846	75189189	78343
EUR_99	40000	EUR	201	78831605	79169154	337549
EUR_99	40000	EUR	201	93907950	94439046	531096
EUR_99	40000	EUR	201	95172719	95391485	218766
EUR_99	40000	EUR	201	95774147	95848672	74525
EUR_100	40000	EUR	202	8590848	8606145	15297
EUR_100	40000	EUR	202	13574314	13635433	61119
EUR_100	40000	EUR	202	13640984	13678187	37203
EUR_100	40000	EUR	202	14051019	14112508	61489
EUR_100	40000	EUR	202	22429343	22533171	103828
EUR_100	40000	EUR	202	25817587	25896396	78809
EUR_100	40000	EUR	202	37986594	38028381	41787
EUR_100	40000	EUR	202	51914729	52065556	150827
EUR_100	40000	EUR	202	63714218	63791798	77580
EUR_100	40000	EUR	202	69800148	69878277	78129
EUR_100	40000	EUR	202	75522893	75632489	109596
EUR_100	40000	EUR	202	78096571	78140074	43503
EUR_100	40000	EUR	202	81188272	81206695	18423
EUR_100	40000	EUR	202	87856365	87888944	32579
EUR_100	40000	EUR	202	88221167	88300295	79128
EUR_100	40000	EUR	202	88977652	89025277	47625
EUR_100	40000	EUR	202	89364716	89445720	81004
EUR_100	40000	EUR	202	93010854	93266029	255175
EUR_100	40000	EUR	203	16202082	16527592	325510
EUR_100	40000	EUR	203	25464518	25731778	267260
EUR_100	40000	EUR	203	27288461	27323243	34782
EUR_100	40000	EUR	203	52224085	52440869	216784
EUR_100	40000	EUR	203	54113043	54612977	499934
EUR_100	40000	EUR	203	72326056	72471635	145579
EUR_100	40000	EUR	203	73208408	73270327	61919
EUR_100	40000	EUR	203	73280417	73494142	213725
EUR_100	40000	EUR	203	92847341	92931513	84172
EUR_100	40000	EUR	203	93862525	94381472	518947
EUR_101	30000	EUR	204	2667696	3017345	349649
EUR_101	30000	EUR	204	18081536	18123499	41963
EUR_101	30000	EUR	204	19048228	19169295	121067
EUR_101	30000	EUR	204	20981647	20985217	3570
EUR_101	30000	EUR	204	23097742	23134653	36911
EUR_101	30000	EUR	204	23165262	23267376	102114
EUR_101	30000	EUR	204	24749954	24757234	7280
EUR_101	30000	EUR	204	25140534	25282579	142045
EUR_101	30000	EUR	204	25323974	25538136	214162
EUR_101	30000	EUR	204	29306591	29478208	171617
EUR_101	30000	EUR	204	33317354	33513276	195922
EUR_101	30000	EUR	204	35001631	35087281	85650
EUR_101	30000	EUR	204	54113043	54177383	64340
EUR_101	30000	EUR	204	59554189	59631623	77434
EUR_101	30000	EUR	204	73243224	73275645	32421
EUR_101	30000	EUR	204	73432614	73547669	115055
EUR_101	30000	EUR	204	76577005	76582454	5449
EUR_101	30000	EUR	204	78246564	78301884	55320
EUR_101	30000	EUR	204	90680866	90852419	171553
EUR_101	30000	EUR	204	91093062	91107582	14520
EUR_101	30000	EUR	204	96116814	96182382	65568
EUR_101	30000	EUR	205	2984450	3003090	18640
EUR_101	30000	EUR	205	23631841	23640206	8365
EUR_101	30000	EUR	205	24892444	24906091	13647
EUR_101	30000	EUR	205	25312993	25777999	465006
EUR_101	30000	EUR	205	25867195	25873969	6774
EUR_101	30000	EUR	205	32694491	32883769	189278
EUR_101	30000	EUR	205	35576182	35644241	68059
EUR_101	30000	EUR	205	35736466	35751236	14770
EUR_101	30000	EUR	205	35808641	35892995	84354
EUR_101	30000	EUR	205	36793192	36866743	73551
EUR_101	30000	EUR	205	41319133	41360462	41329
EUR_101	30000	EUR	205	54113043	54177383	64340
EUR_101	30000	EUR	205	72359726	72373817	14091
EUR_101	30000	EUR	205	81031954	81153739	121785
EUR_101	30000	EUR	205	88785572	89010522	224950
EUR_101	30000	EUR	205	89951130	89992015	40885
EUR_101	30000	EUR	205	91633048	91688404	55356
EUR_101	30000	EUR	205	93907950	94180215	272265
EUR_102	30000	EUR	206	4020191	4044195	24004
EUR_102	30000	EUR	206	5789806	5797287	7481
EUR_102	30000	EUR	206	16211469	16325554	114085
EUR_102	30000	EUR	206	17879034	17946855	67821
EUR_102	30000	EUR	206	24372241	24581630	209389
EUR_102	30000	EUR	206	25029419	25134974	105555
EUR_102	30000	EUR	206	25325282	25351680	26398
EUR_102	30000	EUR	206	32694491	32759145	64654
EUR_102	30000	EUR	206	33126757	33233728	106971
EUR_102	30000	EUR	206	35771774	35892995	121221
EUR_102	30000	EUR	206	37854529	37943125	88596
EUR_102	30000	EUR	206	39639062	39692065	53003
EUR_102	30000	EUR	206	41319133	41329331	10198
EUR_102	30000	EUR	206	74441944	74455862	13918
EUR_102	30000	EUR	206	76577005	76577773	768
EUR_102	30000	EUR	206	80338361	80408604	70243
EUR_102	30000	EUR	206	83886982	83957574	70592
EUR_102	30000	EUR	206	87512858	87623148	110290
EUR_102	30000	EUR	206	88816769	89081743	264974
EUR_102	30000	EUR	206	90084515	90140445	55930
EUR_102	30000	EUR	206	91847626	91870258	22632
EUR_102	30000	EUR	206	93539368	93585074	45706
EUR_102	30000	EUR	206	93891415	93925519	34104
EUR_102	30000	EUR	206	94136553	94153428	16875
EUR_102	30000	EUR	206	94956617	94991097	34480
EUR_102	30000	EUR	207	1041641	1079953	38312
EUR_102	30000	EUR	207	1157833	1191560	33727
EUR_102	30000	EUR	207	12799340	12861516	62176
EUR_102	30000	EUR	207	12952250	13014097	61847
EUR_102	30000	EUR	207	13621609	13634873	13264
EUR_102	30000	EUR	207	16202082	16424107	222025
EUR_102	30000	EUR	207	21164327	21282925	118598
EUR_102	30000	EUR	207	22918884	22920110	1226
EUR_102	30000	EUR	207	23631841	23651476	19635
EUR_102	30000	EUR	207	25995113	26195455	200342
EUR_102	30000	EUR	207	33249258	33295884	46626
EUR_102	30000	EUR	207	58925219	59190527	265308
EUR_102	30000	EUR	207	73082356	73223816	141460
EUR_102	30000	EUR	207	75851931	75915063	63132
EUR_102	30000	EUR	207	84755692	84919115	163423
EUR_102	30000	EUR	207	88077880	88172209	94329
EUR_102	30000	EUR	207	88851576	89109575	257999
EUR_102	30000	EUR	207	94898715	94930362	31647
EUR_103	30000	EUR	208	1762556	1807665	45109
EUR_103	30000	EUR	208	1900787	1993052	92265
EUR_103	30000	EUR	208	3763591	4130169	366578
EUR_103	30000	EUR	208	18622886	18806641	183755
EUR_103	30000	EUR	208	22992959	23099324	106365
EUR_103	30000	EUR	208	23584099	23767868	183769
EUR_103	30000	EUR	208	25202727	25392055	189328
EUR_103	30000	EUR	208	25817587	25896396	78809
EUR_103	30000	EUR	208	30904434	31092945	188511
EUR_103	30000	EUR	208	31440500	31636518	196018
EUR_103	30000	EUR	208	32293660	32386245	92585
EUR_103	30000	EUR	208	32694491	32714627	20136
EUR_103	30000	EUR	208	35576182	35644241	68059
EUR_103	30000	EUR	208	36793192	36866743	73551
EUR_103	30000	EUR	208	39595394	39688540	93146
EUR_103	30000	EUR	208	39891566	40081529	189963
EUR_103	30000	EUR	208	53525713	53544702	18989
EUR_103	30000	EUR	208	57712252	57806900	94648
EUR_103	30000	EUR	208	59650996	59762964	111968
EUR_103	30000	EUR	208	70340835	70396556	55721
EUR_103	30000	EUR	208	72359726	72373817	14091
EUR_103	30000	EUR	208	81111648	81190655	79007
EUR_103	30000	EUR	208	84755692	84810053	54361
EUR_103	30000	EUR	208	88219640	88609202	389562
EUR_103	30000	EUR	208	90390897	90393363	2466
EUR_103	30000	EUR	208	91847626	91965764	118138
EUR_103	30000	EUR	208	93272021	93355458	83437
EUR_103	30000	EUR	208	93907950	94439046	531096
EUR_103	30000	EUR	208	94898715	94930362	31647
EUR_103	30000	EUR	208	95270807	95445533	174726
EUR_103	30000	EUR	208	99165891	99280798	114907
EUR_103	30000	EUR	209	47754	411145	363391
EUR_103	30000	EUR	209	1330157	1426634	96477
EUR_103	30000	EUR	209	1900787	1993052	92265
EUR_103	30000	EUR	209	7572302	7743272	170970
EUR_103	30000	EUR	209	18319962	18357509	37547
EUR_103	30000	EUR	209	32262916	32267787	4871
EUR_103	30000	EUR	209	35376714	35465308	88594
EUR_103	30000	EUR	209	40953591	41037792	84201
EUR_103	30000	EUR	209	42164278	42182833	18555
EUR_103	30000	EUR	209	42280145	42432142	151997
EUR_103	30000	EUR	209	43543383	43582534	39151
EUR_103	30000	EUR	209	57805237	57861351	56114
EUR_103	30000	EUR	209	72226457	72349727	123270
EUR_103	30000	EUR	209	73488506	73675439	186933
EUR_103	30000	EUR	209	86508335	86539843	31508
EUR_103	30000	EUR	209	88025602	88093768	68166
EUR_103	30000	EUR	209	93416072	93429042	12970
EUR_103	30000	EUR	209	93943380	94056780	113400
EUR_104	30000	EUR	210	8348919	8636070	287151
EUR_104	30000	EUR	210	8734503	8737332	2829
EUR_104	30000	EUR	210	17350938	17365688	14750
EUR_104	30000	EUR	210	17889447	18016499	127052
EUR_104	30000	EUR	210	21150828	21225412	74584
EUR_104	30000	EUR	210	23346980	23492340	145360
EUR_104	30000	EUR	210	25140534	25209294	68760
EUR_104	30000	EUR	210	26392689	26436121	43432
EUR_104	30000	EUR	210	28610778	28746647	135869
EUR_104	30000	EUR	210	32694491	32748960	54469
EUR_104	30000	EUR	210	36340804	36448963	108159
EUR_104	30000	EUR	210	49714605	50018640	304035
EUR_104	30000	EUR	210	53821064	54035252	214188
EUR_104	30000	EUR	210	54686744	54714097	27353
EUR_104	30000	EUR	210	59388351	59522281	133930
EUR_104	30000	EUR	210	73084096	73167448	83352
EUR_104	30000	EUR	210	73621363	73642412	21049
EUR_104	30000	EUR	210	75089161	75123826	34665
EUR_104	30000	EUR	210	75277319	75352040	74721
EUR_104	30000	EUR	210	76558352	76909487	351135
EUR_104	30000	EUR	210	79927591	79929594	2003
EUR_104	30000	EUR	210	86508335	86539843	31508
EUR_104	30000	EUR	210	87727929	87888944	161015
EUR_104	30000	EUR	210	88221167	88300295	79128
EUR_104	30000	EUR	210	91633048	91688404	55356
EUR_104	30000	EUR	210	93961556	94024513	62957
EUR_104	30000	EUR	210	96116814	96203122	86308
EUR_104	30000	EUR	210	96910874	97008044	97170
EUR_104	30000	EUR	211	8348919	8386782	37863
EUR_104	30000	EUR	211	9321331	9449917	128586
EUR_104	30000	EUR	211	17350938	17365688	14750
EUR_104	30000	EUR	211	17889447	18016499	127052
EUR_104	30000	EUR	211	19122962	19169295	46333
EUR_104	30000	EUR	211	20981647	21292382	310735
EUR_104	30000	EUR	211	22454245	22608307	154062
EUR_104	30000	EUR	211	25066876	25088413	21537
EUR_104	30000	EUR	211	25189085	25229304	40219
EUR_104	30000	EUR	211	26375604	26436121	60517
EUR_104	30000	EUR	211	31551025	31605832	54807
EUR_104	30000	EUR	211	31689841	31760061	70220
EUR_104	30000	EUR	211	38009742	38097333	87591
EUR_104	30000	EUR	211	40953591	41037792	84201
EUR_104	30000	EUR	211	43359651	43531979	172328
EUR_104	30000	EUR	211	54749914	54904011	154097
EUR_104	30000	EUR	211	59620225	59631623	11398
EUR_104	30000	EUR	211	72226457	72289409	62952
EUR_104	30000	EUR	211	76486431	76589990	103559
EUR_104	30000	EUR	211	77803269	77815455	12186
EUR_104	30000	EUR	211	86508335	86539843	31508
EUR_104	30000	EUR	211	87771619	87826223	54604
EUR_104	30000	EUR	211	88731415	88988477	257062
EUR_104	30000	EUR	211	91018779	91107582	88803
EUR_105	30000	EUR	212	2737848	2740181	2333
EUR_105	30000	EUR	212	4020191	4044195	24004
EUR_105	30000	EUR	212	8763102	8909640	146538
EUR_105	30000	EUR	212	22447027	22516689	69662
EUR_105	30000	EUR	212	25454373	25525533	71160
EUR_105	30000	EUR	212	25817587	25896396	78809
EUR_105	30000	EUR	212	29357693	29365834	8141
EUR_105	30000	EUR	212	36791405	36864514	73109
EUR_105	30000	EUR	212	39847102	40083980	236878
EUR_105	30000	EUR	212	49714605	49785207	70602
EUR_105	30000	EUR	212	69852251	69860988	8737
EUR_105	30000	EUR	212	71544591	71561815	17224
EUR_105	30000	EUR	212	72326056	72471635	145579
EUR_105	30000	EUR	212	75110846	75189189	78343
EUR_105	30000	EUR	212	77606973	77885640	278667
EUR_105	30000	EUR	212	86810612	86824341	13729
EUR_105	30000	EUR	212	88221167	88300295	79128
EUR_105	30000	EUR	212	88324698	88877558	552860
EUR_105	30000	EUR	212	89067780	89099823	32043
EUR_105	30000	EUR	212	90195857	90532466	336609
EUR_105	30000	EUR	212	92839624	93277691	438067
EUR_105	30000	EUR	212	96910874	97008044	97170
EUR_105	30000	EUR	213	1735950	2000286	264336
EUR_105	30000	EUR	213	11722336	11814111	91775
EUR_105	30000	EUR	213	23120612	23184805	64193
EUR_105	30000	EUR	213	25612661	25648626	35965
EUR_105	30000	EUR	213	25867195	25987107	119912
EUR_105	30000	EUR	213	29357693	29365834	8141
EUR_105	30000	EUR	213	30904434	30925177	20743
EUR_105	30000	EUR	213	31517304	31674144	156840
EUR_105	30000	EUR	213	41319133	41360462	41329
EUR_105	30000	EUR	213	71700744	71764001	63257
EUR_105	30000	EUR	213	71780368	71820558	40190
EUR_105	30000	EUR	213	72373480	72471635	98155
EUR_105	30000	EUR	213	74871541	74894548	23007
EUR_105	30000	EUR	213	75587305	75641163	53858
EUR_105	30000	EUR	213	76798443	77082685	284242
EUR_105	30000	EUR	213	79203104	79266344	63240
EUR_105	30000	EUR	213	81072057	81229503	157446
EUR_105	30000	EUR	213	83886982	83957574	70592
EUR_105	30000	EUR	213	85579439	85788658	209219
EUR_105	30000	EUR	213	88977384	89124034	146650
EUR_105	30000	EUR	213	90996188	91107582	111394
EUR_105	30000	EUR	213	93948380	94092405	144025
EUR_105	30000	EUR	213	95774147	96346551	572404
EUR_106	30000	EUR	214	22283237	22433412	150175
EUR_106	30000	EUR	214	23648833	23651476	2643
EUR_106	30000	EUR	214	25066876	25088413	21537
EUR_106	30000	EUR	214	25189085	25231890	42805
EUR_106	30000	EUR	214	25996109	26005477	9368
EUR_106	30000	EUR	214	27746608	27974945	228337
EUR_106	30000	EUR	214	28111916	28139866	27950
EUR_106	30000	EUR	214	31614426	31760061	145635
EUR_106	30000	EUR	214	33486908	33513276	26368
EUR_106	30000	EUR	214	42473584	42574352	100768
EUR_106	30000	EUR	214	54686744	54714097	27353
EUR_106	30000	EUR	214	58925219	59052286	127067
EUR_106	30000	EUR	214	59553546	59762964	209418
EUR_106	30000	EUR	214	75089161	75282527	193366
EUR_106	30000	EUR	214	77961610	78058706	97096
EUR_106	30000	EUR	214	78697685	79134588	436903
EUR_106	30000	EUR	214	88219640	88609202	389562
EUR_106	30000	EUR	214	89989980	89998439	8459
EUR_106	30000	EUR	214	94312012	94382190	70178
EUR_106	30000	EUR	214	94793518	95112420	318902
EUR_106	30000	EUR	214	95774147	95901699	127552
EUR_106	30000	EUR	214	99972505	1e+08	27495
EUR_106	30000	EUR	215	7287218	7640434	353216
EUR_106	30000	EUR	215	11587029	11814111	227082
EUR_106	30000	EUR	215	12903506	12956070	52564
EUR_106	30000	EUR	215	13993038	14112508	119470
EUR_106	30000	EUR	215	17333821	17397614	63793
EUR_106	30000	EUR	215	24892444	24906091	13647
EUR_106	30000	EUR	215	25806508	25855304	48796
EUR_106	30000	EUR	215	40034308	40128543	94235
EUR_106	30000	EUR	215	72226457	72349727	123270
EUR_106	30000	EUR	215	72961212	73172795	211583
EUR_106	30000	EUR	215	73488506	73660589	172083
EUR_106	30000	EUR	215	74055055	74094072	39017
EUR_106	30000	EUR	215	76139818	76143984	4166
EUR_106	30000	EUR	215	77800262	78037381	237119
EUR_106	30000	EUR	215	87512858	87623148	110290
EUR_106	30000	EUR	215	88152919	88153791	872
EUR_106	30000	EUR	215	93168828	93264500	95672
EUR_106	30000	EUR	215	93800814	94544971	744157
EUR_106	30000	EUR	215	95774147	95778109	3962
EUR_106	30000	EUR	215	96136238	96175807	39569
EUR_107	30000	EUR	216	1041641	1079953	38312
EUR_107	30000	EUR	216	1157833	1191560	33727
EUR_107	30000	EUR	216	4020191	4044195	24004
EUR_107	30000	EUR	216	5018475	5041230	22755
EUR_107	30000	EUR	216	8671903	8714283	42380
EUR_107	30000	EUR	216	9413335	9449917	36582
EUR_107	30000	EUR	216	18043301	18304746	261445
EUR_107	30000	EUR	216	20981647	21202559	220912
EUR_107	30000	EUR	216	23346980	23651476	304496
EUR_107	30000	EUR	216	25264173	25276538	12365
EUR_107	30000	EUR	216	26319359	26580898	261539
EUR_107	30000	EUR	216	26849817	26889089	39272
EUR_107	30000	EUR	216	32694491	32715470	20979
EUR_107	30000	EUR	216	57712252	57714199	1947
EUR_107	30000	EUR	216	59201786	59215777	13991
EUR_107	30000	EUR	216	69740511	69942832	202321
EUR_107	30000	EUR	216	72226457	72349727	123270
EUR_107	30000	EUR	216	75089161	75171592	82431
EUR_107	30000	EUR	216	79678655	79687804	9149
EUR_107	30000	EUR	216	80931458	81084087	152629
EUR_107	30000	EUR	216	88175028	88280712	105684
EUR_107	30000	EUR	216	88825376	88985483	160107
EUR_107	30000	EUR	216	90660950	90852419	191469
EUR_107	30000	EUR	216	90916070	90969654	53584
EUR_107	30000	EUR	216	94956617	94991097	34480
EUR_107	30000	EUR	217	2667696	2705753	38057
EUR_107	30000	EUR	217	8348919	8636070	287151
EUR_107	30000	EUR	217	8734503	8737332	2829
EUR_107	30000	EUR	217	12764351	12953142	188791
EUR_107	30000	EUR	217	29693031	29706829	13798
EUR_107	30000	EUR	217	31451275	31636518	185243
EUR_107	30000	EUR	217	59554189	59631623	77434
EUR_107	30000	EUR	217	64394637	64449186	54549
EUR_107	30000	EUR	217	81205893	81211900	6007
EUR_107	30000	EUR	217	83886982	83957574	70592
EUR_107	30000	EUR	217	88208344	88340224	131880
EUR_107	30000	EUR	217	88761110	88797478	36368
EUR_107	30000	EUR	217	89811998	89914231	102233
EUR_107	30000	EUR	217	89989980	89998439	8459
EUR_107	30000	EUR	217	93680632	93680672	40
EUR_107	30000	EUR	217	94898715	94930362	31647
EUR_108	30000	EUR	218	1762556	1775834	13278
EUR_108	30000	EUR	218	5018475	5041230	22755
EUR_108	30000	EUR	218	13094162	13213765	119603
EUR_108	30000	EUR	218	13552023	13563211	11188
EUR_108	30000	EUR	218	16617173	16681323	64150
EUR_108	30000	EUR	218	21829676	21871690	42014
EUR_108	30000	EUR	218	25190794	25235709	44915
EUR_108	30000	EUR	218	26319359	26580898	261539
EUR_108	30000	EUR	218	29306591	29365834	59243
EUR_108	30000	EUR	218	35398401	35528765	130364
EUR_108	30000	EUR	218	43520906	43653793	132887
EUR_108	30000	EUR	218	51914729	51974159	59430
EUR_108	30000	EUR	218	52168283	52173075	4792
EUR_108	30000	EUR	218	56378802	56480618	101816
EUR_108	30000	EUR	218	57789603	57861351	71748
EUR_108	30000	EUR	218	59553546	59700527	146981
EUR_108	30000	EUR	218	72288615	72408032	119417
EUR_108	30000	EUR	218	78246564	78301884	55320
EUR_108	30000	EUR	218	84755692	84898189	142497
EUR_108	30000	EUR	218	88219640	88609202	389562
EUR_108	30000	EUR	218	90390897	90393363	2466
EUR_108	30000	EUR	218	91847626	91965764	118138
EUR_108	30000	EUR	218	93272021	93355458	83437
EUR_108	30000	EUR	218	93907950	94439046	531096
EUR_108	30000	EUR	218	94898715	94930362	31647
EUR_108	30000	EUR	218	95270807	95445533	174726
EUR_108	30000	EUR	219	8038029	8053067	15038
EUR_108	30000	EUR	219	22113151	22313169	200018
EUR_108	30000	EUR	219	23346980	23651476	304496
EUR_108	30000	EUR	219	25323974	25378298	54324
EUR_108	30000	EUR	219	36634451	36678544	44093
EUR_108	30000	EUR	219	42164278	42208086	43808
EUR_108	30000	EUR	219	54113043	54177383	64340
EUR_108	30000	EUR	219	58057212	58136140	78928
EUR_108	30000	EUR	219	58863206	59072585	209379
EUR_108	30000	EUR	219	64338347	64519080	180733
EUR_108	30000	EUR	219	71593748	71666621	72873
EUR_108	30000	EUR	219	74019705	74094072	74367
EUR_108	30000	EUR	219	78697685	78877275	179590
EUR_108	30000	EUR	219	83886982	83957574	70592
EUR_108	30000	EUR	219	85353810	85490844	137034
EUR_108	30000	EUR	219	86916801	87051737	134936
EUR_108	30000	EUR	219	87771619	87826223	54604
EUR_108	30000	EUR	219	90379514	90852419	472905
EUR_108	30000	EUR	219	93303963	93395321	91358
EUR_108	30000	EUR	219	93475944	93494576	18632
EUR_108	30000	EUR	219	95829965	95927099	97134
EUR_108	30000	EUR	219	99177558	99280798	103240
EUR_109	30000	EUR	220	1096442	1099262	2820
EUR_109	30000	EUR	220	1157833	1191560	33727
EUR_109	30000	EUR	220	13737173	13836055	98882
EUR_109	30000	EUR	220	26626799	26642283	15484
EUR_109	30000	EUR	220	29321833	29396318	74485
EUR_109	30000	EUR	220	38009742	38097333	87591
EUR_109	30000	EUR	220	54567449	54612977	45528
EUR_109	30000	EUR	220	64338347	64360469	22122
EUR_109	30000	EUR	220	72359726	72373817	14091
EUR_109	30000	EUR	220	73115427	73223816	108389
EUR_109	30000	EUR	220	73745706	73906350	160644
EUR_109	30000	EUR	220	76558352	76687371	129019
EUR_109	30000	EUR	220	87140553	87455574	315021
EUR_109	30000	EUR	220	88087834	88146039	58205
EUR_109	30000	EUR	220	91633048	91688404	55356
EUR_109	30000	EUR	220	91891040	91902611	11571
EUR_109	30000	EUR	220	93721614	93725532	3918
EUR_109	30000	EUR	220	93891415	93925519	34104
EUR_109	30000	EUR	220	94447447	94522438	74991
EUR_109	30000	EUR	220	94793518	94850934	57416
EUR_109	30000	EUR	220	95821549	95880389	58840
EUR_109	30000	EUR	221	5253381	5276460	23079
EUR_109	30000	EUR	221	25554348	25609073	54725
EUR_109	30000	EUR	221	26889967	26991485	101518
EUR_109	30000	EUR	221	29273800	29311528	37728
EUR_109	30000	EUR	221	30889388	31091299	201911
EUR_109	30000	EUR	221	31829003	32066311	237308
EUR_109	30000	EUR	221	34845302	35179585	334283
EUR_109	30000	EUR	221	35853020	35892995	39975
EUR_109	30000	EUR	221	42793149	42823699	30550
EUR_109	30000	EUR	221	54570050	54578539	8489
EUR_109	30000	EUR	221	54686744	54714097	27353
EUR_109	30000	EUR	221	72226457	72349727	123270
EUR_109	30000	EUR	221	73243224	73275645	32421
EUR_109	30000	EUR	221	79927591	79929594	2003
EUR_109	30000	EUR	221	80952803	81165675	212872
EUR_109	30000	EUR	221	91847626	91965764	118138
EUR_109	30000	EUR	221	93303963	93395321	91358
EUR_109	30000	EUR	221	93601452	93725532	124080
EUR_109	30000	EUR	221	94163899	94305058	141159
EUR_109	30000	EUR	221	94793518	95112420	318902
EUR_110	30000	EUR	222	5018475	5041230	22755
EUR_110	30000	EUR	222	13621609	13626532	4923
EUR_110	30000	EUR	222	23165262	23267376	102114
EUR_110	30000	EUR	222	24045382	24057220	11838
EUR_110	30000	EUR	222	25412616	25424688	12072
EUR_110	30000	EUR	222	25867195	25987107	119912
EUR_110	30000	EUR	222	31113073	31133912	20839
EUR_110	30000	EUR	222	39946242	40128543	182301
EUR_110	30000	EUR	222	73208408	73275645	67237
EUR_110	30000	EUR	222	85353810	85490844	137034
EUR_110	30000	EUR	222	86916801	87051737	134936
EUR_110	30000	EUR	222	87771619	87826223	54604
EUR_110	30000	EUR	222	90680866	90852419	171553
EUR_110	30000	EUR	222	91093062	91107582	14520
EUR_110	30000	EUR	222	96116814	96182382	65568
EUR_110	30000	EUR	223	12968700	13133318	164618
EUR_110	30000	EUR	223	17889447	17902017	12570
EUR_110	30000	EUR	223	21150173	21156082	5909
EUR_110	30000	EUR	223	21200799	21216283	15484
EUR_110	30000	EUR	223	23457295	23569549	112254
EUR_110	30000	EUR	223	25817587	25896396	78809
EUR_110	30000	EUR	223	31065764	31127610	61846
EUR_110	30000	EUR	223	34985092	35249775	264683
EUR_110	30000	EUR	223	35576182	35644241	68059
EUR_110	30000	EUR	223	35736466	35751236	14770
EUR_110	30000	EUR	223	42821514	42823699	2185
EUR_110	30000	EUR	223	52316366	52427775	111409
EUR_110	30000	EUR	223	64321831	64328268	6437
EUR_110	30000	EUR	223	76139818	76140066	248
EUR_110	30000	EUR	223	78423267	78441272	18005
EUR_110	30000	EUR	223	81072057	81103247	31190
EUR_110	30000	EUR	223	83568754	83592822	24068
EUR_110	30000	EUR	223	86843936	86882700	38764
EUR_110	30000	EUR	223	88087834	88160768	72934
EUR_110	30000	EUR	223	88951047	89050718	99671
EUR_110	30000	EUR	223	90058636	90243516	184880
EUR_110	30000	EUR	223	91025410	91107582	82172
EUR_110	30000	EUR	223	91987726	92081240	93514
EUR_110	30000	EUR	223	93943380	94056780	113400
EUR_110	30000	EUR	223	96190489	96318141	127652
EUR_110	30000	EUR	223	96347515	96458269	110754
EUR_111	30000	EUR	224	3763591	3801794	38203
EUR_111	30000	EUR	224	5018475	5041230	22755
EUR_111	30000	EUR	224	8183818	8207134	23316
EUR_111	30000	EUR	224	9413335	9449917	36582
EUR_111	30000	EUR	224	11532006	11689566	157560
EUR_111	30000	EUR	224	16243211	16437214	194003
EUR_111	30000	EUR	224	22447027	22533171	86144
EUR_111	30000	EUR	224	23752602	23877108	124506
EUR_111	30000	EUR	224	24621120	24737906	116786
EUR_111	30000	EUR	224	28661038	28670280	9242
EUR_111	30000	EUR	224	29321833	29396318	74485
EUR_111	30000	EUR	224	30804231	31151086	346855
EUR_111	30000	EUR	224	34999082	35095643	96561
EUR_111	30000	EUR	224	36744092	36864514	120422
EUR_111	30000	EUR	224	41350421	41360462	10041
EUR_111	30000	EUR	224	68675332	68717300	41968
EUR_111	30000	EUR	224	75110846	75189189	78343
EUR_111	30000	EUR	224	87533821	87546866	13045
EUR_111	30000	EUR	224	88870634	88877558	6924
EUR_111	30000	EUR	224	89067780	89099823	32043
EUR_111	30000	EUR	224	90769120	90852419	83299
EUR_111	30000	EUR	224	96116814	96337375	220561
EUR_111	30000	EUR	225	9413335	9449917	36582
EUR_111	30000	EUR	225	16397154	16497900	100746
EUR_111	30000	EUR	225	20981647	21232899	251252
EUR_111	30000	EUR	225	21258424	21429464	171040
EUR_111	30000	EUR	225	24088240	24211824	123584
EUR_111	30000	EUR	225	25177020	25305885	128865
EUR_111	30000	EUR	225	25723973	25777999	54026
EUR_111	30000	EUR	225	25867195	25982719	115524
EUR_111	30000	EUR	225	32694491	32696957	2466
EUR_111	30000	EUR	225	33430359	33479750	49391
EUR_111	30000	EUR	225	35231079	35249775	18696
EUR_111	30000	EUR	225	35576182	35644241	68059
EUR_111	30000	EUR	225	35736466	35751236	14770
EUR_111	30000	EUR	225	35808641	35892995	84354
EUR_111	30000	EUR	225	36050639	36089268	38629
EUR_111	30000	EUR	225	64074044	64094340	20296
EUR_111	30000	EUR	225	70340835	70380749	39914
EUR_111	30000	EUR	225	71700744	71820558	119814
EUR_111	30000	EUR	225	75632052	75641163	9111
EUR_111	30000	EUR	225	77606973	77793446	186473
EUR_111	30000	EUR	225	80852609	80890918	38309
EUR_111	30000	EUR	225	86620325	86627529	7204
EUR_111	30000	EUR	225	87211398	87479720	268322
EUR_111	30000	EUR	225	87925971	88109220	183249
EUR_111	30000	EUR	225	88797692	88850286	52594
EUR_111	30000	EUR	225	91532322	91685857	153535
EUR_111	30000	EUR	225	94368646	94439046	70400
EUR_111	30000	EUR	225	94991140	95061112	69972
EUR_111	30000	EUR	225	96216033	96293794	77761
EUR_111	30000	EUR	225	99972505	1e+08	27495
EUR_112	30000	EUR	226	5253381	5312534	59153
EUR_112	30000	EUR	226	11622387	11762288	139901
EUR_112	30000	EUR	226	13574314	13635433	61119
EUR_112	30000	EUR	226	13640984	13678187	37203
EUR_112	30000	EUR	226	14051019	14112508	61489
EUR_112	30000	EUR	226	21002390	21212552	210162
EUR_112	30000	EUR	226	23165262	23267376	102114
EUR_112	30000	EUR	226	26319359	26580898	261539
EUR_112	30000	EUR	226	27746608	27974945	228337
EUR_112	30000	EUR	226	28111916	28139866	27950
EUR_112	30000	EUR	226	34845302	35163407	318105
EUR_112	30000	EUR	226	36284487	36460007	175520
EUR_112	30000	EUR	226	36793192	36869887	76695
EUR_112	30000	EUR	226	37805274	37943125	137851
EUR_112	30000	EUR	226	49702405	49809814	107409
EUR_112	30000	EUR	226	51914729	51974159	59430
EUR_112	30000	EUR	226	53549372	53568845	19473
EUR_112	30000	EUR	226	54113043	54177383	64340
EUR_112	30000	EUR	226	57712252	57806900	94648
EUR_112	30000	EUR	226	59578454	59745811	167357
EUR_112	30000	EUR	226	72373480	72471635	98155
EUR_112	30000	EUR	226	77751346	77881732	130386
EUR_112	30000	EUR	226	79661746	79687804	26058
EUR_112	30000	EUR	226	79824188	79933512	109324
EUR_112	30000	EUR	226	80852609	80890918	38309
EUR_112	30000	EUR	226	83370620	83384810	14190
EUR_112	30000	EUR	226	93981861	94073065	91204
EUR_112	30000	EUR	226	94179666	94275496	95830
EUR_112	30000	EUR	226	94312012	94382190	70178
EUR_112	30000	EUR	226	95436278	95445533	9255
EUR_112	30000	EUR	226	95774147	96346551	572404
EUR_112	30000	EUR	227	3047708	3053070	5362
EUR_112	30000	EUR	227	12799340	12861516	62176
EUR_112	30000	EUR	227	12952250	13014097	61847
EUR_112	30000	EUR	227	13621609	13634873	13264
EUR_112	30000	EUR	227	20380295	20455191	74896
EUR_112	30000	EUR	227	22447027	22450031	3004
EUR_112	30000	EUR	227	22918884	22920110	1226
EUR_112	30000	EUR	227	23631841	23651476	19635
EUR_112	30000	EUR	227	25325282	25347092	21810
EUR_112	30000	EUR	227	25817587	25896396	78809
EUR_112	30000	EUR	227	34999082	35110499	111417
EUR_112	30000	EUR	227	36793192	36855179	61987
EUR_112	30000	EUR	227	36887403	37108955	221552
EUR_112	30000	EUR	227	37822300	38097333	275033
EUR_112	30000	EUR	227	42280145	42468277	188132
EUR_112	30000	EUR	227	53821064	54075933	254869
EUR_112	30000	EUR	227	64321831	64406792	84961
EUR_112	30000	EUR	227	68657536	68659055	1519
EUR_112	30000	EUR	227	68996935	69082650	85715
EUR_112	30000	EUR	227	70340835	70396556	55721
EUR_112	30000	EUR	227	71700744	71820558	119814
EUR_112	30000	EUR	227	73647668	73705981	58313
EUR_112	30000	EUR	227	74055055	74094072	39017
EUR_112	30000	EUR	227	75587305	75641163	53858
EUR_112	30000	EUR	227	76994847	76996812	1965
EUR_112	30000	EUR	227	86843936	86882700	38764
EUR_112	30000	EUR	227	88951047	89050718	99671
EUR_112	30000	EUR	227	91337361	91345303	7942
EUR_112	30000	EUR	227	91489890	91672576	182686
EUR_112	30000	EUR	227	91847626	91965764	118138
EUR_112	30000	EUR	227	93474092	93647010	172918
EUR_113	30000	EUR	228	1330157	1426634	96477
EUR_113	30000	EUR	228	3281249	3302065	20816
EUR_113	30000	EUR	228	19048228	19118143	69915
EUR_113	30000	EUR	228	20359744	20455191	95447
EUR_113	30000	EUR	228	25806508	25855304	48796
EUR_113	30000	EUR	228	28599684	28692721	93037
EUR_113	30000	EUR	228	29306591	29478208	171617
EUR_113	30000	EUR	228	30904434	31007609	103175
EUR_113	30000	EUR	228	31574534	31605832	31298
EUR_113	30000	EUR	228	32694491	32699337	4846
EUR_113	30000	EUR	228	35771774	35892995	121221
EUR_113	30000	EUR	228	39639062	39692065	53003
EUR_113	30000	EUR	228	39907281	40083980	176699
EUR_113	30000	EUR	228	59130252	59214311	84059
EUR_113	30000	EUR	228	63714218	63732455	18237
EUR_113	30000	EUR	228	71700744	71815267	114523
EUR_113	30000	EUR	228	73488506	73675439	186933
EUR_113	30000	EUR	228	79824188	79933512	109324
EUR_113	30000	EUR	228	83886982	83957574	70592
EUR_113	30000	EUR	228	84821219	84832204	10985
EUR_113	30000	EUR	228	88219640	88382260	162620
EUR_113	30000	EUR	229	2984450	3003090	18640
EUR_113	30000	EUR	229	11532006	11814111	282105
EUR_113	30000	EUR	229	16617173	16681323	64150
EUR_113	30000	EUR	229	21164327	21282925	118598
EUR_113	30000	EUR	229	23176150	23184805	8655
EUR_113	30000	EUR	229	31113073	31133912	20839
EUR_113	30000	EUR	229	32694491	32768500	74009
EUR_113	30000	EUR	229	32808818	32858850	50032
EUR_113	30000	EUR	229	34999082	35063297	64215
EUR_113	30000	EUR	229	37937722	37943125	5403
EUR_113	30000	EUR	229	52626149	52662927	36778
EUR_113	30000	EUR	229	53525713	53544702	18989
EUR_113	30000	EUR	229	56378802	56480618	101816
EUR_113	30000	EUR	229	59650996	59762964	111968
EUR_113	30000	EUR	229	68624378	68673073	48695
EUR_113	30000	EUR	229	70541408	70544348	2940
EUR_113	30000	EUR	229	79862860	79933512	70652
EUR_113	30000	EUR	229	84755692	84919115	163423
EUR_113	30000	EUR	229	88798999	88877558	78559
EUR_113	30000	EUR	229	89067780	89099823	32043
EUR_113	30000	EUR	229	90996188	91107582	111394
EUR_113	30000	EUR	229	94388014	94445886	57872
EUR_113	30000	EUR	229	94793518	94923900	130382
EUR_114	30000	EUR	230	5253381	5312534	59153
EUR_114	30000	EUR	230	8183818	8207134	23316
EUR_114	30000	EUR	230	13229731	13301006	71275
EUR_114	30000	EUR	230	16234928	16286721	51793
EUR_114	30000	EUR	230	23176150	23184805	8655
EUR_114	30000	EUR	230	24749954	24757234	7280
EUR_114	30000	EUR	230	31842746	31866371	23625
EUR_114	30000	EUR	230	36284487	36358923	74436
EUR_114	30000	EUR	230	42732475	42823699	91224
EUR_114	30000	EUR	230	59013499	59098610	85111
EUR_114	30000	EUR	230	59679467	59700527	21060
EUR_114	30000	EUR	230	75110846	75189189	78343
EUR_114	30000	EUR	230	79901897	79936163	34266
EUR_114	30000	EUR	230	80161288	80278256	116968
EUR_114	30000	EUR	230	83533777	83550130	16353
EUR_114	30000	EUR	230	83554127	83592822	38695
EUR_114	30000	EUR	230	84755692	84919115	163423
EUR_114	30000	EUR	230	91511715	91688404	176689
EUR_114	30000	EUR	230	93981861	94313443	331582
EUR_114	30000	EUR	231	166193	369282	203089
EUR_114	30000	EUR	231	1534378	1685328	150950
EUR_114	30000	EUR	231	3763591	4052999	289408
EUR_114	30000	EUR	231	5253381	5312534	59153
EUR_114	30000	EUR	231	8651970	8714283	62313
EUR_114	30000	EUR	231	13002286	13178737	176451
EUR_114	30000	EUR	231	24749954	24757234	7280
EUR_114	30000	EUR	231	24975030	25134974	159944
EUR_114	30000	EUR	231	25212513	25305885	93372
EUR_114	30000	EUR	231	33054627	33322537	267910
EUR_114	30000	EUR	231	34845302	35027869	182567
EUR_114	30000	EUR	231	35562258	35707528	145270
EUR_114	30000	EUR	231	59554189	59631623	77434
EUR_114	30000	EUR	231	64074044	64094340	20296
EUR_114	30000	EUR	231	72359726	72373817	14091
EUR_114	30000	EUR	231	81419681	81567095	147414
EUR_114	30000	EUR	231	88077880	88172209	94329
EUR_114	30000	EUR	231	88913719	89004089	90370
EUR_114	30000	EUR	231	89989980	89998439	8459
EUR_114	30000	EUR	231	90660950	90697106	36156
EUR_114	30000	EUR	231	93277783	93322262	44479
EUR_114	30000	EUR	231	93891415	93925519	34104
EUR_114	30000	EUR	231	94793518	94850934	57416
EUR_114	30000	EUR	231	96439714	96790795	351081
EUR_115	30000	EUR	232	8348919	8386782	37863
EUR_115	30000	EUR	232	9321331	9449917	128586
EUR_115	30000	EUR	232	17922377	18016499	94122
EUR_115	30000	EUR	232	19122962	19169295	46333
EUR_115	30000	EUR	232	22519633	22533171	13538
EUR_115	30000	EUR	232	22579230	22608307	29077
EUR_115	30000	EUR	232	22890136	23206189	316053
EUR_115	30000	EUR	232	23432743	23503377	70634
EUR_115	30000	EUR	232	23631841	23651476	19635
EUR_115	30000	EUR	232	25264173	25265065	892
EUR_115	30000	EUR	232	25385795	25399467	13672
EUR_115	30000	EUR	232	30804231	30886133	81902
EUR_115	30000	EUR	232	32262916	32267787	4871
EUR_115	30000	EUR	232	36284487	36377821	93334
EUR_115	30000	EUR	232	36793192	36866743	73551
EUR_115	30000	EUR	232	43359651	43515922	156271
EUR_115	30000	EUR	232	58863206	58984528	121322
EUR_115	30000	EUR	232	59650996	59762964	111968
EUR_115	30000	EUR	232	68679546	68717300	37754
EUR_115	30000	EUR	232	72961212	73494142	532930
EUR_115	30000	EUR	232	75522893	75632489	109596
EUR_115	30000	EUR	232	76139818	76143984	4166
EUR_115	30000	EUR	232	76798443	77082685	284242
EUR_115	30000	EUR	232	80520393	80530144	9751
EUR_115	30000	EUR	232	80863277	80899276	35999
EUR_115	30000	EUR	232	89067780	89099823	32043
EUR_115	30000	EUR	232	90754357	90820915	66558
EUR_115	30000	EUR	232	91337361	91345303	7942
EUR_115	30000	EUR	232	91847626	91875197	27571
EUR_115	30000	EUR	232	93961556	94092405	130849
EUR_115	30000	EUR	232	94885812	94898377	12565
EUR_115	30000	EUR	232	94898715	94930362	31647
EUR_115	30000	EUR	233	7287218	7531751	244533
EUR_115	30000	EUR	233	22454245	22608307	154062
EUR_115	30000	EUR	233	23148716	23184805	36089
EUR_115	30000	EUR	233	29321833	29396318	74485
EUR_115	30000	EUR	233	37777188	38097333	320145
EUR_115	30000	EUR	233	52572348	52662927	90579
EUR_115	30000	EUR	233	57712252	57806900	94648
EUR_115	30000	EUR	233	63714218	63803837	89619
EUR_115	30000	EUR	233	72288615	72408032	119417
EUR_115	30000	EUR	233	79751575	80004343	252768
EUR_115	30000	EUR	233	88077880	88172209	94329
EUR_115	30000	EUR	233	88761110	89081743	320633
EUR_115	30000	EUR	233	90752674	90800297	47623
EUR_116	30000	EUR	234	16202082	16286721	84639
EUR_116	30000	EUR	234	24372241	24581630	209389
EUR_116	30000	EUR	234	25995113	26195455	200342
EUR_116	30000	EUR	234	26816945	26991485	174540
EUR_116	30000	EUR	234	28645700	28746647	100947
EUR_116	30000	EUR	234	29273800	29311528	37728
EUR_116	30000	EUR	234	32694491	32759145	64654
EUR_116	30000	EUR	234	36793192	36866743	73551
EUR_116	30000	EUR	234	58943812	59122460	178648
EUR_116	30000	EUR	234	74441944	74455862	13918
EUR_116	30000	EUR	234	77751346	77759540	8194
EUR_116	30000	EUR	234	80852609	80890918	38309
EUR_116	30000	EUR	234	87547254	87656802	109548
EUR_116	30000	EUR	234	87727929	87727993	64
EUR_116	30000	EUR	234	88219640	88609202	389562
EUR_116	30000	EUR	234	90996188	91107582	111394
EUR_116	30000	EUR	234	93168828	93264500	95672
EUR_116	30000	EUR	234	94898715	94930362	31647
EUR_116	30000	EUR	234	95270807	95445533	174726
EUR_116	30000	EUR	235	4020191	4032122	11931
EUR_116	30000	EUR	235	11532006	11579583	47577
EUR_116	30000	EUR	235	13981844	14057978	76134
EUR_116	30000	EUR	235	24975030	25134974	159944
EUR_116	30000	EUR	235	25212513	25305885	93372
EUR_116	30000	EUR	235	31087987	31368982	280995
EUR_116	30000	EUR	235	31671896	31807339	135443
EUR_116	30000	EUR	235	41161176	41182266	21090
EUR_116	30000	EUR	235	54210230	54365408	155178
EUR_116	30000	EUR	235	64049018	64062153	13135
EUR_116	30000	EUR	235	72326056	72471635	145579
EUR_116	30000	EUR	235	73488506	73574713	86207
EUR_116	30000	EUR	235	75263541	75282527	18986
EUR_116	30000	EUR	235	78246564	78293118	46554
EUR_116	30000	EUR	235	78697685	79134588	436903
EUR_116	30000	EUR	235	80973372	81108910	135538
EUR_116	30000	EUR	235	83886982	83957574	70592
EUR_116	30000	EUR	235	87567370	88030078	462708
EUR_116	30000	EUR	235	89273347	89419331	145984
EUR_116	30000	EUR	235	93484815	93503466	18651
EUR_116	30000	EUR	235	99177558	99244180	66622
EUR_117	30000	EUR	236	3763591	3982289	218698
EUR_117	30000	EUR	236	4063698	4134871	71173
EUR_117	30000	EUR	236	21002390	21225412	223022
EUR_117	30000	EUR	236	23432743	23503377	70634
EUR_117	30000	EUR	236	23631841	23651476	19635
EUR_117	30000	EUR	236	26319359	26580898	261539
EUR_117	30000	EUR	236	28087103	28139866	52763
EUR_117	30000	EUR	236	29273800	29311528	37728
EUR_117	30000	EUR	236	33229128	33295884	66756
EUR_117	30000	EUR	236	35318235	35413680	95445
EUR_117	30000	EUR	236	41350421	41360462	10041
EUR_117	30000	EUR	236	42164278	42208086	43808
EUR_117	30000	EUR	236	64321831	64328268	6437
EUR_117	30000	EUR	236	73488506	73675439	186933
EUR_117	30000	EUR	236	75349827	75354263	4436
EUR_117	30000	EUR	236	81502816	81569729	66913
EUR_117	30000	EUR	236	85579439	85788658	209219
EUR_117	30000	EUR	236	87271349	87293316	21967
EUR_117	30000	EUR	236	88295555	88537179	241624
EUR_117	30000	EUR	236	90390897	90393363	2466
EUR_117	30000	EUR	237	14089958	14112508	22550
EUR_117	30000	EUR	237	18622886	18636940	14054
EUR_117	30000	EUR	237	20981647	21225412	243765
EUR_117	30000	EUR	237	22992959	23099324	106365
EUR_117	30000	EUR	237	23346980	23651476	304496
EUR_117	30000	EUR	237	24892444	24906091	13647
EUR_117	30000	EUR	237	25323974	25377647	53673
EUR_117	30000	EUR	237	30889388	31145710	256322
EUR_117	30000	EUR	237	37777188	38097333	320145
EUR_117	30000	EUR	237	59064557	59111732	47175
EUR_117	30000	EUR	237	59467676	59631623	163947
EUR_117	30000	EUR	237	73488506	73702901	214395
EUR_117	30000	EUR	237	76365488	76397099	31611
EUR_117	30000	EUR	237	86916801	87051737	134936
EUR_117	30000	EUR	237	88703422	88703923	501
EUR_117	30000	EUR	237	88761110	89081743	320633
EUR_117	30000	EUR	237	90153261	90243516	90255
EUR_117	30000	EUR	237	91489890	91688404	198514
EUR_117	30000	EUR	237	94388014	94419473	31459
EUR_117	30000	EUR	237	96731555	96762025	30470
EUR_118	30000	EUR	238	4539860	4590560	50700
EUR_118	30000	EUR	238	24088240	24211824	123584
EUR_118	30000	EUR	238	25177020	25305885	128865
EUR_118	30000	EUR	238	25723973	25777999	54026
EUR_118	30000	EUR	238	25867195	25982719	115524
EUR_118	30000	EUR	238	31574534	31605832	31298
EUR_118	30000	EUR	238	32667412	32870350	202938
EUR_118	30000	EUR	238	59130252	59214311	84059
EUR_118	30000	EUR	238	74055055	74094072	39017
EUR_118	30000	EUR	238	75587305	75641163	53858
EUR_118	30000	EUR	238	79901897	79929594	27697
EUR_118	30000	EUR	238	80135541	80191742	56201
EUR_118	30000	EUR	238	80696697	80817950	121253
EUR_118	30000	EUR	238	81064593	81108910	44317
EUR_118	30000	EUR	238	84755692	84919115	163423
EUR_118	30000	EUR	238	90992837	91107582	114745
EUR_118	30000	EUR	238	94898715	94930362	31647
EUR_118	30000	EUR	239	166193	303223	137030
EUR_118	30000	EUR	239	11532006	11542173	10167
EUR_118	30000	EUR	239	16202082	16325554	123472
EUR_118	30000	EUR	239	18287266	18394728	107462
EUR_118	30000	EUR	239	21015460	21274841	259381
EUR_118	30000	EUR	239	23432743	23503377	70634
EUR_118	30000	EUR	239	23631841	23651476	19635
EUR_118	30000	EUR	239	30904434	30925177	20743
EUR_118	30000	EUR	239	31517304	31760061	242757
EUR_118	30000	EUR	239	32694491	32768500	74009
EUR_118	30000	EUR	239	32808818	32858850	50032
EUR_118	30000	EUR	239	33054627	33322537	267910
EUR_118	30000	EUR	239	54231248	54247633	16385
EUR_118	30000	EUR	239	68996935	69006592	9657
EUR_118	30000	EUR	239	74092456	74212177	119721
EUR_118	30000	EUR	239	79824188	79933512	109324
EUR_118	30000	EUR	239	83886982	83957574	70592
EUR_118	30000	EUR	239	89356470	89508341	151871
EUR_118	30000	EUR	239	94034370	94056780	22410
EUR_118	30000	EUR	239	94179666	94381472	201806
EUR_118	30000	EUR	239	96708757	96790795	82038
EUR_119	30000	EUR	240	1735950	2022517	286567
EUR_119	30000	EUR	240	2519034	2648737	129703
EUR_119	30000	EUR	240	13229731	13301006	71275
EUR_119	30000	EUR	240	18081536	18140078	58542
EUR_119	30000	EUR	240	22113151	22313169	200018
EUR_119	30000	EUR	240	23176150	23184805	8655
EUR_119	30000	EUR	240	25256327	25305885	49558
EUR_119	30000	EUR	240	25867195	25913738	46543
EUR_119	30000	EUR	240	29273800	29279379	5579
EUR_119	30000	EUR	240	35771774	35892995	121221
EUR_119	30000	EUR	240	36634451	36678544	44093
EUR_119	30000	EUR	240	42493150	42574352	81202
EUR_119	30000	EUR	240	51914729	51974159	59430
EUR_119	30000	EUR	240	52168283	52173075	4792
EUR_119	30000	EUR	240	52415507	52427775	12268
EUR_119	30000	EUR	240	57427875	57493786	65911
EUR_119	30000	EUR	240	57712252	57806900	94648
EUR_119	30000	EUR	240	74441944	74455862	13918
EUR_119	30000	EUR	240	84755692	84810053	54361
EUR_119	30000	EUR	240	87514418	87620403	105985
EUR_119	30000	EUR	240	88002352	88762816	760464
EUR_119	30000	EUR	240	88975808	89081743	105935
EUR_119	30000	EUR	240	89356470	89508341	151871
EUR_119	30000	EUR	240	90627118	90662647	35529
EUR_119	30000	EUR	240	91847626	91875197	27571
EUR_119	30000	EUR	240	94447447	94522438	74991
EUR_119	30000	EUR	240	94793518	94850934	57416
EUR_119	30000	EUR	240	95270807	95445533	174726
EUR_119	30000	EUR	241	1735950	2000286	264336
EUR_119	30000	EUR	241	5018475	5041230	22755
EUR_119	30000	EUR	241	13094162	13213765	119603
EUR_119	30000	EUR	241	22711689	22721112	9423
EUR_119	30000	EUR	241	24621120	24658821	37701
EUR_119	30000	EUR	241	32855612	32870350	14738
EUR_119	30000	EUR	241	34293462	34351822	58360
EUR_119	30000	EUR	241	49714605	50246703	532098
EUR_119	30000	EUR	241	52316366	52362628	46262
EUR_119	30000	EUR	241	54653171	54730663	77492
EUR_119	30000	EUR	241	54893690	54904011	10321
EUR_119	30000	EUR	241	83886982	83957574	70592
EUR_119	30000	EUR	241	86508335	86539843	31508
EUR_119	30000	EUR	241	87547254	87656802	109548
EUR_119	30000	EUR	241	87727929	87846433	118504
EUR_119	30000	EUR	241	88087834	88146039	58205
EUR_119	30000	EUR	241	89106294	89124034	17740
EUR_119	30000	EUR	241	89449131	89450013	882
EUR_119	30000	EUR	241	91049817	91107582	57765
EUR_119	30000	EUR	241	95829965	95927099	97134
EUR_119	30000	EUR	241	96254221	96352723	98502
EUR_120	30000	EUR	242	903241	960221	56980
EUR_120	30000	EUR	242	4020191	4044195	24004
EUR_120	30000	EUR	242	7410848	7475971	65123
EUR_120	30000	EUR	242	12764351	12953142	188791
EUR_120	30000	EUR	242	16316092	16375047	58955
EUR_120	30000	EUR	242	18229012	18368143	139131
EUR_120	30000	EUR	242	22519633	22533171	13538
EUR_120	30000	EUR	242	22579230	22608307	29077
EUR_120	30000	EUR	242	22890136	23215111	324975
EUR_120	30000	EUR	242	25228569	25305885	77316
EUR_120	30000	EUR	242	28599684	28692721	93037
EUR_120	30000	EUR	242	31325536	31368982	43446
EUR_120	30000	EUR	242	35394045	35693478	299433
EUR_120	30000	EUR	242	58863206	59215777	352571
EUR_120	30000	EUR	242	64049018	64062153	13135
EUR_120	30000	EUR	242	72961212	73105848	144636
EUR_120	30000	EUR	242	76365488	76397099	31611
EUR_120	30000	EUR	242	80338361	80507723	169362
EUR_120	30000	EUR	242	80730025	80817950	87925
EUR_120	30000	EUR	242	87211398	87364045	152647
EUR_120	30000	EUR	242	88079309	88353745	274436
EUR_120	30000	EUR	242	89231339	89235318	3979
EUR_120	30000	EUR	242	93792178	94222927	430749
EUR_120	30000	EUR	242	94447447	94522438	74991
EUR_120	30000	EUR	242	94793518	94819760	26242
EUR_120	30000	EUR	242	99165891	99224912	59021
EUR_120	30000	EUR	243	3047708	3053070	5362
EUR_120	30000	EUR	243	9181565	9308590	127025
EUR_120	30000	EUR	243	22890136	23184805	294669
EUR_120	30000	EUR	243	24088240	24133961	45721
EUR_120	30000	EUR	243	31437056	31548447	111391
EUR_120	30000	EUR	243	32694491	32714627	20136
EUR_120	30000	EUR	243	36384163	36460007	75844
EUR_120	30000	EUR	243	39595394	39688540	93146
EUR_120	30000	EUR	243	63840934	63892461	51527
EUR_120	30000	EUR	243	71544591	71678663	134072
EUR_120	30000	EUR	243	75851931	75915063	63132
EUR_120	30000	EUR	243	77137118	77172196	35078
EUR_120	30000	EUR	243	83910212	83957574	47362
EUR_120	30000	EUR	243	84755692	84876019	120327
EUR_120	30000	EUR	243	87727929	87888944	161015
EUR_120	30000	EUR	243	88221167	88300295	79128
EUR_120	30000	EUR	243	95774147	95792644	18497
EUR_120	30000	EUR	243	96136238	96175807	39569
EUR_121	30000	EUR	244	18622886	18806641	183755
EUR_121	30000	EUR	244	25325282	25351680	26398
EUR_121	30000	EUR	244	26375604	26436121	60517
EUR_121	30000	EUR	244	37727611	37943125	215514
EUR_121	30000	EUR	244	42164278	42208086	43808
EUR_121	30000	EUR	244	42793149	42823699	30550
EUR_121	30000	EUR	244	58569405	58694180	124775
EUR_121	30000	EUR	244	63714218	63803837	89619
EUR_121	30000	EUR	244	73259003	73275645	16642
EUR_121	30000	EUR	244	73432614	73538489	105875
EUR_121	30000	EUR	244	77751346	77830955	79609
EUR_121	30000	EUR	244	88025602	88093768	68166
EUR_121	30000	EUR	244	88951047	89050718	99671
EUR_121	30000	EUR	244	90058636	90243516	184880
EUR_121	30000	EUR	244	92978681	93140942	162261
EUR_121	30000	EUR	244	93277783	93322262	44479
EUR_121	30000	EUR	244	93870672	93921319	50647
EUR_121	30000	EUR	244	95270807	95445533	174726
EUR_121	30000	EUR	245	13002286	13178737	176451
EUR_121	30000	EUR	245	22918884	23168293	249409
EUR_121	30000	EUR	245	29306591	29365834	59243
EUR_121	30000	EUR	245	31087987	31109395	21408
EUR_121	30000	EUR	245	36050639	36089268	38629
EUR_121	30000	EUR	245	36284487	36460007	175520
EUR_121	30000	EUR	245	54879491	54904011	24520
EUR_121	30000	EUR	245	58057212	58136140	78928
EUR_121	30000	EUR	245	58863206	59072585	209379
EUR_121	30000	EUR	245	73647668	73705981	58313
EUR_121	30000	EUR	245	74055055	74094072	39017
EUR_121	30000	EUR	245	76365488	76397099	31611
EUR_121	30000	EUR	245	79862860	79919444	56584
EUR_121	30000	EUR	245	88025602	88085432	59830
EUR_121	30000	EUR	245	88087834	88153791	65957
EUR_121	30000	EUR	245	89811998	89818615	6617
EUR_121	30000	EUR	245	90409104	90619367	210263
EUR_121	30000	EUR	245	93484815	93503466	18651
EUR_121	30000	EUR	245	94348955	94544971	196016
EUR_122	30000	EUR	246	18118969	18304746	185777
EUR_122	30000	EUR	246	22455494	22608307	152813
EUR_122	30000	EUR	246	23631841	23640206	8365
EUR_122	30000	EUR	246	24892444	24906091	13647
EUR_122	30000	EUR	246	25312993	25777999	465006
EUR_122	30000	EUR	246	25867195	25873969	6774
EUR_122	30000	EUR	246	26798389	26911224	112835
EUR_122	30000	EUR	246	35001631	35087281	85650
EUR_122	30000	EUR	246	35394045	35892995	498950
EUR_122	30000	EUR	246	39847102	40083980	236878
EUR_122	30000	EUR	246	53821064	54076786	255722
EUR_122	30000	EUR	246	56378802	56480618	101816
EUR_122	30000	EUR	246	72961212	73105848	144636
EUR_122	30000	EUR	246	76365488	76397099	31611
EUR_122	30000	EUR	246	80338361	80507723	169362
EUR_122	30000	EUR	246	80863277	81009604	146327
EUR_122	30000	EUR	246	84755692	84919115	163423
EUR_122	30000	EUR	246	87533821	87546866	13045
EUR_122	30000	EUR	246	92892702	93214589	321887
EUR_122	30000	EUR	246	94049016	94222927	173911
EUR_122	30000	EUR	246	94447447	94522438	74991
EUR_122	30000	EUR	246	94793518	94819760	26242
EUR_122	30000	EUR	246	99165891	99224912	59021
EUR_122	30000	EUR	247	3929740	3982289	52549
EUR_122	30000	EUR	247	4063698	4074143	10445
EUR_122	30000	EUR	247	20359744	20455191	95447
EUR_122	30000	EUR	247	22918884	23121198	202314
EUR_122	30000	EUR	247	23276233	23330932	54699
EUR_122	30000	EUR	247	26798389	26911224	112835
EUR_122	30000	EUR	247	29306591	29365834	59243
EUR_122	30000	EUR	247	31113073	31133912	20839
EUR_122	30000	EUR	247	40410992	40602505	191513
EUR_122	30000	EUR	247	40861764	40955214	93450
EUR_122	30000	EUR	247	77751346	77836139	84793
EUR_122	30000	EUR	247	79901897	79936163	34266
EUR_122	30000	EUR	247	83533777	83550130	16353
EUR_122	30000	EUR	247	83554127	83592822	38695
EUR_122	30000	EUR	247	88797692	88812922	15230
EUR_122	30000	EUR	247	93168828	93264500	95672
EUR_123	30000	EUR	248	1041641	1079953	38312
EUR_123	30000	EUR	248	1157833	1191560	33727
EUR_123	30000	EUR	248	2519034	2627098	108064
EUR_123	30000	EUR	248	8038029	8053067	15038
EUR_123	30000	EUR	248	16243211	16437214	194003
EUR_123	30000	EUR	248	22519633	22533171	13538
EUR_123	30000	EUR	248	22579230	22608307	29077
EUR_123	30000	EUR	248	22890136	22957748	67612
EUR_123	30000	EUR	248	23165262	23267376	102114
EUR_123	30000	EUR	248	24045382	24166883	121501
EUR_123	30000	EUR	248	24892444	24906091	13647
EUR_123	30000	EUR	248	25323974	25377647	53673
EUR_123	30000	EUR	248	31820071	31835000	14929
EUR_123	30000	EUR	248	34845302	35639874	794572
EUR_123	30000	EUR	248	36744092	36799236	55144
EUR_123	30000	EUR	248	40814271	40833757	19486
EUR_123	30000	EUR	248	42493150	42574352	81202
EUR_123	30000	EUR	248	54113043	54393679	280636
EUR_123	30000	EUR	248	59694320	59762964	68644
EUR_123	30000	EUR	248	74644219	74738891	94672
EUR_123	30000	EUR	248	77733985	77735979	1994
EUR_123	30000	EUR	248	85353810	85490844	137034
EUR_123	30000	EUR	248	87533821	87546866	13045
EUR_123	30000	EUR	248	87987577	87994899	7322
EUR_123	30000	EUR	248	88077880	88172209	94329
EUR_123	30000	EUR	248	88825376	89124034	298658
EUR_123	30000	EUR	248	91987726	92081240	93514
EUR_123	30000	EUR	248	93123848	93146996	23148
EUR_123	30000	EUR	249	2861477	2874967	13490
EUR_123	30000	EUR	249	5253381	5276460	23079
EUR_123	30000	EUR	249	23977787	24094707	116920
EUR_123	30000	EUR	249	25189085	25217171	28086
EUR_123	30000	EUR	249	25323974	25378298	54324
EUR_123	30000	EUR	249	26816945	26991485	174540
EUR_123	30000	EUR	249	32057270	32141896	84626
EUR_123	30000	EUR	249	34999082	35063297	64215
EUR_123	30000	EUR	249	37937722	37943125	5403
EUR_123	30000	EUR	249	59553546	59604966	51420
EUR_123	30000	EUR	249	75089161	75282527	193366
EUR_123	30000	EUR	249	77751346	77830955	79609
EUR_123	30000	EUR	249	81031954	81153739	121785
EUR_123	30000	EUR	249	84755692	84917262	161570
EUR_123	30000	EUR	249	87727929	87888944	161015
EUR_123	30000	EUR	249	87969149	87994899	25750
EUR_123	30000	EUR	249	88077880	88113143	35263
EUR_123	30000	EUR	249	88405406	88464514	59108
EUR_123	30000	EUR	249	88761110	89001971	240861
EUR_123	30000	EUR	249	90409104	90619367	210263
EUR_123	30000	EUR	249	92892702	93214589	321887
EUR_123	30000	EUR	249	93299514	93456351	156837
EUR_123	30000	EUR	249	94163899	94305058	141159
EUR_123	30000	EUR	249	94793518	94934431	140913
EUR_124	30000	EUR	250	1158753	1191560	32807
EUR_124	30000	EUR	250	9413335	9449917	36582
EUR_124	30000	EUR	250	18731537	18806641	75104
EUR_124	30000	EUR	250	24892444	24906091	13647
EUR_124	30000	EUR	250	25537317	25603895	66578
EUR_124	30000	EUR	250	29273800	29300000	26200
EUR_124	30000	EUR	250	30904434	30907594	3160
EUR_124	30000	EUR	250	35270136	35413680	143544
EUR_124	30000	EUR	250	36744092	36864514	120422
EUR_124	30000	EUR	250	52316366	52388544	72178
EUR_124	30000	EUR	250	58863206	59215777	352571
EUR_124	30000	EUR	250	64803473	64820966	17493
EUR_124	30000	EUR	250	70881157	70994958	113801
EUR_124	30000	EUR	250	71544591	71678663	134072
EUR_124	30000	EUR	250	73633815	73702901	69086
EUR_124	30000	EUR	250	76485395	76594146	108751
EUR_124	30000	EUR	250	77751346	77881732	130386
EUR_124	30000	EUR	250	84755692	84919115	163423
EUR_124	30000	EUR	250	87075746	87120548	44802
EUR_124	30000	EUR	250	88060972	88419767	358795
EUR_124	30000	EUR	250	88761110	89081743	320633
EUR_124	30000	EUR	250	90996188	91107582	111394
EUR_124	30000	EUR	250	94388014	94445886	57872
EUR_124	30000	EUR	250	94793518	94923900	130382
EUR_124	30000	EUR	251	23165262	23267376	102114
EUR_124	30000	EUR	251	25189085	25217171	28086
EUR_124	30000	EUR	251	25323974	25378298	54324
EUR_124	30000	EUR	251	25867195	25987107	119912
EUR_124	30000	EUR	251	26111918	26131607	19689
EUR_124	30000	EUR	251	29693031	29706829	13798
EUR_124	30000	EUR	251	32694491	32768500	74009
EUR_124	30000	EUR	251	32808818	32858850	50032
EUR_124	30000	EUR	251	34054443	34083746	29303
EUR_124	30000	EUR	251	34845302	35585418	740116
EUR_124	30000	EUR	251	59578454	59745811	167357
EUR_124	30000	EUR	251	71047773	71070570	22797
EUR_124	30000	EUR	251	76365488	76606551	241063
EUR_124	30000	EUR	251	88208344	88340224	131880
EUR_124	30000	EUR	251	88761110	88910118	149008
EUR_124	30000	EUR	251	91666010	91688404	22394
EUR_124	30000	EUR	251	95774147	95788396	14249
EUR_125	30000	EUR	252	1534378	1685328	150950
EUR_125	30000	EUR	252	5018475	5041230	22755
EUR_125	30000	EUR	252	18057439	18173182	115743
EUR_125	30000	EUR	252	20359744	20455191	95447
EUR_125	30000	EUR	252	22387409	22509864	122455
EUR_125	30000	EUR	252	25451396	25580873	129477
EUR_125	30000	EUR	252	26798389	26991485	193096
EUR_125	30000	EUR	252	31437056	31648058	211002
EUR_125	30000	EUR	252	31699236	31853916	154680
EUR_125	30000	EUR	252	32824940	32871485	46545
EUR_125	30000	EUR	252	33126706	33180725	54019
EUR_125	30000	EUR	252	35576182	35584922	8740
EUR_125	30000	EUR	252	41319133	41360462	41329
EUR_125	30000	EUR	252	53821064	53824702	3638
EUR_125	30000	EUR	252	54210230	54365408	155178
EUR_125	30000	EUR	252	58057212	58136140	78928
EUR_125	30000	EUR	252	64803473	64922329	118856
EUR_125	30000	EUR	252	69852251	69860988	8737
EUR_125	30000	EUR	252	74019705	74094072	74367
EUR_125	30000	EUR	252	79860282	79933512	73230
EUR_125	30000	EUR	252	80931458	81084087	152629
EUR_125	30000	EUR	252	88797692	88812922	15230
EUR_125	30000	EUR	253	1889575	1993052	103477
EUR_125	30000	EUR	253	11532006	11651553	119547
EUR_125	30000	EUR	253	16397154	16497900	100746
EUR_125	30000	EUR	253	18319962	18357509	37547
EUR_125	30000	EUR	253	23685805	23781066	95261
EUR_125	30000	EUR	253	25066876	25088413	21537
EUR_125	30000	EUR	253	25189085	25231890	42805
EUR_125	30000	EUR	253	29306591	29396432	89841
EUR_125	30000	EUR	253	30905056	31145710	240654
EUR_125	30000	EUR	253	39639062	39692065	53003
EUR_125	30000	EUR	253	57136159	57262845	126686
EUR_125	30000	EUR	253	71433365	71457991	24626
EUR_125	30000	EUR	253	79751575	80004343	252768
EUR_125	30000	EUR	253	88077880	88172209	94329
EUR_125	30000	EUR	253	88761110	89081743	320633
EUR_125	30000	EUR	253	93168828	93264500	95672
EUR_125	30000	EUR	253	93800814	94181111	380297
EUR_125	30000	EUR	253	94793518	94908178	114660
EUR_125	30000	EUR	253	95774147	95788396	14249
EUR_125	30000	EUR	253	96676576	96731601	55025
EUR_126	30000	EUR	254	13574314	13634873	60559
EUR_126	30000	EUR	254	17976951	18041675	64724
EUR_126	30000	EUR	254	21015460	21274841	259381
EUR_126	30000	EUR	254	26319359	26580898	261539
EUR_126	30000	EUR	254	50183403	50246703	63300
EUR_126	30000	EUR	254	57427875	57493786	65911
EUR_126	30000	EUR	254	58569405	58694180	124775
EUR_126	30000	EUR	254	60019556	60031854	12298
EUR_126	30000	EUR	254	60110145	60125448	15303
EUR_126	30000	EUR	254	76567582	76594146	26564
EUR_126	30000	EUR	254	84248521	84254246	5725
EUR_126	30000	EUR	254	87727929	87888944	161015
EUR_126	30000	EUR	254	87969149	87994899	25750
EUR_126	30000	EUR	254	88077880	88113143	35263
EUR_126	30000	EUR	254	88302301	88340224	37923
EUR_126	30000	EUR	254	89067780	89099823	32043
EUR_126	30000	EUR	254	94179075	94439046	259971
EUR_126	30000	EUR	254	95829965	95927099	97134
EUR_126	30000	EUR	254	96254221	96268391	14170
EUR_126	30000	EUR	255	1096442	1099262	2820
EUR_126	30000	EUR	255	1157833	1191560	33727
EUR_126	30000	EUR	255	8783056	8932393	149337
EUR_126	30000	EUR	255	11693469	11814111	120642
EUR_126	30000	EUR	255	18118969	18304746	185777
EUR_126	30000	EUR	255	20607744	20914821	307077
EUR_126	30000	EUR	255	23721919	23797839	75920
EUR_126	30000	EUR	255	25323974	25378298	54324
EUR_126	30000	EUR	255	31440500	31636518	196018
EUR_126	30000	EUR	255	32293660	32447123	153463
EUR_126	30000	EUR	255	32731416	32768500	37084
EUR_126	30000	EUR	255	39823503	40145306	321803
EUR_126	30000	EUR	255	42280145	42468277	188132
EUR_126	30000	EUR	255	54748754	54904011	155257
EUR_126	30000	EUR	255	56476588	56480618	4030
EUR_126	30000	EUR	255	74441944	74455862	13918
EUR_126	30000	EUR	255	77733985	77735979	1994
EUR_126	30000	EUR	255	77805961	77881732	75771
EUR_126	30000	EUR	255	80874989	81229503	354514
EUR_126	30000	EUR	255	86620325	86627529	7204
EUR_126	30000	EUR	255	87211398	87903841	692443
EUR_126	30000	EUR	255	88751576	88762816	11240
EUR_126	30000	EUR	255	91976671	92000571	23900
EUR_126	30000	EUR	255	93308720	93312065	3345
EUR_127	30000	EUR	256	4539860	4590560	50700
EUR_127	30000	EUR	256	18118969	18304746	185777
EUR_127	30000	EUR	256	20607744	20914821	307077
EUR_127	30000	EUR	256	23721919	23797839	75920
EUR_127	30000	EUR	256	25323974	25378298	54324
EUR_127	30000	EUR	256	31440500	31636518	196018
EUR_127	30000	EUR	256	32293660	32447123	153463
EUR_127	30000	EUR	256	32731416	32768500	37084
EUR_127	30000	EUR	256	76577005	76582454	5449
EUR_127	30000	EUR	256	88150542	88709432	558890
EUR_127	30000	EUR	256	88913719	89004089	90370
EUR_127	30000	EUR	256	91633048	91688404	55356
EUR_127	30000	EUR	256	96910874	97008044	97170
EUR_127	30000	EUR	256	99165891	99280798	114907
EUR_127	30000	EUR	257	7287218	7444890	157672
EUR_127	30000	EUR	257	18319962	18357509	37547
EUR_127	30000	EUR	257	23631841	23640206	8365
EUR_127	30000	EUR	257	24892444	24906091	13647
EUR_127	30000	EUR	257	25312993	25777999	465006
EUR_127	30000	EUR	257	25867195	25873969	6774
EUR_127	30000	EUR	257	31440500	31636518	196018
EUR_127	30000	EUR	257	40410992	40602505	191513
EUR_127	30000	EUR	257	54653171	54730663	77492
EUR_127	30000	EUR	257	56476588	56480618	4030
EUR_127	30000	EUR	257	73432614	73559998	127384
EUR_127	30000	EUR	257	75089161	75282527	193366
EUR_127	30000	EUR	257	79621494	79687804	66310
EUR_127	30000	EUR	257	88494020	88941340	447320
EUR_127	30000	EUR	257	91856433	91929323	72890
EUR_127	30000	EUR	257	91987726	92171686	183960
EUR_127	30000	EUR	257	93474092	93647010	172918
EUR_128	30000	EUR	258	16243211	16437214	194003
EUR_128	30000	EUR	258	17889447	18016499	127052
EUR_128	30000	EUR	258	21195166	21282925	87759
EUR_128	30000	EUR	258	25189085	25301824	112739
EUR_128	30000	EUR	258	26319359	26580898	261539
EUR_128	30000	EUR	258	32036224	32105882	69658
EUR_128	30000	EUR	258	32694491	32714627	20136
EUR_128	30000	EUR	258	52572348	52662927	90579
EUR_128	30000	EUR	258	57712252	57714199	1947
EUR_128	30000	EUR	258	58863206	58863428	222
EUR_128	30000	EUR	258	73745706	73906350	160644
EUR_128	30000	EUR	258	75089161	75183183	94022
EUR_128	30000	EUR	258	80856331	80890918	34587
EUR_128	30000	EUR	258	83886982	83911043	24061
EUR_128	30000	EUR	258	87512858	87623148	110290
EUR_128	30000	EUR	258	88761110	89081743	320633
EUR_128	30000	EUR	258	90996188	91107582	111394
EUR_128	30000	EUR	258	93172929	93217584	44655
EUR_128	30000	EUR	258	96136238	96175807	39569
EUR_128	30000	EUR	259	21234567	21274841	40274
EUR_128	30000	EUR	259	24892444	24906091	13647
EUR_128	30000	EUR	259	25537317	25639784	102467
EUR_128	30000	EUR	259	29306591	29478208	171617
EUR_128	30000	EUR	259	35406023	35627884	221861
EUR_128	30000	EUR	259	39823503	40145306	321803
EUR_128	30000	EUR	259	52359027	52420473	61446
EUR_128	30000	EUR	259	54403505	54904011	500506
EUR_128	30000	EUR	259	57427875	57493786	65911
EUR_128	30000	EUR	259	64143701	64195652	51951
EUR_128	30000	EUR	259	68212528	68360598	148070
EUR_128	30000	EUR	259	74644219	74738891	94672
EUR_128	30000	EUR	259	79901897	79929594	27697
EUR_128	30000	EUR	259	80135541	80191742	56201
EUR_128	30000	EUR	259	88025602	88028190	2588
EUR_128	30000	EUR	259	88090377	88093768	3391
EUR_128	30000	EUR	259	90992837	91107582	114745
EUR_128	30000	EUR	259	93303963	93395321	91358
EUR_128	30000	EUR	259	95774147	95788396	14249
EUR_128	30000	EUR	259	96116814	96159987	43173
EUR_129	30000	EUR	260	2667696	3017345	349649
EUR_129	30000	EUR	260	9413335	9449917	36582
EUR_129	30000	EUR	260	20486426	20730956	244530
EUR_129	30000	EUR	260	22447027	22462305	15278
EUR_129	30000	EUR	260	24892444	24906091	13647
EUR_129	30000	EUR	260	25867195	25987107	119912
EUR_129	30000	EUR	260	26111918	26176332	64414
EUR_129	30000	EUR	260	26552483	26580898	28415
EUR_129	30000	EUR	260	26849817	26889089	39272
EUR_129	30000	EUR	260	29306591	29579668	273077
EUR_129	30000	EUR	260	31681213	31759077	77864
EUR_129	30000	EUR	260	32039879	32187563	147684
EUR_129	30000	EUR	260	32262916	32267787	4871
EUR_129	30000	EUR	260	33126706	33295884	169178
EUR_129	30000	EUR	260	35780770	35849669	68899
EUR_129	30000	EUR	260	41350421	41360462	10041
EUR_129	30000	EUR	260	52316366	52388544	72178
EUR_129	30000	EUR	260	59578454	59745811	167357
EUR_129	30000	EUR	260	64394637	64449186	54549
EUR_129	30000	EUR	260	76567582	76594146	26564
EUR_129	30000	EUR	260	77751346	77881732	130386
EUR_129	30000	EUR	260	85353810	85490844	137034
EUR_129	30000	EUR	260	86916801	87051737	134936
EUR_129	30000	EUR	260	87771619	87826223	54604
EUR_129	30000	EUR	260	94354590	94559172	204582
EUR_129	30000	EUR	260	96229638	96352723	123085
EUR_129	30000	EUR	261	5253381	5312534	59153
EUR_129	30000	EUR	261	17687142	17741407	54265
EUR_129	30000	EUR	261	22447027	22533171	86144
EUR_129	30000	EUR	261	23958336	23981408	23072
EUR_129	30000	EUR	261	25189085	25235709	46624
EUR_129	30000	EUR	261	25253272	25646013	392741
EUR_129	30000	EUR	261	31478668	31507373	28705
EUR_129	30000	EUR	261	32730368	32759145	28777
EUR_129	30000	EUR	261	32992892	33513276	520384
EUR_129	30000	EUR	261	40099562	40145306	45744
EUR_129	30000	EUR	261	59620225	59631623	11398
EUR_129	30000	EUR	261	64049018	64062153	13135
EUR_129	30000	EUR	261	72326056	72471635	145579
EUR_129	30000	EUR	261	73488506	73574713	86207
EUR_129	30000	EUR	261	75263541	75282527	18986
EUR_129	30000	EUR	261	84235412	84254246	18834
EUR_129	30000	EUR	261	88025602	88028190	2588
EUR_129	30000	EUR	261	88797692	88812922	15230
EUR_129	30000	EUR	261	93601452	93725532	124080
EUR_129	30000	EUR	261	93897160	93916191	19031
EUR_129	30000	EUR	261	95829965	95864870	34905
EUR_130	30000	EUR	262	1041641	1079953	38312
EUR_130	30000	EUR	262	1157833	1191560	33727
EUR_130	30000	EUR	262	21002390	21212552	210162
EUR_130	30000	EUR	262	23486422	23554604	68182
EUR_130	30000	EUR	262	23944949	24094707	149758
EUR_130	30000	EUR	262	24430339	24581630	151291
EUR_130	30000	EUR	262	25190794	25501390	310596
EUR_130	30000	EUR	262	26413359	26436121	22762
EUR_130	30000	EUR	262	32474747	32556505	81758
EUR_130	30000	EUR	262	35771774	35892995	121221
EUR_130	30000	EUR	262	36744092	36864514	120422
EUR_130	30000	EUR	262	51914729	51974159	59430
EUR_130	30000	EUR	262	52168283	52173075	4792
EUR_130	30000	EUR	262	59201786	59215777	13991
EUR_130	30000	EUR	262	64049018	64195652	146634
EUR_130	30000	EUR	262	72288615	72398733	110118
EUR_130	30000	EUR	262	79901897	79929594	27697
EUR_130	30000	EUR	262	80520393	80530144	9751
EUR_130	30000	EUR	262	80863277	80899276	35999
EUR_130	30000	EUR	262	84898186	84919115	20929
EUR_130	30000	EUR	262	87525309	87661974	136665
EUR_130	30000	EUR	262	87692546	87787319	94773
EUR_130	30000	EUR	262	88087834	88972858	885024
EUR_130	30000	EUR	263	2813723	3065958	252235
EUR_130	30000	EUR	263	3531284	3550781	19497
EUR_130	30000	EUR	263	3771889	3866676	94787
EUR_130	30000	EUR	263	18815917	18882238	66321
EUR_130	30000	EUR	263	21150828	21225412	74584
EUR_130	30000	EUR	263	22711689	22721112	9423
EUR_130	30000	EUR	263	41319133	41360462	41329
EUR_130	30000	EUR	263	42164278	42208086	43808
EUR_130	30000	EUR	263	42793149	42823699	30550
EUR_130	30000	EUR	263	59279449	59419031	139582
EUR_130	30000	EUR	263	72326056	72471635	145579
EUR_130	30000	EUR	263	75089161	75282527	193366
EUR_130	30000	EUR	263	76141203	76143984	2781
EUR_130	30000	EUR	263	76577005	76582454	5449
EUR_130	30000	EUR	263	80908589	80979063	70474
EUR_130	30000	EUR	263	84875618	84919115	43497
EUR_130	30000	EUR	263	87771619	87826223	54604
EUR_130	30000	EUR	263	90266070	90439818	173748
EUR_130	30000	EUR	263	92081595	92314179	232584
EUR_130	30000	EUR	263	93303963	93494576	190613
EUR_130	30000	EUR	263	94898715	94930362	31647
EUR_130	30000	EUR	263	96010530	96175181	164651
EUR_131	30000	EUR	264	1853096	1854996	1900
EUR_131	30000	EUR	264	3281249	3302065	20816
EUR_131	30000	EUR	264	8348919	8398285	49366
EUR_131	30000	EUR	264	16243211	16437214	194003
EUR_131	30000	EUR	264	23501997	23569549	67552
EUR_131	30000	EUR	264	24892444	24906091	13647
EUR_131	30000	EUR	264	26403531	26580898	177367
EUR_131	30000	EUR	264	31962878	32187563	224685
EUR_131	30000	EUR	264	32262916	32267787	4871
EUR_131	30000	EUR	264	37777188	38097333	320145
EUR_131	30000	EUR	264	54210889	54362674	151785
EUR_131	30000	EUR	264	58064915	58088114	23199
EUR_131	30000	EUR	264	71700744	71764001	63257
EUR_131	30000	EUR	264	71780368	71820558	40190
EUR_131	30000	EUR	264	72373480	72471635	98155
EUR_131	30000	EUR	264	76798443	77082685	284242
EUR_131	30000	EUR	264	77606973	77700986	94013
EUR_131	30000	EUR	264	94898715	94930362	31647
EUR_131	30000	EUR	264	95270807	95445533	174726
EUR_131	30000	EUR	265	25623732	25639784	16052
EUR_131	30000	EUR	265	27746608	27974945	228337
EUR_131	30000	EUR	265	28111916	28139866	27950
EUR_131	30000	EUR	265	31069333	31111151	41818
EUR_131	30000	EUR	265	43380901	43453960	73059
EUR_131	30000	EUR	265	50183403	50246703	63300
EUR_131	30000	EUR	265	52230216	52342098	111882
EUR_131	30000	EUR	265	59650599	59762964	112365
EUR_131	30000	EUR	265	69740511	69996567	256056
EUR_131	30000	EUR	265	71544591	71637339	92748
EUR_131	30000	EUR	265	72447779	72471635	23856
EUR_131	30000	EUR	265	76365488	76397099	31611
EUR_131	30000	EUR	265	83554127	83592822	38695
EUR_131	30000	EUR	265	84755692	84919115	163423
EUR_131	30000	EUR	265	89067780	89099823	32043
EUR_131	30000	EUR	265	92839624	92850739	11115
EUR_131	30000	EUR	265	94437992	94544971	106979
EUR_132	30000	EUR	266	1534378	1685328	150950
EUR_132	30000	EUR	266	1904339	1993052	88713
EUR_132	30000	EUR	266	8967212	9054846	87634
EUR_132	30000	EUR	266	9367655	9435211	67556
EUR_132	30000	EUR	266	13574314	13634873	60559
EUR_132	30000	EUR	266	23165262	23267376	102114
EUR_132	30000	EUR	266	24749954	24757234	7280
EUR_132	30000	EUR	266	25066876	25088413	21537
EUR_132	30000	EUR	266	25385795	25600157	214362
EUR_132	30000	EUR	266	25847649	25855304	7655
EUR_132	30000	EUR	266	26849817	26889089	39272
EUR_132	30000	EUR	266	31113073	31133912	20839
EUR_132	30000	EUR	266	32824940	32871485	46545
EUR_132	30000	EUR	266	35270136	35361115	90979
EUR_132	30000	EUR	266	57136159	57291065	154906
EUR_132	30000	EUR	266	64321831	64533989	212158
EUR_132	30000	EUR	266	73243224	73275645	32421
EUR_132	30000	EUR	266	73432614	73705981	273367
EUR_132	30000	EUR	266	73896313	73986181	89868
EUR_132	30000	EUR	266	76515893	76623036	107143
EUR_132	30000	EUR	266	79661746	79687804	26058
EUR_132	30000	EUR	266	80874989	81229503	354514
EUR_132	30000	EUR	266	87486948	87615322	128374
EUR_132	30000	EUR	266	88077880	88172209	94329
EUR_132	30000	EUR	266	88761110	88910118	149008
EUR_132	30000	EUR	266	89067780	89099823	32043
EUR_132	30000	EUR	266	91640322	91688404	48082
EUR_132	30000	EUR	266	95829965	95927099	97134
EUR_132	30000	EUR	266	96254221	96268391	14170
EUR_132	30000	EUR	267	8662954	8714283	51329
EUR_132	30000	EUR	267	16202082	16437214	235132
EUR_132	30000	EUR	267	23123133	23168293	45160
EUR_132	30000	EUR	267	26849817	26889089	39272
EUR_132	30000	EUR	267	32694491	32768500	74009
EUR_132	30000	EUR	267	32808818	32870350	61532
EUR_132	30000	EUR	267	54570050	54578539	8489
EUR_132	30000	EUR	267	54686744	54714097	27353
EUR_132	30000	EUR	267	71433365	71457991	24626
EUR_132	30000	EUR	267	74871541	74894548	23007
EUR_132	30000	EUR	267	77606973	77793446	186473
EUR_132	30000	EUR	267	78831605	78886366	54761
EUR_132	30000	EUR	267	79086226	79134588	48362
EUR_132	30000	EUR	267	80874989	81229503	354514
EUR_132	30000	EUR	267	87964655	88160316	195661
EUR_132	30000	EUR	267	88805828	88972858	167030
EUR_132	30000	EUR	267	89989980	89998439	8459
EUR_132	30000	EUR	267	91025410	91107582	82172
EUR_132	30000	EUR	267	91633860	91688404	54544
EUR_132	30000	EUR	267	95829965	95927099	97134
EUR_133	30000	EUR	268	5253381	5312534	59153
EUR_133	30000	EUR	268	9413335	9449917	36582
EUR_133	30000	EUR	268	16243211	16437214	194003
EUR_133	30000	EUR	268	18229012	18368143	139131
EUR_133	30000	EUR	268	25190794	25501390	310596
EUR_133	30000	EUR	268	26392689	26436121	43432
EUR_133	30000	EUR	268	29693031	29706829	13798
EUR_133	30000	EUR	268	32694491	32768500	74009
EUR_133	30000	EUR	268	32808818	32858850	50032
EUR_133	30000	EUR	268	34054443	34182116	127673
EUR_133	30000	EUR	268	39994469	40145306	150837
EUR_133	30000	EUR	268	53525713	53544702	18989
EUR_133	30000	EUR	268	79751575	80004343	252768
EUR_133	30000	EUR	268	80275303	80278256	2953
EUR_133	30000	EUR	268	88761110	88838666	77556
EUR_133	30000	EUR	268	93907950	94180215	272265
EUR_133	30000	EUR	269	1900787	1993052	92265
EUR_133	30000	EUR	269	2922115	3040220	118105
EUR_133	30000	EUR	269	4063698	4128933	65235
EUR_133	30000	EUR	269	7572302	7795144	222842
EUR_133	30000	EUR	269	16397154	16481996	84842
EUR_133	30000	EUR	269	21528581	21598259	69678
EUR_133	30000	EUR	269	23631841	23651476	19635
EUR_133	30000	EUR	269	24433803	24581630	147827
EUR_133	30000	EUR	269	24734599	24737906	3307
EUR_133	30000	EUR	269	31440500	31636518	196018
EUR_133	30000	EUR	269	35406023	35627884	221861
EUR_133	30000	EUR	269	39823503	40145306	321803
EUR_133	30000	EUR	269	42302836	42668186	365350
EUR_133	30000	EUR	269	59279449	59419031	139582
EUR_133	30000	EUR	269	73812122	73876442	64320
EUR_133	30000	EUR	269	74871541	74894548	23007
EUR_133	30000	EUR	269	79887673	79933512	45839
EUR_133	30000	EUR	269	81419681	81567095	147414
EUR_133	30000	EUR	269	87615246	87696235	80989
EUR_133	30000	EUR	269	88761110	89081743	320633
EUR_133	30000	EUR	269	89989980	89998439	8459
EUR_133	30000	EUR	269	91489890	91688404	198514
EUR_133	30000	EUR	269	93680632	93680672	40
EUR_133	30000	EUR	269	94239712	94313443	73731
EUR_134	30000	EUR	270	11532006	11563258	31252
EUR_134	30000	EUR	270	23120612	23184805	64193
EUR_134	30000	EUR	270	26375604	26436121	60517
EUR_134	30000	EUR	270	26567249	26580898	13649
EUR_134	30000	EUR	270	29316030	29365834	49804
EUR_134	30000	EUR	270	32388664	32431881	43217
EUR_134	30000	EUR	270	32526542	32537277	10735
EUR_134	30000	EUR	270	32694491	32759145	64654
EUR_134	30000	EUR	270	37928155	37943125	14970
EUR_134	30000	EUR	270	39639062	39692065	53003
EUR_134	30000	EUR	270	39907281	40020133	112852
EUR_134	30000	EUR	270	43359651	43471816	112165
EUR_134	30000	EUR	270	49702405	49881449	179044
EUR_134	30000	EUR	270	52634497	52662927	28430
EUR_134	30000	EUR	270	75587305	75641163	53858
EUR_134	30000	EUR	270	76653172	76779583	126411
EUR_134	30000	EUR	270	77123560	77233615	110055
EUR_134	30000	EUR	270	88494020	88941340	447320
EUR_134	30000	EUR	270	90972791	91107582	134791
EUR_134	30000	EUR	270	93303963	93319809	15846
EUR_134	30000	EUR	271	1787203	1883643	96440
EUR_134	30000	EUR	271	11532006	11579583	47577
EUR_134	30000	EUR	271	17879034	17984110	105076
EUR_134	30000	EUR	271	20981647	21390474	408827
EUR_134	30000	EUR	271	22447027	22462305	15278
EUR_134	30000	EUR	271	24045382	24166883	121501
EUR_134	30000	EUR	271	25635684	25692513	56829
EUR_134	30000	EUR	271	25995113	26195455	200342
EUR_134	30000	EUR	271	27746608	27801750	55142
EUR_134	30000	EUR	271	34316673	34351822	35149
EUR_134	30000	EUR	271	37944692	38097333	152641
EUR_134	30000	EUR	271	39847102	40083980	236878
EUR_134	30000	EUR	271	42473584	42574352	100768
EUR_134	30000	EUR	271	52359027	52420473	61446
EUR_134	30000	EUR	271	63840934	63854733	13799
EUR_134	30000	EUR	271	64074044	64094340	20296
EUR_134	30000	EUR	271	72373480	72471635	98155
EUR_134	30000	EUR	271	73633815	73702901	69086
EUR_134	30000	EUR	271	88494020	88941340	447320
EUR_134	30000	EUR	271	90972791	91107582	134791
EUR_134	30000	EUR	271	93966746	94001839	35093
EUR_135	30000	EUR	272	9413335	9436595	23260
EUR_135	30000	EUR	272	18211220	18285211	73991
EUR_135	30000	EUR	272	22447027	22533171	86144
EUR_135	30000	EUR	272	24749954	24757234	7280
EUR_135	30000	EUR	272	25140534	25282579	142045
EUR_135	30000	EUR	272	25323974	25692513	368539
EUR_135	30000	EUR	272	31478668	31575105	96437
EUR_135	30000	EUR	272	36793192	36866743	73551
EUR_135	30000	EUR	272	39642776	39688540	45764
EUR_135	30000	EUR	272	40973349	41037792	64443
EUR_135	30000	EUR	272	42280145	42468277	188132
EUR_135	30000	EUR	272	50031962	50246703	214741
EUR_135	30000	EUR	272	70541408	70544348	2940
EUR_135	30000	EUR	272	75110846	75189189	78343
EUR_135	30000	EUR	272	79927591	79929594	2003
EUR_135	30000	EUR	272	91847626	91965764	118138
EUR_135	30000	EUR	272	93141998	93318268	176270
EUR_135	30000	EUR	272	93566853	94108231	541378
EUR_135	30000	EUR	272	94227858	94353699	125841
EUR_135	30000	EUR	272	94459430	94559172	99742
EUR_135	30000	EUR	273	0	411145	411145
EUR_135	30000	EUR	273	2519034	2648737	129703
EUR_135	30000	EUR	273	4020191	4044195	24004
EUR_135	30000	EUR	273	5789806	5822302	32496
EUR_135	30000	EUR	273	22890136	23184805	294669
EUR_135	30000	EUR	273	24088240	24133961	45721
EUR_135	30000	EUR	273	25323974	25692513	368539
EUR_135	30000	EUR	273	32694491	32759145	64654
EUR_135	30000	EUR	273	35001631	35009871	8240
EUR_135	30000	EUR	273	42793149	42823699	30550
EUR_135	30000	EUR	273	54210230	54614450	404220
EUR_135	30000	EUR	273	58057212	58136140	78928
EUR_135	30000	EUR	273	71466790	71612174	145384
EUR_135	30000	EUR	273	73653051	73705981	52930
EUR_135	30000	EUR	273	77674769	77885640	210871
EUR_135	30000	EUR	273	80450538	80507723	57185
EUR_135	30000	EUR	273	88219640	88382260	162620
EUR_135	30000	EUR	273	88619237	88762816	143579
EUR_135	30000	EUR	273	90754357	90820915	66558
EUR_135	30000	EUR	273	91489890	91688404	198514
EUR_135	30000	EUR	273	94388014	94419473	31459
EUR_135	30000	EUR	273	96731555	96762025	30470
EUR_136	30000	EUR	274	1762556	1930967	168411
EUR_136	30000	EUR	274	21073083	21390474	317391
EUR_136	30000	EUR	274	22519633	22533171	13538
EUR_136	30000	EUR	274	22579230	22608307	29077
EUR_136	30000	EUR	274	22890136	23215111	324975
EUR_136	30000	EUR	274	25323974	25351680	27706
EUR_136	30000	EUR	274	25867195	25987107	119912
EUR_136	30000	EUR	274	26422263	26430978	8715
EUR_136	30000	EUR	274	26849817	26889089	39272
EUR_136	30000	EUR	274	34124908	34182116	57208
EUR_136	30000	EUR	274	40410992	40602505	191513
EUR_136	30000	EUR	274	40861764	41135061	273297
EUR_136	30000	EUR	274	53821064	53973632	152568
EUR_136	30000	EUR	274	56378802	56480618	101816
EUR_136	30000	EUR	274	58943812	59122460	178648
EUR_136	30000	EUR	274	68624378	68673073	48695
EUR_136	30000	EUR	274	71544591	71637339	92748
EUR_136	30000	EUR	274	72447779	72471635	23856
EUR_136	30000	EUR	274	73633815	73702901	69086
EUR_136	30000	EUR	274	80952803	81229503	276700
EUR_136	30000	EUR	274	87653008	88105667	452659
EUR_136	30000	EUR	274	88610781	88762816	152035
EUR_136	30000	EUR	274	89989980	89998439	8459
EUR_136	30000	EUR	274	91856433	91929323	72890
EUR_136	30000	EUR	274	91987726	92171686	183960
EUR_136	30000	EUR	274	93050408	93411339	360931
EUR_136	30000	EUR	274	94970004	94991097	21093
EUR_136	30000	EUR	275	5253381	5312534	59153
EUR_136	30000	EUR	275	11622387	11762288	139901
EUR_136	30000	EUR	275	13574314	13635433	61119
EUR_136	30000	EUR	275	13640984	13678187	37203
EUR_136	30000	EUR	275	14051019	14112508	61489
EUR_136	30000	EUR	275	21002390	21212552	210162
EUR_136	30000	EUR	275	23165262	23267376	102114
EUR_136	30000	EUR	275	26319359	26580898	261539
EUR_136	30000	EUR	275	27746608	27974945	228337
EUR_136	30000	EUR	275	28111916	28139866	27950
EUR_136	30000	EUR	275	34845302	35163407	318105
EUR_136	30000	EUR	275	36284487	36460007	175520
EUR_136	30000	EUR	275	36793192	36869887	76695
EUR_136	30000	EUR	275	37805274	37943125	137851
EUR_136	30000	EUR	275	49702405	49809814	107409
EUR_136	30000	EUR	275	51850918	51870076	19158
EUR_136	30000	EUR	275	54113043	54393679	280636
EUR_136	30000	EUR	275	72373480	72471635	98155
EUR_136	30000	EUR	275	76798443	77082685	284242
EUR_136	30000	EUR	275	77733985	77735979	1994
EUR_136	30000	EUR	275	81111648	81190655	79007
EUR_136	30000	EUR	275	86508335	86539843	31508
EUR_136	30000	EUR	275	87727929	87888944	161015
EUR_136	30000	EUR	275	88221167	88300295	79128
EUR_136	30000	EUR	275	91633048	91688404	55356
EUR_136	30000	EUR	275	94388014	94445886	57872
EUR_136	30000	EUR	275	94793518	94818139	24621
EUR_137	30000	EUR	276	1762556	1883643	121087
EUR_137	30000	EUR	276	2508373	2963488	455115
EUR_137	30000	EUR	276	22319180	22417091	97911
EUR_137	30000	EUR	276	24892444	24906091	13647
EUR_137	30000	EUR	276	25537317	25686943	149626
EUR_137	30000	EUR	276	26375604	26436121	60517
EUR_137	30000	EUR	276	34993565	35110499	116934
EUR_137	30000	EUR	276	36634451	36646367	11916
EUR_137	30000	EUR	276	40410992	40475911	64919
EUR_137	30000	EUR	276	49714605	49785207	70602
EUR_137	30000	EUR	276	53525713	53570384	44671
EUR_137	30000	EUR	276	54231248	54247633	16385
EUR_137	30000	EUR	276	56378802	56480618	101816
EUR_137	30000	EUR	276	76139818	76143984	4166
EUR_137	30000	EUR	276	76798443	77082685	284242
EUR_137	30000	EUR	276	78831605	78865177	33572
EUR_137	30000	EUR	276	85353810	85490844	137034
EUR_137	30000	EUR	276	88077880	88172209	94329
EUR_137	30000	EUR	276	91546652	91688404	141752
EUR_137	30000	EUR	277	2899134	3053070	153936
EUR_137	30000	EUR	277	12764351	12953142	188791
EUR_137	30000	EUR	277	16116232	16375047	258815
EUR_137	30000	EUR	277	19048228	19169295	121067
EUR_137	30000	EUR	277	25623732	25639784	16052
EUR_137	30000	EUR	277	27746608	27974945	228337
EUR_137	30000	EUR	277	28111916	28139866	27950
EUR_137	30000	EUR	277	31113073	31133912	20839
EUR_137	30000	EUR	277	40953591	41037792	84201
EUR_137	30000	EUR	277	50053800	50097389	43589
EUR_137	30000	EUR	277	68624378	68717300	92922
EUR_137	30000	EUR	277	74092456	74212177	119721
EUR_137	30000	EUR	277	84755692	84810053	54361
EUR_137	30000	EUR	277	88498234	88881085	382851
EUR_137	30000	EUR	277	90627118	90940624	313506
EUR_137	30000	EUR	277	91072592	91107582	34990
EUR_137	30000	EUR	277	93792178	94222927	430749
EUR_137	30000	EUR	277	94447447	94522438	74991
EUR_137	30000	EUR	277	94793518	94819760	26242
EUR_137	30000	EUR	277	99165891	99224912	59021
EUR_138	30000	EUR	278	3763591	3774274	10683
EUR_138	30000	EUR	278	13094162	13213765	119603
EUR_138	30000	EUR	278	13552023	13563211	11188
EUR_138	30000	EUR	278	17879034	17946855	67821
EUR_138	30000	EUR	278	24580740	24581630	890
EUR_138	30000	EUR	278	26319359	26580898	261539
EUR_138	30000	EUR	278	31617825	31648058	30233
EUR_138	30000	EUR	278	32855612	32870350	14738
EUR_138	30000	EUR	278	32992892	33151307	158415
EUR_138	30000	EUR	278	58863206	58863428	222
EUR_138	30000	EUR	278	71700744	71820558	119814
EUR_138	30000	EUR	278	76558352	76909487	351135
EUR_138	30000	EUR	278	80874989	81110463	235474
EUR_138	30000	EUR	278	88221167	88300295	79128
EUR_138	30000	EUR	278	88324698	88956731	632033
EUR_138	30000	EUR	278	89989980	89998439	8459
EUR_138	30000	EUR	278	93870672	93925519	54847
EUR_138	30000	EUR	278	95303196	95445533	142337
EUR_138	30000	EUR	279	264239	342894	78655
EUR_138	30000	EUR	279	1041641	1079953	38312
EUR_138	30000	EUR	279	1157833	1191560	33727
EUR_138	30000	EUR	279	13574314	13617882	43568
EUR_138	30000	EUR	279	17288353	17397614	109261
EUR_138	30000	EUR	279	18622886	18806641	183755
EUR_138	30000	EUR	279	22113151	22313169	200018
EUR_138	30000	EUR	279	23346980	23651476	304496
EUR_138	30000	EUR	279	25264173	25276538	12365
EUR_138	30000	EUR	279	30904434	31092945	188511
EUR_138	30000	EUR	279	42302836	42823699	520863
EUR_138	30000	EUR	279	49702405	49790168	87763
EUR_138	30000	EUR	279	52626149	52662927	36778
EUR_138	30000	EUR	279	53525713	53544702	18989
EUR_138	30000	EUR	279	54403505	54904011	500506
EUR_138	30000	EUR	279	71780368	71799875	19507
EUR_138	30000	EUR	279	73812122	73906350	94228
EUR_138	30000	EUR	279	77751346	77881732	130386
EUR_138	30000	EUR	279	84755692	84919115	163423
EUR_138	30000	EUR	279	90992837	91107582	114745
EUR_138	30000	EUR	279	94898715	94930362	31647
EUR_139	30000	EUR	280	3531284	3550781	19497
EUR_139	30000	EUR	280	3910700	3982289	71589
EUR_139	30000	EUR	280	4063698	4134871	71173
EUR_139	30000	EUR	280	8622945	8710657	87712
EUR_139	30000	EUR	280	9413335	9449917	36582
EUR_139	30000	EUR	280	19048228	19169295	121067
EUR_139	30000	EUR	280	22447027	22516689	69662
EUR_139	30000	EUR	280	25454373	25561873	107500
EUR_139	30000	EUR	280	31440500	31636518	196018
EUR_139	30000	EUR	280	35771774	35892995	121221
EUR_139	30000	EUR	280	37705403	38097333	391930
EUR_139	30000	EUR	280	39821749	40128543	306794
EUR_139	30000	EUR	280	52626149	52662927	36778
EUR_139	30000	EUR	280	59650599	59762964	112365
EUR_139	30000	EUR	280	63714218	63803837	89619
EUR_139	30000	EUR	280	71780368	71799875	19507
EUR_139	30000	EUR	280	73812122	73906350	94228
EUR_139	30000	EUR	280	79901897	79933512	31615
EUR_139	30000	EUR	280	84755692	84919115	163423
EUR_139	30000	EUR	280	91018779	91107582	88803
EUR_139	30000	EUR	280	93981861	94313443	331582
EUR_139	30000	EUR	280	94358451	94412962	54511
EUR_139	30000	EUR	280	95821549	95880389	58840
EUR_139	30000	EUR	280	99165891	99280798	114907
EUR_139	30000	EUR	281	0	411145	411145
EUR_139	30000	EUR	281	2755836	2872347	116511
EUR_139	30000	EUR	281	4539860	4573252	33392
EUR_139	30000	EUR	281	11650811	11814111	163300
EUR_139	30000	EUR	281	29306591	29365834	59243
EUR_139	30000	EUR	281	32730368	32759145	28777
EUR_139	30000	EUR	281	51850918	51870076	19158
EUR_139	30000	EUR	281	56378802	56480618	101816
EUR_139	30000	EUR	281	71544591	71637339	92748
EUR_139	30000	EUR	281	72447779	72471635	23856
EUR_139	30000	EUR	281	73633815	73702901	69086
EUR_139	30000	EUR	281	74055055	74094072	39017
EUR_139	30000	EUR	281	75089161	75282527	193366
EUR_139	30000	EUR	281	76486431	76589990	103559
EUR_139	30000	EUR	281	77137118	77172196	35078
EUR_139	30000	EUR	281	88087834	88165769	77935
EUR_139	30000	EUR	281	88221167	88224922	3755
EUR_139	30000	EUR	281	93551268	93647010	95742
EUR_139	30000	EUR	281	99165891	99280798	114907
EUR_140	30000	EUR	282	0	411145	411145
EUR_140	30000	EUR	282	1950000	2022517	72517
EUR_140	30000	EUR	282	2519034	2648737	129703
EUR_140	30000	EUR	282	11662358	11814111	151753
EUR_140	30000	EUR	282	18271487	18368143	96656
EUR_140	30000	EUR	282	20981647	21292382	310735
EUR_140	30000	EUR	282	22454245	22608307	154062
EUR_140	30000	EUR	282	23631841	23651476	19635
EUR_140	30000	EUR	282	25323974	25356128	32154
EUR_140	30000	EUR	282	27933038	27974945	41907
EUR_140	30000	EUR	282	29306591	29326030	19439
EUR_140	30000	EUR	282	32992892	33513276	520384
EUR_140	30000	EUR	282	39578272	39603386	25114
EUR_140	30000	EUR	282	41319133	41329331	10198
EUR_140	30000	EUR	282	53821064	53859932	38868
EUR_140	30000	EUR	282	58925219	59190527	265308
EUR_140	30000	EUR	282	72226457	72349727	123270
EUR_140	30000	EUR	282	74912229	75354263	442034
EUR_140	30000	EUR	282	80908589	80979063	70474
EUR_140	30000	EUR	282	88798999	88877558	78559
EUR_140	30000	EUR	282	89067780	89099823	32043
EUR_140	30000	EUR	282	94447447	94522438	74991
EUR_140	30000	EUR	282	94793518	94850934	57416
EUR_140	30000	EUR	283	1762556	1991372	228816
EUR_140	30000	EUR	283	5789806	5797287	7481
EUR_140	30000	EUR	283	13574314	13635433	61119
EUR_140	30000	EUR	283	13640984	13678187	37203
EUR_140	30000	EUR	283	14051019	14112508	61489
EUR_140	30000	EUR	283	17333821	17397614	63793
EUR_140	30000	EUR	283	20535891	20681098	145207
EUR_140	30000	EUR	283	22890136	23215111	324975
EUR_140	30000	EUR	283	23748818	23781066	32248
EUR_140	30000	EUR	283	25323974	25378298	54324
EUR_140	30000	EUR	283	36050639	36089268	38629
EUR_140	30000	EUR	283	36284487	36460007	175520
EUR_140	30000	EUR	283	42164278	42208086	43808
EUR_140	30000	EUR	283	52316366	52388544	72178
EUR_140	30000	EUR	283	54403505	54904011	500506
EUR_140	30000	EUR	283	57427875	57493786	65911
EUR_140	30000	EUR	283	71047773	71070570	22797
EUR_140	30000	EUR	283	74092456	74212177	119721
EUR_140	30000	EUR	283	75522893	75632489	109596
EUR_140	30000	EUR	283	78831605	78865177	33572
EUR_140	30000	EUR	283	80852609	80890918	38309
EUR_140	30000	EUR	283	89067780	89099823	32043
EUR_140	30000	EUR	283	92839624	92850739	11115
EUR_141	30000	EUR	284	1534378	1685328	150950
EUR_141	30000	EUR	284	2546510	2600196	53686
EUR_141	30000	EUR	284	5253381	5312534	59153
EUR_141	30000	EUR	284	17333821	17397614	63793
EUR_141	30000	EUR	284	23639757	23651476	11719
EUR_141	30000	EUR	284	26392689	26436121	43432
EUR_141	30000	EUR	284	31325536	31368982	43446
EUR_141	30000	EUR	284	32694491	32768500	74009
EUR_141	30000	EUR	284	32808818	32858850	50032
EUR_141	30000	EUR	284	34993565	35110499	116934
EUR_141	30000	EUR	284	36634451	36646367	11916
EUR_141	30000	EUR	284	40410992	40475911	64919
EUR_141	30000	EUR	284	54570050	54578539	8489
EUR_141	30000	EUR	284	54686744	54714097	27353
EUR_141	30000	EUR	284	72226457	72349727	123270
EUR_141	30000	EUR	284	74871541	74894548	23007
EUR_141	30000	EUR	284	78096571	78140074	43503
EUR_141	30000	EUR	284	78831605	78886366	54761
EUR_141	30000	EUR	284	79086226	79134588	48362
EUR_141	30000	EUR	284	80874989	81229503	354514
EUR_141	30000	EUR	284	85353810	85568496	214686
EUR_141	30000	EUR	284	88134521	88172209	37688
EUR_141	30000	EUR	284	90754357	90820915	66558
EUR_141	30000	EUR	284	91847626	91875197	27571
EUR_141	30000	EUR	284	93172929	93217584	44655
EUR_141	30000	EUR	284	96136238	96175807	39569
EUR_141	30000	EUR	285	8348919	8636070	287151
EUR_141	30000	EUR	285	8734503	8737332	2829
EUR_141	30000	EUR	285	13737173	13836055	98882
EUR_141	30000	EUR	285	25029419	25134974	105555
EUR_141	30000	EUR	285	25325282	25351680	26398
EUR_141	30000	EUR	285	26319359	26580898	261539
EUR_141	30000	EUR	285	27746608	27776716	30108
EUR_141	30000	EUR	285	29306591	29365834	59243
EUR_141	30000	EUR	285	32730368	32759145	28777
EUR_141	30000	EUR	285	43359651	43418108	58457
EUR_141	30000	EUR	285	54113043	54393679	280636
EUR_141	30000	EUR	285	54592615	54904011	311396
EUR_141	30000	EUR	285	72961212	73172795	211583
EUR_141	30000	EUR	285	73488506	73660589	172083
EUR_141	30000	EUR	285	74055055	74094072	39017
EUR_141	30000	EUR	285	76772794	76909487	136693
EUR_141	30000	EUR	285	77053274	77082685	29411
EUR_141	30000	EUR	285	80161288	80278256	116968
EUR_141	30000	EUR	285	88221167	88224922	3755
EUR_141	30000	EUR	285	89080671	89081743	1072
EUR_141	30000	EUR	285	94312012	94382190	70178
EUR_141	30000	EUR	285	99177558	99280798	103240
EUR_142	30000	EUR	286	1041641	1079953	38312
EUR_142	30000	EUR	286	1157833	1191560	33727
EUR_142	30000	EUR	286	2984450	3003090	18640
EUR_142	30000	EUR	286	8038029	8053067	15038
EUR_142	30000	EUR	286	9413335	9449917	36582
EUR_142	30000	EUR	286	16397154	16497900	100746
EUR_142	30000	EUR	286	18622886	18806641	183755
EUR_142	30000	EUR	286	20981647	21271812	290165
EUR_142	30000	EUR	286	25066876	25088413	21537
EUR_142	30000	EUR	286	25385795	25600157	214362
EUR_142	30000	EUR	286	25847649	25855304	7655
EUR_142	30000	EUR	286	28645700	28746647	100947
EUR_142	30000	EUR	286	31478668	31788752	310084
EUR_142	30000	EUR	286	32694491	32709855	15364
EUR_142	30000	EUR	286	35576182	35644241	68059
EUR_142	30000	EUR	286	35736466	35751236	14770
EUR_142	30000	EUR	286	43380901	43582534	201633
EUR_142	30000	EUR	286	54403505	54863567	460062
EUR_142	30000	EUR	286	71466790	71612174	145384
EUR_142	30000	EUR	286	73653051	73705981	52930
EUR_142	30000	EUR	286	76365488	76397099	31611
EUR_142	30000	EUR	286	76401521	76606551	205030
EUR_142	30000	EUR	286	77050513	77082685	32172
EUR_142	30000	EUR	286	80852609	80890918	38309
EUR_142	30000	EUR	286	88797692	88812922	15230
EUR_142	30000	EUR	286	92839624	93277691	438067
EUR_142	30000	EUR	286	99165891	99280798	114907
EUR_142	30000	EUR	287	1158753	1191560	32807
EUR_142	30000	EUR	287	3763591	3982289	218698
EUR_142	30000	EUR	287	4063698	4134871	71173
EUR_142	30000	EUR	287	13574314	13635433	61119
EUR_142	30000	EUR	287	13640984	13678187	37203
EUR_142	30000	EUR	287	21226662	21274841	48179
EUR_142	30000	EUR	287	22986827	23206189	219362
EUR_142	30000	EUR	287	23432743	23503377	70634
EUR_142	30000	EUR	287	23631841	23651476	19635
EUR_142	30000	EUR	287	25264173	25265065	892
EUR_142	30000	EUR	287	25385795	25399467	13672
EUR_142	30000	EUR	287	31440500	31636518	196018
EUR_142	30000	EUR	287	32293660	32447123	153463
EUR_142	30000	EUR	287	32731416	32768500	37084
EUR_142	30000	EUR	287	36793192	36869887	76695
EUR_142	30000	EUR	287	37805274	37943125	137851
EUR_142	30000	EUR	287	76365488	76403689	38201
EUR_142	30000	EUR	287	76798443	76927673	129230
EUR_142	30000	EUR	287	77751346	77795560	44214
EUR_142	30000	EUR	287	78697685	78886621	188936
EUR_142	30000	EUR	287	78983641	78992993	9352
EUR_142	30000	EUR	287	84755692	84919115	163423
EUR_142	30000	EUR	287	87615246	87696235	80989
EUR_142	30000	EUR	287	91337361	91345303	7942
EUR_142	30000	EUR	287	94114395	94181111	66716
EUR_142	30000	EUR	287	95774147	95778109	3962
EUR_142	30000	EUR	287	96136238	96175807	39569
EUR_143	30000	EUR	288	5253381	5312534	59153
EUR_143	30000	EUR	288	16383279	16384266	987
EUR_143	30000	EUR	288	18057439	18173182	115743
EUR_143	30000	EUR	288	20370960	20455191	84231
EUR_143	30000	EUR	288	22918884	23121198	202314
EUR_143	30000	EUR	288	23276233	23442163	165930
EUR_143	30000	EUR	288	23551910	23554604	2694
EUR_143	30000	EUR	288	25264173	25276538	12365
EUR_143	30000	EUR	288	25626912	25692513	65601
EUR_143	30000	EUR	288	32694491	32837729	143238
EUR_143	30000	EUR	288	35771774	35892995	121221
EUR_143	30000	EUR	288	36634451	36678544	44093
EUR_143	30000	EUR	288	39847102	40083980	236878
EUR_143	30000	EUR	288	42473584	42574352	100768
EUR_143	30000	EUR	288	49702405	49881449	179044
EUR_143	30000	EUR	288	68624378	68673073	48695
EUR_143	30000	EUR	288	71700744	71764001	63257
EUR_143	30000	EUR	288	71780368	71820558	40190
EUR_143	30000	EUR	288	72373480	72431184	57704
EUR_143	30000	EUR	288	73582233	73650807	68574
EUR_143	30000	EUR	288	74644219	74738891	94672
EUR_143	30000	EUR	288	77995793	78058706	62913
EUR_143	30000	EUR	288	78697685	79134588	436903
EUR_143	30000	EUR	288	87268119	87455574	187455
EUR_143	30000	EUR	288	88796237	89010522	214285
EUR_143	30000	EUR	288	93123848	93146996	23148
EUR_143	30000	EUR	289	12968700	13133318	164618
EUR_143	30000	EUR	289	20981647	21271812	290165
EUR_143	30000	EUR	289	23176150	23184805	8655
EUR_143	30000	EUR	289	23584099	23767868	183769
EUR_143	30000	EUR	289	25066876	25088413	21537
EUR_143	30000	EUR	289	25385795	25600157	214362
EUR_143	30000	EUR	289	25847649	25855304	7655
EUR_143	30000	EUR	289	26849817	26889089	39272
EUR_143	30000	EUR	289	31065764	31127610	61846
EUR_143	30000	EUR	289	34985092	35249775	264683
EUR_143	30000	EUR	289	35576182	35644241	68059
EUR_143	30000	EUR	289	35736466	35751236	14770
EUR_143	30000	EUR	289	42821514	42823699	2185
EUR_143	30000	EUR	289	57805237	57861351	56114
EUR_143	30000	EUR	289	71466790	71612174	145384
EUR_143	30000	EUR	289	73653051	73705981	52930
EUR_143	30000	EUR	289	76088300	76143984	55684
EUR_143	30000	EUR	289	88208344	88340224	131880
EUR_143	30000	EUR	289	89811998	89914231	102233
EUR_143	30000	EUR	289	93961556	94092405	130849
EUR_143	30000	EUR	289	94885812	94898377	12565
EUR_143	30000	EUR	289	94898715	94930362	31647
EUR_144	30000	EUR	290	21015460	21199936	184476
EUR_144	30000	EUR	290	22992959	23099324	106365
EUR_144	30000	EUR	290	25066876	25088413	21537
EUR_144	30000	EUR	290	25189085	25646013	456928
EUR_144	30000	EUR	290	26319359	26580898	261539
EUR_144	30000	EUR	290	58925219	59190527	265308
EUR_144	30000	EUR	290	71047773	71070570	22797
EUR_144	30000	EUR	290	76022322	76042432	20110
EUR_144	30000	EUR	290	84755692	84810053	54361
EUR_144	30000	EUR	290	85579439	85788658	209219
EUR_144	30000	EUR	290	86508335	86539843	31508
EUR_144	30000	EUR	290	87652065	87661974	9909
EUR_144	30000	EUR	290	88219640	88529765	310125
EUR_144	30000	EUR	290	91337361	91345303	7942
EUR_144	30000	EUR	290	93551268	93647010	95742
EUR_144	30000	EUR	290	94898715	94930362	31647
EUR_144	30000	EUR	290	95774147	95901699	127552
EUR_144	30000	EUR	291	4458174	4517103	58929
EUR_144	30000	EUR	291	22992959	23099324	106365
EUR_144	30000	EUR	291	25392757	25406871	14114
EUR_144	30000	EUR	291	26626799	26642283	15484
EUR_144	30000	EUR	291	29306591	29579668	273077
EUR_144	30000	EUR	291	31437056	31548447	111391
EUR_144	30000	EUR	291	54615125	54904011	288886
EUR_144	30000	EUR	291	64321831	64328268	6437
EUR_144	30000	EUR	291	68624378	68713281	88903
EUR_144	30000	EUR	291	76365488	76472340	106852
EUR_144	30000	EUR	291	84770173	84796498	26325
EUR_144	30000	EUR	291	86508335	86539843	31508
EUR_144	30000	EUR	291	88077880	88651451	573571
EUR_144	30000	EUR	291	88951464	89001971	50507
EUR_144	30000	EUR	291	89989980	89998439	8459
EUR_144	30000	EUR	291	90996188	91076018	79830
EUR_144	30000	EUR	291	93539368	93585074	45706
EUR_144	30000	EUR	291	94087786	94381472	293686
EUR_144	30000	EUR	291	94412297	94544971	132674
EUR_144	30000	EUR	291	96506025	96557237	51212
EUR_144	30000	EUR	291	99165891	99197260	31369
EUR_145	30000	EUR	292	16617173	16681323	64150
EUR_145	30000	EUR	292	17889447	18016499	127052
EUR_145	30000	EUR	292	21224963	21225412	449
EUR_145	30000	EUR	292	22918884	23121198	202314
EUR_145	30000	EUR	292	23156936	23184805	27869
EUR_145	30000	EUR	292	24045382	24166883	121501
EUR_145	30000	EUR	292	25323974	25378298	54324
EUR_145	30000	EUR	292	27746608	27801750	55142
EUR_145	30000	EUR	292	30889388	30971791	82403
EUR_145	30000	EUR	292	31111231	31151086	39855
EUR_145	30000	EUR	292	32036224	32105882	69658
EUR_145	30000	EUR	292	34999082	35110499	111417
EUR_145	30000	EUR	292	35562258	35707528	145270
EUR_145	30000	EUR	292	37705403	38097333	391930
EUR_145	30000	EUR	292	41350421	41360462	10041
EUR_145	30000	EUR	292	42164278	42208086	43808
EUR_145	30000	EUR	292	53525713	53570384	44671
EUR_145	30000	EUR	292	54231248	54247633	16385
EUR_145	30000	EUR	292	57427875	57493786	65911
EUR_145	30000	EUR	292	57712252	57806900	94648
EUR_145	30000	EUR	292	64803473	64820966	17493
EUR_145	30000	EUR	292	79901897	79903521	1624
EUR_145	30000	EUR	292	83554127	83592822	38695
EUR_145	30000	EUR	292	84755692	84919115	163423
EUR_145	30000	EUR	292	88077880	88172209	94329
EUR_145	30000	EUR	292	88501433	88762816	261383
EUR_145	30000	EUR	292	91018779	91107582	88803
EUR_145	30000	EUR	292	94290726	94412962	122236
EUR_145	30000	EUR	292	94970004	94991097	21093
EUR_145	30000	EUR	292	96116814	96282167	165353
EUR_145	30000	EUR	293	2813723	3065958	252235
EUR_145	30000	EUR	293	3531284	3550781	19497
EUR_145	30000	EUR	293	3771889	4111306	339417
EUR_145	30000	EUR	293	13094162	13213765	119603
EUR_145	30000	EUR	293	13552023	13563211	11188
EUR_145	30000	EUR	293	22519633	22533171	13538
EUR_145	30000	EUR	293	22579230	22608307	29077
EUR_145	30000	EUR	293	22890136	23215111	324975
EUR_145	30000	EUR	293	23685805	23781066	95261
EUR_145	30000	EUR	293	25189085	25235709	46624
EUR_145	30000	EUR	293	25537317	25692513	155196
EUR_145	30000	EUR	293	25995113	26216582	221469
EUR_145	30000	EUR	293	31087987	31368982	280995
EUR_145	30000	EUR	293	31671896	31807339	135443
EUR_145	30000	EUR	293	34275078	34351822	76744
EUR_145	30000	EUR	293	35771774	35892995	121221
EUR_145	30000	EUR	293	42399388	42823699	424311
EUR_145	30000	EUR	293	52661635	52662927	1292
EUR_145	30000	EUR	293	53821064	53973632	152568
EUR_145	30000	EUR	293	56476588	56480618	4030
EUR_145	30000	EUR	293	73647668	73705981	58313
EUR_145	30000	EUR	293	74055055	74094072	39017
EUR_145	30000	EUR	293	76365488	76397099	31611
EUR_145	30000	EUR	293	79862919	80004343	141424
EUR_145	30000	EUR	293	88025602	88093768	68166
EUR_145	30000	EUR	293	94447447	94522438	74991
EUR_145	30000	EUR	293	95436278	95445533	9255
EUR_145	30000	EUR	293	95774147	96346551	572404
EUR_145	30000	EUR	293	99972505	1e+08	27495
EUR_146	30000	EUR	294	10399704	10402156	2452
EUR_146	30000	EUR	294	18731537	18806641	75104
EUR_146	30000	EUR	294	24892444	24906091	13647
EUR_146	30000	EUR	294	25537317	25603895	66578
EUR_146	30000	EUR	294	27746608	27801750	55142
EUR_146	30000	EUR	294	29306591	29365834	59243
EUR_146	30000	EUR	294	32018123	32141896	123773
EUR_146	30000	EUR	294	32848174	33016465	168291
EUR_146	30000	EUR	294	71700744	71820558	119814
EUR_146	30000	EUR	294	73488506	73509057	20551
EUR_146	30000	EUR	294	76094687	76143984	49297
EUR_146	30000	EUR	294	76577005	76582454	5449
EUR_146	30000	EUR	294	79824188	79933512	109324
EUR_146	30000	EUR	294	83886982	83957574	70592
EUR_146	30000	EUR	294	88731415	88988477	257062
EUR_146	30000	EUR	294	93981861	94073065	91204
EUR_146	30000	EUR	294	94179666	94275496	95830
EUR_146	30000	EUR	294	94312012	94382190	70178
EUR_146	30000	EUR	295	1534378	1685328	150950
EUR_146	30000	EUR	295	1904339	1993052	88713
EUR_146	30000	EUR	295	23165262	23267376	102114
EUR_146	30000	EUR	295	25189085	25217171	28086
EUR_146	30000	EUR	295	25323974	25378298	54324
EUR_146	30000	EUR	295	25867195	25987107	119912
EUR_146	30000	EUR	295	26111918	26176332	64414
EUR_146	30000	EUR	295	29273800	29311528	37728
EUR_146	30000	EUR	295	30889388	31145710	256322
EUR_146	30000	EUR	295	36793192	36869887	76695
EUR_146	30000	EUR	295	43520906	43653793	132887
EUR_146	30000	EUR	295	72961212	73172795	211583
EUR_146	30000	EUR	295	73488506	73548611	60105
EUR_146	30000	EUR	295	75522893	75632489	109596
EUR_146	30000	EUR	295	77733985	77735979	1994
EUR_146	30000	EUR	295	79114596	79134588	19992
EUR_146	30000	EUR	295	79842561	80034351	191790
EUR_146	30000	EUR	295	81113251	81229503	116252
EUR_146	30000	EUR	295	83886982	83957574	70592
EUR_146	30000	EUR	295	84755692	84919115	163423
EUR_146	30000	EUR	295	88218213	88372217	154004
EUR_146	30000	EUR	295	88460364	88600577	140213
EUR_146	30000	EUR	295	91856433	91899455	43022
EUR_146	30000	EUR	295	92892702	92935218	42516
EUR_146	30000	EUR	295	93303963	93395321	91358
EUR_146	30000	EUR	295	93475944	93494576	18632
EUR_147	30000	EUR	296	4458174	4652717	194543
EUR_147	30000	EUR	296	17350938	17365688	14750
EUR_147	30000	EUR	296	17889447	18016499	127052
EUR_147	30000	EUR	296	19122962	19169295	46333
EUR_147	30000	EUR	296	20535891	20681098	145207
EUR_147	30000	EUR	296	23584099	23598380	14281
EUR_147	30000	EUR	296	24535453	24581630	46177
EUR_147	30000	EUR	296	33279807	33324192	44385
EUR_147	30000	EUR	296	38009742	38097333	87591
EUR_147	30000	EUR	296	40953591	41037792	84201
EUR_147	30000	EUR	296	52626149	52662927	36778
EUR_147	30000	EUR	296	53525713	53544702	18989
EUR_147	30000	EUR	296	56378802	56480618	101816
EUR_147	30000	EUR	296	59650996	59762964	111968
EUR_147	30000	EUR	296	75089161	75282527	193366
EUR_147	30000	EUR	296	76558352	76687371	129019
EUR_147	30000	EUR	296	80135541	80139395	3854
EUR_147	30000	EUR	296	83886982	83957574	70592
EUR_147	30000	EUR	296	88025602	88085432	59830
EUR_147	30000	EUR	296	88087834	88153791	65957
EUR_147	30000	EUR	296	89811998	89818615	6617
EUR_147	30000	EUR	296	90409104	90619367	210263
EUR_147	30000	EUR	296	94447447	94522438	74991
EUR_147	30000	EUR	296	95374182	95445533	71351
EUR_147	30000	EUR	296	95843893	95880389	36496
EUR_147	30000	EUR	297	1004770	1079953	75183
EUR_147	30000	EUR	297	1157833	1191560	33727
EUR_147	30000	EUR	297	11871846	12122701	250855
EUR_147	30000	EUR	297	17350938	17365688	14750
EUR_147	30000	EUR	297	17889447	18016499	127052
EUR_147	30000	EUR	297	22992959	23099324	106365
EUR_147	30000	EUR	297	24372241	24581630	209389
EUR_147	30000	EUR	297	30974915	31127610	152695
EUR_147	30000	EUR	297	32755333	32768500	13167
EUR_147	30000	EUR	297	32808818	32858850	50032
EUR_147	30000	EUR	297	68624378	68624464	86
EUR_147	30000	EUR	297	70340835	70380749	39914
EUR_147	30000	EUR	297	73488506	73574713	86207
EUR_147	30000	EUR	297	74871541	74894548	23007
EUR_147	30000	EUR	297	76365488	76606551	241063
EUR_147	30000	EUR	297	76759679	76871517	111838
EUR_147	30000	EUR	297	79621494	79687804	66310
EUR_147	30000	EUR	297	83886982	83957574	70592
EUR_147	30000	EUR	297	87969149	87994899	25750
EUR_147	30000	EUR	297	88077880	88113143	35263
EUR_147	30000	EUR	297	88405406	88464514	59108
EUR_147	30000	EUR	297	88761110	88877947	116837
EUR_147	30000	EUR	297	89067780	89099823	32043
EUR_147	30000	EUR	297	91891040	91902611	11571
EUR_147	30000	EUR	297	96195614	96352723	157109
EUR_148	30000	EUR	298	7621285	7715723	94438
EUR_148	30000	EUR	298	24892444	24906091	13647
EUR_148	30000	EUR	298	25537317	25639784	102467
EUR_148	30000	EUR	298	31437056	31648058	211002
EUR_148	30000	EUR	298	31699236	31853916	154680
EUR_148	30000	EUR	298	32824940	32871485	46545
EUR_148	30000	EUR	298	33126706	33180725	54019
EUR_148	30000	EUR	298	35576182	35584922	8740
EUR_148	30000	EUR	298	41319133	41360462	41329
EUR_148	30000	EUR	298	42752327	42823699	71372
EUR_148	30000	EUR	298	54403505	54904011	500506
EUR_148	30000	EUR	298	57805237	57861351	56114
EUR_148	30000	EUR	298	73571089	73574713	3624
EUR_148	30000	EUR	298	81502816	81569729	66913
EUR_148	30000	EUR	298	83503362	83550130	46768
EUR_148	30000	EUR	298	88804587	88975974	171387
EUR_148	30000	EUR	298	89989980	89998439	8459
EUR_148	30000	EUR	298	93943380	94056780	113400
EUR_148	30000	EUR	298	94392287	94559172	166885
EUR_148	30000	EUR	299	8671826	8714283	42457
EUR_148	30000	EUR	299	18622886	18703470	80584
EUR_148	30000	EUR	299	22992959	23099324	106365
EUR_148	30000	EUR	299	23156936	23184805	27869
EUR_148	30000	EUR	299	23417236	23569549	152313
EUR_148	30000	EUR	299	24892444	24906091	13647
EUR_148	30000	EUR	299	25323974	25377647	53673
EUR_148	30000	EUR	299	28689322	28746647	57325
EUR_148	30000	EUR	299	30804231	30861567	57336
EUR_148	30000	EUR	299	32262916	32267787	4871
EUR_148	30000	EUR	299	35780770	35849669	68899
EUR_148	30000	EUR	299	41350421	41360462	10041
EUR_148	30000	EUR	299	59553546	59604966	51420
EUR_148	30000	EUR	299	75089161	75282527	193366
EUR_148	30000	EUR	299	77751346	77830955	79609
EUR_148	30000	EUR	299	79824188	79933512	109324
EUR_148	30000	EUR	299	83370620	83384810	14190
EUR_148	30000	EUR	299	87987577	87994899	7322
EUR_148	30000	EUR	299	88077880	88172209	94329
EUR_148	30000	EUR	299	88804587	88975974	171387
EUR_148	30000	EUR	299	93553045	93713967	160922
EUR_148	30000	EUR	299	94339305	94439046	99741
EUR_148	30000	EUR	299	94793518	95112420	318902
EUR_148	30000	EUR	299	95975458	96175181	199723
EUR_149	30000	EUR	300	1004770	1079953	75183
EUR_149	30000	EUR	300	1157833	1191560	33727
EUR_149	30000	EUR	300	2209083	2476266	267183
EUR_149	30000	EUR	300	16397154	16497900	100746
EUR_149	30000	EUR	300	20535891	20681098	145207
EUR_149	30000	EUR	300	22283237	22433412	150175
EUR_149	30000	EUR	300	25189085	25305885	116800
EUR_149	30000	EUR	300	25655883	25742481	86598
EUR_149	30000	EUR	300	32293660	32473898	180238
EUR_149	30000	EUR	300	32499856	32556505	56649
EUR_149	30000	EUR	300	32855612	32870350	14738
EUR_149	30000	EUR	300	58057212	58136140	78928
EUR_149	30000	EUR	300	68234244	68360598	126354
EUR_149	30000	EUR	300	85353810	85490844	137034
EUR_149	30000	EUR	300	88765447	89081743	316296
EUR_149	30000	EUR	300	95816191	96346551	530360
EUR_149	30000	EUR	301	1762556	1991372	228816
EUR_149	30000	EUR	301	3890786	4134871	244085
EUR_149	30000	EUR	301	5018475	5041230	22755
EUR_149	30000	EUR	301	9413335	9449917	36582
EUR_149	30000	EUR	301	16202082	16437214	235132
EUR_149	30000	EUR	301	18229012	18368143	139131
EUR_149	30000	EUR	301	23721919	23797839	75920
EUR_149	30000	EUR	301	25323974	25378298	54324
EUR_149	30000	EUR	301	31440500	31636518	196018
EUR_149	30000	EUR	301	32293660	32447123	153463
EUR_149	30000	EUR	301	32731416	32768500	37084
EUR_149	30000	EUR	301	58569405	58694180	124775
EUR_149	30000	EUR	301	64338347	64519080	180733
EUR_149	30000	EUR	301	68212528	68360598	148070
EUR_149	30000	EUR	301	68694407	68717300	22893
EUR_149	30000	EUR	301	75089161	75282527	193366
EUR_149	30000	EUR	301	75587305	75641163	53858
EUR_149	30000	EUR	301	77606973	77706627	99654
EUR_149	30000	EUR	301	79931678	79936163	4485
EUR_149	30000	EUR	301	87512858	87623148	110290
EUR_149	30000	EUR	301	90103571	90314521	210950
EUR_149	30000	EUR	301	91595465	91605385	9920
EUR_149	30000	EUR	301	94388014	94437057	49043
EUR_150	30000	EUR	302	264239	341796	77557
EUR_150	30000	EUR	302	1534378	1685328	150950
EUR_150	30000	EUR	302	5253381	5312534	59153
EUR_150	30000	EUR	302	8543877	8569481	25604
EUR_150	30000	EUR	302	17922377	18016499	94122
EUR_150	30000	EUR	302	26375604	26436121	60517
EUR_150	30000	EUR	302	27104809	27162106	57297
EUR_150	30000	EUR	302	29321833	29396318	74485
EUR_150	30000	EUR	302	30889388	31025577	136189
EUR_150	30000	EUR	302	36340804	36613907	273103
EUR_150	30000	EUR	302	39578272	39603386	25114
EUR_150	30000	EUR	302	41319133	41329331	10198
EUR_150	30000	EUR	302	42756207	42823699	67492
EUR_150	30000	EUR	302	54653171	54730663	77492
EUR_150	30000	EUR	302	59650599	59762964	112365
EUR_150	30000	EUR	302	63840934	63892461	51527
EUR_150	30000	EUR	302	64049018	64147418	98400
EUR_150	30000	EUR	302	73571089	73574713	3624
EUR_150	30000	EUR	302	79824188	79933512	109324
EUR_150	30000	EUR	302	80952803	81229503	276700
EUR_150	30000	EUR	302	83886982	83957574	70592
EUR_150	30000	EUR	302	85353810	85490844	137034
EUR_150	30000	EUR	302	87547254	87656802	109548
EUR_150	30000	EUR	302	87727929	87847745	119816
EUR_150	30000	EUR	302	88087834	88146039	58205
EUR_150	30000	EUR	302	93792178	94035011	242833
EUR_150	30000	EUR	302	94348955	94544971	196016
EUR_150	30000	EUR	302	96195614	96352723	157109
EUR_150	30000	EUR	303	3763591	3982289	218698
EUR_150	30000	EUR	303	4063698	4134871	71173
EUR_150	30000	EUR	303	5789806	5797287	7481
EUR_150	30000	EUR	303	13574314	13634873	60559
EUR_150	30000	EUR	303	22918884	23168293	249409
EUR_150	30000	EUR	303	25867195	25987107	119912
EUR_150	30000	EUR	303	28617778	28746647	128869
EUR_150	30000	EUR	303	29273800	29311528	37728
EUR_150	30000	EUR	303	31111231	31151086	39855
EUR_150	30000	EUR	303	39947061	40087247	140186
EUR_150	30000	EUR	303	40953591	41037792	84201
EUR_150	30000	EUR	303	49702405	49881449	179044
EUR_150	30000	EUR	303	54151884	54177383	25499
EUR_150	30000	EUR	303	56410070	56462221	52151
EUR_150	30000	EUR	303	59130252	59214311	84059
EUR_150	30000	EUR	303	73243224	73275645	32421
EUR_150	30000	EUR	303	73432614	73547669	115055
EUR_150	30000	EUR	303	76577005	76582454	5449
EUR_150	30000	EUR	303	78246564	78301884	55320
EUR_150	30000	EUR	303	88077880	88172209	94329
EUR_150	30000	EUR	303	88761110	89081743	320633
EUR_150	30000	EUR	303	93168828	93264500	95672
EUR_150	30000	EUR	303	93800814	94181111	380297
EUR_150	30000	EUR	303	94793518	94908178	114660
EUR_150	30000	EUR	303	96229638	96241778	12140
EUR_151	20000	EUR	304	8734503	8737332	2829
EUR_151	20000	EUR	304	9431845	9449917	18072
EUR_151	20000	EUR	304	10399704	10402156	2452
EUR_151	20000	EUR	304	21098420	21202559	104139
EUR_151	20000	EUR	304	23120612	23184805	64193
EUR_151	20000	EUR	304	25867195	25893125	25930
EUR_151	20000	EUR	304	26816945	26991485	174540
EUR_151	20000	EUR	304	27746608	27894364	147756
EUR_151	20000	EUR	304	32694491	32748960	54469
EUR_151	20000	EUR	304	33126757	33151809	25052
EUR_151	20000	EUR	304	41319133	41360462	41329
EUR_151	20000	EUR	304	50053800	50097389	43589
EUR_151	20000	EUR	304	59423469	59522281	98812
EUR_151	20000	EUR	304	59525840	59631623	105783
EUR_151	20000	EUR	304	74019705	74094072	74367
EUR_151	20000	EUR	304	75263541	75282527	18986
EUR_151	20000	EUR	304	78816419	79134588	318169
EUR_151	20000	EUR	304	83533777	83550130	16353
EUR_151	20000	EUR	304	83554127	83592822	38695
EUR_151	20000	EUR	304	90153261	90233834	80573
EUR_151	20000	EUR	304	93168828	93264500	95672
EUR_151	20000	EUR	304	93947223	94317758	370535
EUR_151	20000	EUR	304	94447394	94544971	97577
EUR_151	20000	EUR	304	95270807	95445533	174726
EUR_151	20000	EUR	304	95774147	95901699	127552
EUR_151	20000	EUR	304	99177558	99280798	103240
EUR_151	20000	EUR	305	2788906	2935582	146676
EUR_151	20000	EUR	305	5121074	5123781	2707
EUR_151	20000	EUR	305	16243211	16293533	50322
EUR_151	20000	EUR	305	21150173	21156082	5909
EUR_151	20000	EUR	305	21200799	21274841	74042
EUR_151	20000	EUR	305	21353991	21429464	75473
EUR_151	20000	EUR	305	25343770	25501390	157620
EUR_151	20000	EUR	305	25953989	25987107	33118
EUR_151	20000	EUR	305	27746608	27894364	147756
EUR_151	20000	EUR	305	29321833	29396318	74485
EUR_151	20000	EUR	305	31528053	31593163	65110
EUR_151	20000	EUR	305	32667412	32838295	170883
EUR_151	20000	EUR	305	33167789	33295884	128095
EUR_151	20000	EUR	305	34136759	34182116	45357
EUR_151	20000	EUR	305	34999082	35095643	96561
EUR_151	20000	EUR	305	39957500	39960153	2653
EUR_151	20000	EUR	305	49702405	49809814	107409
EUR_151	20000	EUR	305	52168283	52337003	168720
EUR_151	20000	EUR	305	54659849	54665953	6104
EUR_151	20000	EUR	305	57149895	57291065	141170
EUR_151	20000	EUR	305	58580135	58694180	114045
EUR_151	20000	EUR	305	58863206	58863428	222
EUR_151	20000	EUR	305	59576740	59700527	123787
EUR_151	20000	EUR	305	64321831	64406792	84961
EUR_151	20000	EUR	305	68675332	68717300	41968
EUR_151	20000	EUR	305	73112940	73160136	47196
EUR_151	20000	EUR	305	75587305	75641163	53858
EUR_151	20000	EUR	305	77606973	77624992	18019
EUR_151	20000	EUR	305	77800262	77900737	100475
EUR_151	20000	EUR	305	79901897	79936163	34266
EUR_151	20000	EUR	305	80161288	80278256	116968
EUR_151	20000	EUR	305	83903513	83957574	54061
EUR_151	20000	EUR	305	88087834	88762816	674982
EUR_151	20000	EUR	305	88915214	88957821	42607
EUR_151	20000	EUR	305	89011064	89081743	70679
EUR_151	20000	EUR	305	90443917	90558518	114601
EUR_151	20000	EUR	305	94595895	94713332	117437
EUR_151	20000	EUR	305	95348335	95382886	34551
EUR_151	20000	EUR	305	95829965	95927099	97134
EUR_152	20000	EUR	306	1945682	1959936	14254
EUR_152	20000	EUR	306	4042823	4044195	1372
EUR_152	20000	EUR	306	7287218	7349567	62349
EUR_152	20000	EUR	306	16243211	16355261	112050
EUR_152	20000	EUR	306	16646358	16681323	34965
EUR_152	20000	EUR	306	22447027	22462305	15278
EUR_152	20000	EUR	306	23176150	23184805	8655
EUR_152	20000	EUR	306	23935058	23997380	62322
EUR_152	20000	EUR	306	25817587	25896396	78809
EUR_152	20000	EUR	306	26319359	26513093	193734
EUR_152	20000	EUR	306	33445186	33479750	34564
EUR_152	20000	EUR	306	35811062	35849669	38607
EUR_152	20000	EUR	306	52168283	52224193	55910
EUR_152	20000	EUR	306	53872128	54075933	203805
EUR_152	20000	EUR	306	54686744	54714097	27353
EUR_152	20000	EUR	306	56378802	56448072	69270
EUR_152	20000	EUR	306	57288509	57291065	2556
EUR_152	20000	EUR	306	57712252	57861351	149099
EUR_152	20000	EUR	306	72471551	72471635	84
EUR_152	20000	EUR	306	76759679	76869710	110031
EUR_152	20000	EUR	306	76921572	77082685	161113
EUR_152	20000	EUR	306	87550109	87647830	97721
EUR_152	20000	EUR	306	93680632	93680672	40
EUR_152	20000	EUR	306	93696093	93713967	17874
EUR_152	20000	EUR	306	94210771	94222927	12156
EUR_152	20000	EUR	306	95774147	95778109	3962
EUR_152	20000	EUR	307	1853096	1854996	1900
EUR_152	20000	EUR	307	2737848	2740181	2333
EUR_152	20000	EUR	307	9321331	9449917	128586
EUR_152	20000	EUR	307	11532006	11731498	199492
EUR_152	20000	EUR	307	16243211	16437214	194003
EUR_152	20000	EUR	307	24892444	24906091	13647
EUR_152	20000	EUR	307	25285126	25305885	20759
EUR_152	20000	EUR	307	25537317	25639784	102467
EUR_152	20000	EUR	307	25868315	25896396	28081
EUR_152	20000	EUR	307	25898105	25905765	7660
EUR_152	20000	EUR	307	27746608	27974945	228337
EUR_152	20000	EUR	307	28108851	28110553	1702
EUR_152	20000	EUR	307	31431938	31446638	14700
EUR_152	20000	EUR	307	32824940	32871485	46545
EUR_152	20000	EUR	307	33126757	33166924	40167
EUR_152	20000	EUR	307	34136759	34182116	45357
EUR_152	20000	EUR	307	35059726	35095643	35917
EUR_152	20000	EUR	307	39681230	39692065	10835
EUR_152	20000	EUR	307	40410992	40602505	191513
EUR_152	20000	EUR	307	54210889	54362674	151785
EUR_152	20000	EUR	307	58943812	59122460	178648
EUR_152	20000	EUR	307	72288615	72398733	110118
EUR_152	20000	EUR	307	74055055	74086574	31519
EUR_152	20000	EUR	307	74181531	74196975	15444
EUR_152	20000	EUR	307	75587305	75641163	53858
EUR_152	20000	EUR	307	76365488	76370460	4972
EUR_152	20000	EUR	307	78816419	79134588	318169
EUR_152	20000	EUR	307	80852609	80890918	38309
EUR_152	20000	EUR	307	84755692	84810053	54361
EUR_152	20000	EUR	307	87369479	87389813	20334
EUR_152	20000	EUR	307	87580327	87751923	171596
EUR_152	20000	EUR	307	88025602	88030185	4583
EUR_152	20000	EUR	307	88087834	88679238	591404
EUR_152	20000	EUR	307	88761110	89081743	320633
EUR_152	20000	EUR	307	90103571	90243516	139945
EUR_152	20000	EUR	307	91976671	92000571	23900
EUR_152	20000	EUR	307	94239181	94337048	97867
EUR_152	20000	EUR	307	94348955	94544971	196016
EUR_152	20000	EUR	307	96292257	96346551	54294
EUR_153	20000	EUR	308	13621609	13626532	4923
EUR_153	20000	EUR	308	21195166	21282925	87759
EUR_153	20000	EUR	308	22447027	22468823	21796
EUR_153	20000	EUR	308	23032354	23168293	135939
EUR_153	20000	EUR	308	24548376	24578020	29644
EUR_153	20000	EUR	308	25140534	25209294	68760
EUR_153	20000	EUR	308	26375604	26436121	60517
EUR_153	20000	EUR	308	30904434	31092945	188511
EUR_153	20000	EUR	308	32039879	32057645	17766
EUR_153	20000	EUR	308	35664184	35693478	29294
EUR_153	20000	EUR	308	35699524	35892995	193471
EUR_153	20000	EUR	308	36050639	36089268	38629
EUR_153	20000	EUR	308	36793192	36795080	1888
EUR_153	20000	EUR	308	40410992	40602505	191513
EUR_153	20000	EUR	308	49702405	49853573	151168
EUR_153	20000	EUR	308	56476588	56480618	4030
EUR_153	20000	EUR	308	59650599	59762964	112365
EUR_153	20000	EUR	308	72964182	73172795	208613
EUR_153	20000	EUR	308	76022322	76143984	121662
EUR_153	20000	EUR	308	80863277	80899276	35999
EUR_153	20000	EUR	308	86508335	86539843	31508
EUR_153	20000	EUR	308	87580327	87628134	47807
EUR_153	20000	EUR	308	88087834	88319207	231373
EUR_153	20000	EUR	308	90141069	90164943	23874
EUR_153	20000	EUR	308	93680632	93680672	40
EUR_153	20000	EUR	308	93685203	93713967	28764
EUR_153	20000	EUR	308	94196868	94317758	120890
EUR_153	20000	EUR	308	96150043	96217388	67345
EUR_153	20000	EUR	308	96506025	97008044	502019
EUR_153	20000	EUR	308	99192246	99280798	88552
EUR_153	20000	EUR	309	1762556	1830270	67714
EUR_153	20000	EUR	309	3763591	3801794	38203
EUR_153	20000	EUR	309	3890786	4115507	224721
EUR_153	20000	EUR	309	8348919	8386102	37183
EUR_153	20000	EUR	309	11532006	11579583	47577
EUR_153	20000	EUR	309	21093849	21390474	296625
EUR_153	20000	EUR	309	22447027	22468823	21796
EUR_153	20000	EUR	309	23752602	23877108	124506
EUR_153	20000	EUR	309	24892444	24906091	13647
EUR_153	20000	EUR	309	26375604	26420785	45181
EUR_153	20000	EUR	309	27746608	27894364	147756
EUR_153	20000	EUR	309	35771774	35849669	77895
EUR_153	20000	EUR	309	37705403	37817231	111828
EUR_153	20000	EUR	309	43520906	43576329	55423
EUR_153	20000	EUR	309	51948707	52007205	58498
EUR_153	20000	EUR	309	54632404	54637830	5426
EUR_153	20000	EUR	309	54799832	54904011	104179
EUR_153	20000	EUR	309	59631177	59631623	446
EUR_153	20000	EUR	309	63714218	63732455	18237
EUR_153	20000	EUR	309	68675332	68717300	41968
EUR_153	20000	EUR	309	75263541	75282527	18986
EUR_153	20000	EUR	309	75851931	75915063	63132
EUR_153	20000	EUR	309	77733985	77735979	1994
EUR_153	20000	EUR	309	83886982	83921060	34078
EUR_153	20000	EUR	309	84898186	84919115	20929
EUR_153	20000	EUR	309	87625743	87858554	232811
EUR_153	20000	EUR	309	88087834	88319207	231373
EUR_153	20000	EUR	309	91847626	91875197	27571
EUR_153	20000	EUR	309	93123848	93146996	23148
EUR_153	20000	EUR	309	93680632	93680672	40
EUR_153	20000	EUR	309	95829965	95927099	97134
EUR_153	20000	EUR	309	96303215	96332142	28927
EUR_153	20000	EUR	309	96524393	96559858	35465
EUR_154	20000	EUR	310	3890786	4134871	244085
EUR_154	20000	EUR	310	23427310	23651476	224166
EUR_154	20000	EUR	310	23721919	23797839	75920
EUR_154	20000	EUR	310	24372241	24424495	52254
EUR_154	20000	EUR	310	24516931	24581630	64699
EUR_154	20000	EUR	310	25343770	25501390	157620
EUR_154	20000	EUR	310	25817587	25894919	77332
EUR_154	20000	EUR	310	27746608	27974945	228337
EUR_154	20000	EUR	310	28111916	28138518	26602
EUR_154	20000	EUR	310	29347606	29396432	48826
EUR_154	20000	EUR	310	31113073	31116691	3618
EUR_154	20000	EUR	310	32057270	32141896	84626
EUR_154	20000	EUR	310	32667412	32870350	202938
EUR_154	20000	EUR	310	40555384	40602505	47121
EUR_154	20000	EUR	310	41319133	41360462	41329
EUR_154	20000	EUR	310	49714605	49899094	184489
EUR_154	20000	EUR	310	54210889	54362674	151785
EUR_154	20000	EUR	310	57181563	57291065	109502
EUR_154	20000	EUR	310	72961212	73172795	211583
EUR_154	20000	EUR	310	73645076	73702901	57825
EUR_154	20000	EUR	310	74055055	74094072	39017
EUR_154	20000	EUR	310	74595799	74699907	104108
EUR_154	20000	EUR	310	75592795	75602276	9481
EUR_154	20000	EUR	310	78831605	78886366	54761
EUR_154	20000	EUR	310	79831163	79933512	102349
EUR_154	20000	EUR	310	87625743	87858554	232811
EUR_154	20000	EUR	310	88087834	88254889	167055
EUR_154	20000	EUR	310	89989980	89998439	8459
EUR_154	20000	EUR	310	90426720	90558518	131798
EUR_154	20000	EUR	310	91891040	91902611	11571
EUR_154	20000	EUR	310	93553045	93713967	160922
EUR_154	20000	EUR	310	94239181	94337048	97867
EUR_154	20000	EUR	310	94348955	94544971	196016
EUR_154	20000	EUR	310	94898715	94930362	31647
EUR_154	20000	EUR	310	95817511	95880389	62878
EUR_154	20000	EUR	310	96116814	96159987	43173
EUR_154	20000	EUR	311	1853096	1854996	1900
EUR_154	20000	EUR	311	3963309	4130169	166860
EUR_154	20000	EUR	311	9413335	9449917	36582
EUR_154	20000	EUR	311	16243211	16286721	43510
EUR_154	20000	EUR	311	16582116	16608410	26294
EUR_154	20000	EUR	311	22519633	22533171	13538
EUR_154	20000	EUR	311	23165262	23245810	80548
EUR_154	20000	EUR	311	24892444	24906091	13647
EUR_154	20000	EUR	311	29306591	29478208	171617
EUR_154	20000	EUR	311	30976914	31127610	150696
EUR_154	20000	EUR	311	41161176	41182266	21090
EUR_154	20000	EUR	311	42493150	42550782	57632
EUR_154	20000	EUR	311	43363665	43453960	90295
EUR_154	20000	EUR	311	53821064	54035252	214188
EUR_154	20000	EUR	311	54686744	54714097	27353
EUR_154	20000	EUR	311	59436810	59522281	85471
EUR_154	20000	EUR	311	76910764	76913276	2512
EUR_154	20000	EUR	311	77606973	77735858	128885
EUR_154	20000	EUR	311	83533777	83550130	16353
EUR_154	20000	EUR	311	87625743	87858554	232811
EUR_154	20000	EUR	311	88087834	88254889	167055
EUR_154	20000	EUR	311	88741915	88762816	20901
EUR_154	20000	EUR	311	88986815	88988477	1662
EUR_154	20000	EUR	311	91511715	91647061	135346
EUR_154	20000	EUR	311	93981861	94002806	20945
EUR_154	20000	EUR	311	94208996	94365251	156255
EUR_154	20000	EUR	311	94898715	94930362	31647
EUR_155	20000	EUR	312	2813723	2954696	140973
EUR_155	20000	EUR	312	18677221	18844474	167253
EUR_155	20000	EUR	312	21258424	21429464	171040
EUR_155	20000	EUR	312	22519633	22533171	13538
EUR_155	20000	EUR	312	23176150	23184805	8655
EUR_155	20000	EUR	312	24531164	24581630	50466
EUR_155	20000	EUR	312	24892444	24906091	13647
EUR_155	20000	EUR	312	26886230	26972181	85951
EUR_155	20000	EUR	312	35001631	35019786	18155
EUR_155	20000	EUR	312	37705403	37817231	111828
EUR_155	20000	EUR	312	53821064	53859932	38868
EUR_155	20000	EUR	312	54567449	54612977	45528
EUR_155	20000	EUR	312	57149895	57291065	141170
EUR_155	20000	EUR	312	59665101	59762964	97863
EUR_155	20000	EUR	312	73136973	73172795	35822
EUR_155	20000	EUR	312	74019705	74094072	74367
EUR_155	20000	EUR	312	79901897	79903521	1624
EUR_155	20000	EUR	312	80852609	80890918	38309
EUR_155	20000	EUR	312	87650695	87656802	6107
EUR_155	20000	EUR	312	88269544	88319207	49663
EUR_155	20000	EUR	312	88766564	89069315	302751
EUR_155	20000	EUR	312	90769120	90852419	83299
EUR_155	20000	EUR	312	94239181	94337048	97867
EUR_155	20000	EUR	312	94348955	94544971	196016
EUR_155	20000	EUR	312	95829965	95927099	97134
EUR_155	20000	EUR	312	96229638	96336399	106761
EUR_155	20000	EUR	313	339845	411145	71300
EUR_155	20000	EUR	313	17953431	17984110	30679
EUR_155	20000	EUR	313	20981647	21202559	220912
EUR_155	20000	EUR	313	23148716	23184805	36089
EUR_155	20000	EUR	313	24621120	24666053	44933
EUR_155	20000	EUR	313	24892444	24906091	13647
EUR_155	20000	EUR	313	25817896	25839696	21800
EUR_155	20000	EUR	313	26048379	26195455	147076
EUR_155	20000	EUR	313	32057270	32141896	84626
EUR_155	20000	EUR	313	32667412	32870350	202938
EUR_155	20000	EUR	313	33126757	33151809	25052
EUR_155	20000	EUR	313	43437923	43471816	33893
EUR_155	20000	EUR	313	50053800	50097389	43589
EUR_155	20000	EUR	313	54113043	54177383	64340
EUR_155	20000	EUR	313	54899898	54904011	4113
EUR_155	20000	EUR	313	73145730	73223816	78086
EUR_155	20000	EUR	313	77636100	77751872	115772
EUR_155	20000	EUR	313	80520393	80530144	9751
EUR_155	20000	EUR	313	80863277	80899276	35999
EUR_155	20000	EUR	313	88087834	88319207	231373
EUR_155	20000	EUR	313	88527647	88551173	23526
EUR_155	20000	EUR	313	88796237	89010522	214285
EUR_156	20000	EUR	314	1945682	1959936	14254
EUR_156	20000	EUR	314	4042823	4044195	1372
EUR_156	20000	EUR	314	7287218	7349567	62349
EUR_156	20000	EUR	314	16234928	16286721	51793
EUR_156	20000	EUR	314	17333821	17397614	63793
EUR_156	20000	EUR	314	23176150	23184805	8655
EUR_156	20000	EUR	314	24892444	24906091	13647
EUR_156	20000	EUR	314	25323974	25378298	54324
EUR_156	20000	EUR	314	27746608	27793020	46412
EUR_156	20000	EUR	314	31528053	31593163	65110
EUR_156	20000	EUR	314	34136759	34182116	45357
EUR_156	20000	EUR	314	39858032	39938835	80803
EUR_156	20000	EUR	314	40572310	40602505	30195
EUR_156	20000	EUR	314	40861764	41134712	272948
EUR_156	20000	EUR	314	42369514	42472558	103044
EUR_156	20000	EUR	314	54210230	54365408	155178
EUR_156	20000	EUR	314	57136159	57253147	116988
EUR_156	20000	EUR	314	57857678	57861351	3673
EUR_156	20000	EUR	314	73645076	73702901	57825
EUR_156	20000	EUR	314	74055055	74094072	39017
EUR_156	20000	EUR	314	75110846	75189189	78343
EUR_156	20000	EUR	314	77879347	77881732	2385
EUR_156	20000	EUR	314	84755692	84842960	87268
EUR_156	20000	EUR	314	88087834	88319207	231373
EUR_156	20000	EUR	314	94263579	94317758	54179
EUR_156	20000	EUR	314	96136238	96175807	39569
EUR_156	20000	EUR	314	96854339	97008044	153705
EUR_156	20000	EUR	315	3794084	3982289	188205
EUR_156	20000	EUR	315	8651970	8714283	62313
EUR_156	20000	EUR	315	21350121	21367194	17073
EUR_156	20000	EUR	315	23648833	23651476	2643
EUR_156	20000	EUR	315	24372241	24384508	12267
EUR_156	20000	EUR	315	25140534	25157132	16598
EUR_156	20000	EUR	315	26180848	26195455	14607
EUR_156	20000	EUR	315	26319359	26343601	24242
EUR_156	20000	EUR	315	26886230	26991485	105255
EUR_156	20000	EUR	315	36846999	36869887	22888
EUR_156	20000	EUR	315	37727611	37735395	7784
EUR_156	20000	EUR	315	39957500	40021036	63536
EUR_156	20000	EUR	315	40410992	40602505	191513
EUR_156	20000	EUR	315	49714605	49899094	184489
EUR_156	20000	EUR	315	59617240	59714920	97680
EUR_156	20000	EUR	315	68624378	68673073	48695
EUR_156	20000	EUR	315	71700744	71764001	63257
EUR_156	20000	EUR	315	72961212	73172795	211583
EUR_156	20000	EUR	315	73645076	73702901	57825
EUR_156	20000	EUR	315	74055055	74094072	39017
EUR_156	20000	EUR	315	84755692	84919115	163423
EUR_156	20000	EUR	315	87382730	87435149	52419
EUR_156	20000	EUR	315	87727929	87874122	146193
EUR_156	20000	EUR	315	88338208	88646288	308080
EUR_156	20000	EUR	315	93585543	93713967	128424
EUR_156	20000	EUR	315	96136238	96137817	1579
EUR_156	20000	EUR	315	99165891	99213383	47492
EUR_157	20000	EUR	316	2415974	2702115	286141
EUR_157	20000	EUR	316	8749037	8780869	31832
EUR_157	20000	EUR	316	11532006	11542173	10167
EUR_157	20000	EUR	316	13429221	13471276	42055
EUR_157	20000	EUR	316	24749954	24757234	7280
EUR_157	20000	EUR	316	26849817	26883308	33491
EUR_157	20000	EUR	316	29306591	29365834	59243
EUR_157	20000	EUR	316	31528053	31575105	47052
EUR_157	20000	EUR	316	32824940	32828620	3680
EUR_157	20000	EUR	316	32858056	32870350	12294
EUR_157	20000	EUR	316	36339512	36357016	17504
EUR_157	20000	EUR	316	40047500	40068128	20628
EUR_157	20000	EUR	316	41161176	41182266	21090
EUR_157	20000	EUR	316	53875418	53951058	75640
EUR_157	20000	EUR	316	54210889	54261453	50564
EUR_157	20000	EUR	316	59674842	59700527	25685
EUR_157	20000	EUR	316	69023918	69051154	27236
EUR_157	20000	EUR	316	73136973	73172795	35822
EUR_157	20000	EUR	316	74019705	74094072	74367
EUR_157	20000	EUR	316	88761110	88877947	116837
EUR_157	20000	EUR	316	93308720	93312065	3345
EUR_157	20000	EUR	316	94034997	94105458	70461
EUR_157	20000	EUR	316	94239181	94313443	74262
EUR_157	20000	EUR	317	12764351	12907211	142860
EUR_157	20000	EUR	317	13970992	14057978	86986
EUR_157	20000	EUR	317	22447027	22457574	10547
EUR_157	20000	EUR	317	22890136	22948351	58215
EUR_157	20000	EUR	317	25336091	25347092	11001
EUR_157	20000	EUR	317	26819249	26911224	91975
EUR_157	20000	EUR	317	28599684	28692721	93037
EUR_157	20000	EUR	317	29306591	29396432	89841
EUR_157	20000	EUR	317	31113073	31133912	20839
EUR_157	20000	EUR	317	31446501	31539412	92911
EUR_157	20000	EUR	317	32262916	32267787	4871
EUR_157	20000	EUR	317	32730368	32759145	28777
EUR_157	20000	EUR	317	37805274	37815963	10689
EUR_157	20000	EUR	317	40410992	40602505	191513
EUR_157	20000	EUR	317	42473584	42574352	100768
EUR_157	20000	EUR	317	53821064	53872495	51431
EUR_157	20000	EUR	317	54113043	54177383	64340
EUR_157	20000	EUR	317	59674842	59700527	25685
EUR_157	20000	EUR	317	63714218	63732455	18237
EUR_157	20000	EUR	317	68675332	68717300	41968
EUR_157	20000	EUR	317	75089161	75095784	6623
EUR_157	20000	EUR	317	75851931	75915063	63132
EUR_157	20000	EUR	317	78832752	78908217	75465
EUR_157	20000	EUR	317	84235412	84254246	18834
EUR_157	20000	EUR	317	87075746	87120548	44802
EUR_157	20000	EUR	317	87175208	87455574	280366
EUR_157	20000	EUR	317	88043168	88085432	42264
EUR_157	20000	EUR	317	88087834	88153791	65957
EUR_157	20000	EUR	317	92065436	92171686	106250
EUR_157	20000	EUR	317	93553045	93685892	132847
EUR_157	20000	EUR	317	95270807	95445533	174726
EUR_158	20000	EUR	318	13429221	13730499	301278
EUR_158	20000	EUR	318	16243211	16402432	159221
EUR_158	20000	EUR	318	17879034	18041675	162641
EUR_158	20000	EUR	318	18091263	18107085	15822
EUR_158	20000	EUR	318	24088240	24133961	45721
EUR_158	20000	EUR	318	24456376	24581630	125254
EUR_158	20000	EUR	318	25950286	25987107	36821
EUR_158	20000	EUR	318	28645700	28663032	17332
EUR_158	20000	EUR	318	29306591	29478208	171617
EUR_158	20000	EUR	318	31087987	31138800	50813
EUR_158	20000	EUR	318	32057270	32141896	84626
EUR_158	20000	EUR	318	32667412	32696052	28640
EUR_158	20000	EUR	318	37754246	38097333	343087
EUR_158	20000	EUR	318	75587305	75641163	53858
EUR_158	20000	EUR	318	76870150	76972698	102548
EUR_158	20000	EUR	318	88175028	88280712	105684
EUR_158	20000	EUR	318	88460364	88598966	138602
EUR_158	20000	EUR	318	89084957	89124034	39077
EUR_158	20000	EUR	318	90062084	90243516	181432
EUR_158	20000	EUR	318	91904367	91921002	16635
EUR_158	20000	EUR	318	93957733	94010234	52501
EUR_158	20000	EUR	318	94447447	94522438	74991
EUR_158	20000	EUR	318	95270807	95382886	112079
EUR_158	20000	EUR	318	96116814	96220219	103405
EUR_158	20000	EUR	318	99165891	99280798	114907
EUR_158	20000	EUR	319	3763591	3801794	38203
EUR_158	20000	EUR	319	13574314	13635433	61119
EUR_158	20000	EUR	319	13640984	13678187	37203
EUR_158	20000	EUR	319	21194944	21271328	76384
EUR_158	20000	EUR	319	22992959	23099324	106365
EUR_158	20000	EUR	319	23156936	23184805	27869
EUR_158	20000	EUR	319	25264173	25276538	12365
EUR_158	20000	EUR	319	26319359	26436121	116762
EUR_158	20000	EUR	319	29291099	29311528	20429
EUR_158	20000	EUR	319	33271998	33295884	23886
EUR_158	20000	EUR	319	34136759	34182116	45357
EUR_158	20000	EUR	319	53821064	54076786	255722
EUR_158	20000	EUR	319	54712516	54904011	191495
EUR_158	20000	EUR	319	63714218	63803837	89619
EUR_158	20000	EUR	319	69023918	69060887	36969
EUR_158	20000	EUR	319	73136973	73172795	35822
EUR_158	20000	EUR	319	73498527	73536154	37627
EUR_158	20000	EUR	319	75263541	75282527	18986
EUR_158	20000	EUR	319	76139818	76143984	4166
EUR_158	20000	EUR	319	77606973	77624905	17932
EUR_158	20000	EUR	319	80973372	81229503	256131
EUR_158	20000	EUR	319	83886982	83921060	34078
EUR_158	20000	EUR	319	86810612	86824341	13729
EUR_158	20000	EUR	319	87504329	87507341	3012
EUR_158	20000	EUR	319	88219640	88382260	162620
EUR_158	20000	EUR	319	88796237	89010522	214285
EUR_158	20000	EUR	319	93123848	93146996	23148
EUR_158	20000	EUR	319	94793518	94818871	25353
EUR_159	20000	EUR	320	5253381	5312534	59153
EUR_159	20000	EUR	320	8348919	8386102	37183
EUR_159	20000	EUR	320	21164327	21282925	118598
EUR_159	20000	EUR	320	22992959	23099324	106365
EUR_159	20000	EUR	320	23156936	23184805	27869
EUR_159	20000	EUR	320	23771474	23877108	105634
EUR_159	20000	EUR	320	26319359	26436121	116762
EUR_159	20000	EUR	320	26886230	26991485	105255
EUR_159	20000	EUR	320	27746608	27795190	48582
EUR_159	20000	EUR	320	31164146	31314394	150248
EUR_159	20000	EUR	320	31478668	31502542	23874
EUR_159	20000	EUR	320	31671896	31719587	47691
EUR_159	20000	EUR	320	37727611	37861599	133988
EUR_159	20000	EUR	320	39652652	39692065	39413
EUR_159	20000	EUR	320	39907281	40008876	101595
EUR_159	20000	EUR	320	40410992	40602505	191513
EUR_159	20000	EUR	320	41359664	41360462	798
EUR_159	20000	EUR	320	54210230	54365408	155178
EUR_159	20000	EUR	320	63714218	63784151	69933
EUR_159	20000	EUR	320	72961212	73079345	118133
EUR_159	20000	EUR	320	74410856	74438736	27880
EUR_159	20000	EUR	320	76022322	76143984	121662
EUR_159	20000	EUR	320	77051968	77082685	30717
EUR_159	20000	EUR	320	77751346	77830955	79609
EUR_159	20000	EUR	320	79087333	79134588	47255
EUR_159	20000	EUR	320	79860282	79933512	73230
EUR_159	20000	EUR	320	83886982	83957574	70592
EUR_159	20000	EUR	320	85579439	85666862	87423
EUR_159	20000	EUR	320	87512858	87622177	109319
EUR_159	20000	EUR	320	87944722	88033483	88761
EUR_159	20000	EUR	320	88221167	88259136	37969
EUR_159	20000	EUR	320	88797692	89081743	284051
EUR_159	20000	EUR	320	89180086	89235318	55232
EUR_159	20000	EUR	320	89997508	90008065	10557
EUR_159	20000	EUR	320	93943380	94056780	113400
EUR_159	20000	EUR	320	94297447	94418018	120571
EUR_159	20000	EUR	320	94419260	94544971	125711
EUR_159	20000	EUR	320	95829965	95927099	97134
EUR_159	20000	EUR	320	96254221	96258363	4142
EUR_159	20000	EUR	320	99165891	99280798	114907
EUR_159	20000	EUR	321	2813723	3065958	252235
EUR_159	20000	EUR	321	7287218	7349567	62349
EUR_159	20000	EUR	321	17333821	17360068	26247
EUR_159	20000	EUR	321	18310807	18368143	57336
EUR_159	20000	EUR	321	21093849	21390474	296625
EUR_159	20000	EUR	321	23499612	23554604	54992
EUR_159	20000	EUR	321	24076703	24094707	18004
EUR_159	20000	EUR	321	25325282	25351680	26398
EUR_159	20000	EUR	321	30976914	31054287	77373
EUR_159	20000	EUR	321	36542977	36847359	304382
EUR_159	20000	EUR	321	40974541	41037792	63251
EUR_159	20000	EUR	321	52168283	52224193	55910
EUR_159	20000	EUR	321	59693122	59762964	69842
EUR_159	20000	EUR	321	64338347	64449680	111333
EUR_159	20000	EUR	321	68624378	68632783	8405
EUR_159	20000	EUR	321	75089161	75095784	6623
EUR_159	20000	EUR	321	76798443	77082685	284242
EUR_159	20000	EUR	321	84863773	84919115	55342
EUR_159	20000	EUR	321	88087834	88173414	85580
EUR_159	20000	EUR	321	88480384	88583737	103353
EUR_159	20000	EUR	321	88804587	88891848	87261
EUR_159	20000	EUR	321	89011064	89081586	70522
EUR_159	20000	EUR	321	89188899	89227874	38975
EUR_159	20000	EUR	321	90138632	90357107	218475
EUR_160	20000	EUR	322	2984450	2997995	13545
EUR_160	20000	EUR	322	4020191	4044195	24004
EUR_160	20000	EUR	322	12968700	13067431	98731
EUR_160	20000	EUR	322	13574314	13635433	61119
EUR_160	20000	EUR	322	13640984	13678187	37203
EUR_160	20000	EUR	322	16243211	16257692	14481
EUR_160	20000	EUR	322	17333821	17397614	63793
EUR_160	20000	EUR	322	20981647	21202559	220912
EUR_160	20000	EUR	322	24372241	24581630	209389
EUR_160	20000	EUR	322	25817587	25840674	23087
EUR_160	20000	EUR	322	25971191	25987107	15916
EUR_160	20000	EUR	322	29321833	29396318	74485
EUR_160	20000	EUR	322	32824940	32871485	46545
EUR_160	20000	EUR	322	33126757	33166924	40167
EUR_160	20000	EUR	322	34999082	35095643	96561
EUR_160	20000	EUR	322	40410992	40602505	191513
EUR_160	20000	EUR	322	40973349	40979135	5786
EUR_160	20000	EUR	322	53826246	53994973	168727
EUR_160	20000	EUR	322	54403505	54904011	500506
EUR_160	20000	EUR	322	56378802	56480618	101816
EUR_160	20000	EUR	322	57149895	57291065	141170
EUR_160	20000	EUR	322	69048774	69068474	19700
EUR_160	20000	EUR	322	71544591	71563119	18528
EUR_160	20000	EUR	322	76567582	76594146	26564
EUR_160	20000	EUR	322	79901897	79936163	34266
EUR_160	20000	EUR	322	87829130	87903841	74711
EUR_160	20000	EUR	322	88751576	88762816	11240
EUR_160	20000	EUR	322	94243595	94317758	74163
EUR_160	20000	EUR	322	94885812	94898377	12565
EUR_160	20000	EUR	322	94898715	94930362	31647
EUR_160	20000	EUR	322	95774147	95778109	3962
EUR_160	20000	EUR	322	96136238	96175807	39569
EUR_160	20000	EUR	323	16582116	16622814	40698
EUR_160	20000	EUR	323	22447027	22533171	86144
EUR_160	20000	EUR	323	23177139	23184805	7666
EUR_160	20000	EUR	323	23721919	23797839	75920
EUR_160	20000	EUR	323	24380643	24581630	200987
EUR_160	20000	EUR	323	24892444	24906091	13647
EUR_160	20000	EUR	323	30984604	31034898	50294
EUR_160	20000	EUR	323	31113073	31133912	20839
EUR_160	20000	EUR	323	32730368	32759145	28777
EUR_160	20000	EUR	323	33129736	33221037	91301
EUR_160	20000	EUR	323	42613880	42659849	45969
EUR_160	20000	EUR	323	49795900	49864433	68533
EUR_160	20000	EUR	323	58863206	58863428	222
EUR_160	20000	EUR	323	59718356	59745811	27455
EUR_160	20000	EUR	323	73593016	73702901	109885
EUR_160	20000	EUR	323	74088728	74094072	5344
EUR_160	20000	EUR	323	76139818	76143984	4166
EUR_160	20000	EUR	323	80161288	80269440	108152
EUR_160	20000	EUR	323	84235412	84254246	18834
EUR_160	20000	EUR	323	84755692	84919115	163423
EUR_160	20000	EUR	323	87512858	87570978	58120
EUR_160	20000	EUR	323	88281615	88382260	100645
EUR_160	20000	EUR	323	89126730	89235318	108588
EUR_160	20000	EUR	323	89396010	89508341	112331
EUR_160	20000	EUR	323	91541076	91672576	131500
EUR_160	20000	EUR	323	93331071	93411339	80268
EUR_160	20000	EUR	323	93943380	94056780	113400
EUR_160	20000	EUR	323	94297447	94418018	120571
EUR_160	20000	EUR	323	94419260	94544971	125711
EUR_160	20000	EUR	323	95774147	95792644	18497
EUR_161	20000	EUR	324	4458174	4517103	58929
EUR_161	20000	EUR	324	5018475	5034623	16148
EUR_161	20000	EUR	324	8348919	8386102	37183
EUR_161	20000	EUR	324	9413335	9449917	36582
EUR_161	20000	EUR	324	10399704	10402156	2452
EUR_161	20000	EUR	324	11480169	11492904	12735
EUR_161	20000	EUR	324	12764351	12785371	21020
EUR_161	20000	EUR	324	16234928	16286721	51793
EUR_161	20000	EUR	324	17753822	17984110	230288
EUR_161	20000	EUR	324	22918884	23024336	105452
EUR_161	20000	EUR	324	23176150	23184805	8655
EUR_161	20000	EUR	324	29273800	29311528	37728
EUR_161	20000	EUR	324	30804231	31151086	346855
EUR_161	20000	EUR	324	32855612	32870350	14738
EUR_161	20000	EUR	324	34136759	34182116	45357
EUR_161	20000	EUR	324	37809118	37815963	6845
EUR_161	20000	EUR	324	40047500	40068128	20628
EUR_161	20000	EUR	324	54210889	54362674	151785
EUR_161	20000	EUR	324	59650996	59762964	111968
EUR_161	20000	EUR	324	73161968	73172795	10827
EUR_161	20000	EUR	324	76436374	76457500	21126
EUR_161	20000	EUR	324	76567582	76594146	26564
EUR_161	20000	EUR	324	76798443	76814774	16331
EUR_161	20000	EUR	324	81111648	81190655	79007
EUR_161	20000	EUR	324	84755692	84919115	163423
EUR_161	20000	EUR	324	90660950	90852419	191469
EUR_161	20000	EUR	324	91093062	91107582	14520
EUR_161	20000	EUR	324	92839624	92866729	27105
EUR_161	20000	EUR	324	93553045	93713967	160922
EUR_161	20000	EUR	324	94132438	94351179	218741
EUR_161	20000	EUR	325	1927314	1946512	19198
EUR_161	20000	EUR	325	2519034	2648737	129703
EUR_161	20000	EUR	325	8749037	8780869	31832
EUR_161	20000	EUR	325	11532006	11542173	10167
EUR_161	20000	EUR	325	16243211	16399613	156402
EUR_161	20000	EUR	325	18622886	18806641	183755
EUR_161	20000	EUR	325	21153525	21204967	51442
EUR_161	20000	EUR	325	22279659	22313169	33510
EUR_161	20000	EUR	325	25614636	25639784	25148
EUR_161	20000	EUR	325	26477051	26533611	56560
EUR_161	20000	EUR	325	27746608	27894364	147756
EUR_161	20000	EUR	325	34174020	34182116	8096
EUR_161	20000	EUR	325	35084593	35087281	2688
EUR_161	20000	EUR	325	37705403	37817231	111828
EUR_161	20000	EUR	325	40572310	40602505	30195
EUR_161	20000	EUR	325	40861764	41134712	272948
EUR_161	20000	EUR	325	42399388	42550782	151394
EUR_161	20000	EUR	325	43359651	43453960	94309
EUR_161	20000	EUR	325	54567449	54611831	44382
EUR_161	20000	EUR	325	56378802	56448072	69270
EUR_161	20000	EUR	325	56460233	56480618	20385
EUR_161	20000	EUR	325	59650996	59762964	111968
EUR_161	20000	EUR	325	69827718	69827861	143
EUR_161	20000	EUR	325	73488506	73560480	71974
EUR_161	20000	EUR	325	76137655	76143984	6329
EUR_161	20000	EUR	325	78831605	78886366	54761
EUR_161	20000	EUR	325	79086226	79134588	48362
EUR_161	20000	EUR	325	83886982	83921060	34078
EUR_161	20000	EUR	325	84898186	84919115	20929
EUR_161	20000	EUR	325	87653008	87713350	60342
EUR_161	20000	EUR	325	88093541	88161538	67997
EUR_161	20000	EUR	325	88761110	88877947	116837
EUR_161	20000	EUR	325	89989980	89998439	8459
EUR_161	20000	EUR	325	90392670	90558518	165848
EUR_161	20000	EUR	325	93318121	93371609	53488
EUR_161	20000	EUR	325	94523809	94559172	35363
EUR_162	20000	EUR	326	13429221	13752117	322896
EUR_162	20000	EUR	326	15890559	16047641	157082
EUR_162	20000	EUR	326	16234928	16286721	51793
EUR_162	20000	EUR	326	18100331	18140078	39747
EUR_162	20000	EUR	326	21195166	21282925	87759
EUR_162	20000	EUR	326	23165262	23244178	78916
EUR_162	20000	EUR	326	23276233	23442163	165930
EUR_162	20000	EUR	326	23551910	23554604	2694
EUR_162	20000	EUR	326	24101175	24155650	54475
EUR_162	20000	EUR	326	24892444	24906091	13647
EUR_162	20000	EUR	326	25264173	25276538	12365
EUR_162	20000	EUR	326	30976914	31127610	150696
EUR_162	20000	EUR	326	32694491	32709855	15364
EUR_162	20000	EUR	326	32830516	32871485	40969
EUR_162	20000	EUR	326	34136759	34182116	45357
EUR_162	20000	EUR	326	37705403	37817231	111828
EUR_162	20000	EUR	326	49714809	49899094	184285
EUR_162	20000	EUR	326	52168283	52224193	55910
EUR_162	20000	EUR	326	54403505	54802095	398590
EUR_162	20000	EUR	326	57188385	57262845	74460
EUR_162	20000	EUR	326	64338347	64519080	180733
EUR_162	20000	EUR	326	68624378	68632783	8405
EUR_162	20000	EUR	326	72226457	72229994	3537
EUR_162	20000	EUR	326	72961212	73040765	79553
EUR_162	20000	EUR	326	73136973	73172795	35822
EUR_162	20000	EUR	326	78754228	78823038	68810
EUR_162	20000	EUR	326	88087834	88319207	231373
EUR_162	20000	EUR	326	88810221	88988477	178256
EUR_162	20000	EUR	326	90195857	90532466	336609
EUR_162	20000	EUR	326	93190964	93277691	86727
EUR_162	20000	EUR	326	95270807	95445533	174726
EUR_162	20000	EUR	326	95774147	95817637	43490
EUR_162	20000	EUR	327	3890786	4134871	244085
EUR_162	20000	EUR	327	13574314	13635433	61119
EUR_162	20000	EUR	327	13640984	13678187	37203
EUR_162	20000	EUR	327	17889447	17902017	12570
EUR_162	20000	EUR	327	21207998	21282925	74927
EUR_162	20000	EUR	327	22992959	23099324	106365
EUR_162	20000	EUR	327	23156936	23184805	27869
EUR_162	20000	EUR	327	23432743	23554604	121861
EUR_162	20000	EUR	327	24101175	24155650	54475
EUR_162	20000	EUR	327	24892444	24906091	13647
EUR_162	20000	EUR	327	25323974	25377647	53673
EUR_162	20000	EUR	327	30917279	31034898	117619
EUR_162	20000	EUR	327	31113073	31133912	20839
EUR_162	20000	EUR	327	37705403	38097333	391930
EUR_162	20000	EUR	327	39957500	39960153	2653
EUR_162	20000	EUR	327	40973349	40979135	5786
EUR_162	20000	EUR	327	49849508	49881449	31941
EUR_162	20000	EUR	327	53821064	53996323	175259
EUR_162	20000	EUR	327	54567449	54612977	45528
EUR_162	20000	EUR	327	58580135	58694180	114045
EUR_162	20000	EUR	327	73136973	73172795	35822
EUR_162	20000	EUR	327	73498527	73648028	149501
EUR_162	20000	EUR	327	76759679	76869710	110031
EUR_162	20000	EUR	327	76921572	77067204	145632
EUR_162	20000	EUR	327	77800262	77885640	85378
EUR_162	20000	EUR	327	80179758	80278256	98498
EUR_162	20000	EUR	327	84755692	84790641	34949
EUR_162	20000	EUR	327	86508335	86539843	31508
EUR_162	20000	EUR	327	88025602	88093768	68166
EUR_162	20000	EUR	327	88986474	89010522	24048
EUR_162	20000	EUR	327	90058636	90243516	184880
EUR_162	20000	EUR	327	91847626	91875197	27571
EUR_162	20000	EUR	327	92847341	92913320	65979
EUR_162	20000	EUR	327	93318121	93371609	53488
EUR_162	20000	EUR	327	95270807	95445533	174726
EUR_162	20000	EUR	327	95774147	95834476	60329
EUR_163	20000	EUR	328	2984450	2997995	13545
EUR_163	20000	EUR	328	4013828	4126878	113050
EUR_163	20000	EUR	328	9181565	9308590	127025
EUR_163	20000	EUR	328	18100331	18140078	39747
EUR_163	20000	EUR	328	21195166	21282925	87759
EUR_163	20000	EUR	328	23120612	23184805	64193
EUR_163	20000	EUR	328	25867195	25987107	119912
EUR_163	20000	EUR	328	26069214	26169692	100478
EUR_163	20000	EUR	328	28111916	28139866	27950
EUR_163	20000	EUR	328	30904434	30925177	20743
EUR_163	20000	EUR	328	33271998	33295884	23886
EUR_163	20000	EUR	328	33326865	33429152	102287
EUR_163	20000	EUR	328	35640621	35825375	184754
EUR_163	20000	EUR	328	36660352	36714961	54609
EUR_163	20000	EUR	328	41161176	41182266	21090
EUR_163	20000	EUR	328	42493150	42550782	57632
EUR_163	20000	EUR	328	49849508	49881449	31941
EUR_163	20000	EUR	328	73488506	73702901	214395
EUR_163	20000	EUR	328	74019705	74094072	74367
EUR_163	20000	EUR	328	75263541	75263695	154
EUR_163	20000	EUR	328	76022322	76143984	121662
EUR_163	20000	EUR	328	80863277	80899276	35999
EUR_163	20000	EUR	328	86508335	86539843	31508
EUR_163	20000	EUR	328	87580327	87628134	47807
EUR_163	20000	EUR	328	88087834	88319207	231373
EUR_163	20000	EUR	328	90141069	90164943	23874
EUR_163	20000	EUR	328	93680632	93680672	40
EUR_163	20000	EUR	328	93685203	93713967	28764
EUR_163	20000	EUR	328	94196868	94317758	120890
EUR_163	20000	EUR	328	96150043	96217388	67345
EUR_163	20000	EUR	328	96506025	97008044	502019
EUR_163	20000	EUR	328	99192246	99280798	88552
EUR_163	20000	EUR	329	1945682	1964815	19133
EUR_163	20000	EUR	329	5018475	5041230	22755
EUR_163	20000	EUR	329	7572302	7793592	221290
EUR_163	20000	EUR	329	13889315	13904227	14912
EUR_163	20000	EUR	329	24372241	24581630	209389
EUR_163	20000	EUR	329	25817896	25839223	21327
EUR_163	20000	EUR	329	29273800	29279379	5579
EUR_163	20000	EUR	329	31113073	31116691	3618
EUR_163	20000	EUR	329	32694491	32709855	15364
EUR_163	20000	EUR	329	40861764	41024466	162702
EUR_163	20000	EUR	329	54113043	54177383	64340
EUR_163	20000	EUR	329	59680988	59700527	19539
EUR_163	20000	EUR	329	71544591	71563119	18528
EUR_163	20000	EUR	329	73488506	73574713	86207
EUR_163	20000	EUR	329	79824188	79933512	109324
EUR_163	20000	EUR	329	80954431	81229503	275072
EUR_163	20000	EUR	329	87512858	87623148	110290
EUR_163	20000	EUR	329	90103571	90243516	139945
EUR_163	20000	EUR	329	94239181	94337048	97867
EUR_163	20000	EUR	329	94348955	94544971	196016
EUR_163	20000	EUR	329	95774147	95834476	60329
EUR_163	20000	EUR	329	96264202	96346551	82349
EUR_164	20000	EUR	330	1762556	1830270	67714
EUR_164	20000	EUR	330	3763591	3801794	38203
EUR_164	20000	EUR	330	3890786	4115507	224721
EUR_164	20000	EUR	330	9413335	9449917	36582
EUR_164	20000	EUR	330	17889447	18016499	127052
EUR_164	20000	EUR	330	23371214	23387858	16644
EUR_164	20000	EUR	330	24045382	24155650	110268
EUR_164	20000	EUR	330	24621120	24737906	116786
EUR_164	20000	EUR	330	25183341	25305885	122544
EUR_164	20000	EUR	330	25323974	25374012	50038
EUR_164	20000	EUR	330	25777449	25777999	550
EUR_164	20000	EUR	330	25867195	25873969	6774
EUR_164	20000	EUR	330	27933038	27974945	41907
EUR_164	20000	EUR	330	29291099	29311528	20429
EUR_164	20000	EUR	330	32855612	32870350	14738
EUR_164	20000	EUR	330	33007991	33062946	54955
EUR_164	20000	EUR	330	37727611	37798680	71069
EUR_164	20000	EUR	330	50053800	50097389	43589
EUR_164	20000	EUR	330	53821064	53887824	66760
EUR_164	20000	EUR	330	54403505	54753618	350113
EUR_164	20000	EUR	330	59436810	59522281	85471
EUR_164	20000	EUR	330	73519049	73675439	156390
EUR_164	20000	EUR	330	75089161	75095784	6623
EUR_164	20000	EUR	330	76798443	76840727	42284
EUR_164	20000	EUR	330	79901897	79936163	34266
EUR_164	20000	EUR	330	80161288	80278256	116968
EUR_164	20000	EUR	330	84898186	84919115	20929
EUR_164	20000	EUR	330	88087834	88679238	591404
EUR_164	20000	EUR	330	88761110	89052379	291269
EUR_164	20000	EUR	330	89180086	89235318	55232
EUR_164	20000	EUR	330	90153261	90243516	90255
EUR_164	20000	EUR	330	94290726	94412962	122236
EUR_164	20000	EUR	330	94535576	94544971	9395
EUR_164	20000	EUR	330	94805865	94819760	13895
EUR_164	20000	EUR	330	95323015	95353984	30969
EUR_164	20000	EUR	330	95774147	95778109	3962
EUR_164	20000	EUR	330	96116814	96337375	220561
EUR_164	20000	EUR	331	11703759	11814111	110352
EUR_164	20000	EUR	331	21258424	21429464	171040
EUR_164	20000	EUR	331	22519633	22533171	13538
EUR_164	20000	EUR	331	22579230	22598483	19253
EUR_164	20000	EUR	331	23176150	23184805	8655
EUR_164	20000	EUR	331	24045382	24155650	110268
EUR_164	20000	EUR	331	24579932	24581630	1698
EUR_164	20000	EUR	331	25142500	25215904	73404
EUR_164	20000	EUR	331	25554348	25609073	54725
EUR_164	20000	EUR	331	27796339	27974945	178606
EUR_164	20000	EUR	331	28111916	28139866	27950
EUR_164	20000	EUR	331	29347606	29396432	48826
EUR_164	20000	EUR	331	30872888	30886133	13245
EUR_164	20000	EUR	331	32057270	32141896	84626
EUR_164	20000	EUR	331	42493150	42550782	57632
EUR_164	20000	EUR	331	49714605	50246703	532098
EUR_164	20000	EUR	331	53821064	53971876	150812
EUR_164	20000	EUR	331	54714203	54904011	189808
EUR_164	20000	EUR	331	56378802	56386732	7930
EUR_164	20000	EUR	331	57149895	57291065	141170
EUR_164	20000	EUR	331	59674842	59700527	25685
EUR_164	20000	EUR	331	64803473	64922329	118856
EUR_164	20000	EUR	331	73745706	73906350	160644
EUR_164	20000	EUR	331	77800262	77885640	85378
EUR_164	20000	EUR	331	79901897	79936163	34266
EUR_164	20000	EUR	331	80161288	80278256	116968
EUR_164	20000	EUR	331	87625743	87858554	232811
EUR_164	20000	EUR	331	88087834	88254889	167055
EUR_164	20000	EUR	331	90627118	90718047	90929
EUR_164	20000	EUR	331	93470832	93647010	176178
EUR_165	20000	EUR	332	1762556	1830270	67714
EUR_165	20000	EUR	332	2942516	3053070	110554
EUR_165	20000	EUR	332	24621120	24737906	116786
EUR_165	20000	EUR	332	24809049	24847656	38607
EUR_165	20000	EUR	332	25140534	25305885	165351
EUR_165	20000	EUR	332	26362504	26436121	73617
EUR_165	20000	EUR	332	27746608	27749622	3014
EUR_165	20000	EUR	332	29347606	29396432	48826
EUR_165	20000	EUR	332	30984604	31034898	50294
EUR_165	20000	EUR	332	31113073	31133912	20839
EUR_165	20000	EUR	332	32431231	32446630	15399
EUR_165	20000	EUR	332	32824940	32871485	46545
EUR_165	20000	EUR	332	33126706	33180725	54019
EUR_165	20000	EUR	332	34124908	34182116	57208
EUR_165	20000	EUR	332	36822445	36864514	42069
EUR_165	20000	EUR	332	39858032	39938835	80803
EUR_165	20000	EUR	332	40410992	40484323	73331
EUR_165	20000	EUR	332	40572310	40602505	30195
EUR_165	20000	EUR	332	40861764	41134712	272948
EUR_165	20000	EUR	332	42551043	42574352	23309
EUR_165	20000	EUR	332	42752327	42823699	71372
EUR_165	20000	EUR	332	53821064	53887824	66760
EUR_165	20000	EUR	332	54403505	54753618	350113
EUR_165	20000	EUR	332	59674842	59700527	25685
EUR_165	20000	EUR	332	68624378	68632783	8405
EUR_165	20000	EUR	332	72160732	72205102	44370
EUR_165	20000	EUR	332	74410856	74438736	27880
EUR_165	20000	EUR	332	86508335	86539843	31508
EUR_165	20000	EUR	332	87969149	87994899	25750
EUR_165	20000	EUR	332	88077880	88113143	35263
EUR_165	20000	EUR	332	88405406	88464514	59108
EUR_165	20000	EUR	332	88476761	88537179	60418
EUR_165	20000	EUR	332	89180086	89235318	55232
EUR_165	20000	EUR	332	90426720	90558518	131798
EUR_165	20000	EUR	332	91093062	91107582	14520
EUR_165	20000	EUR	332	91847626	91875197	27571
EUR_165	20000	EUR	332	92847341	92913320	65979
EUR_165	20000	EUR	332	93318121	93371609	53488
EUR_165	20000	EUR	332	94126349	94222927	96578
EUR_165	20000	EUR	332	94447447	94522438	74991
EUR_165	20000	EUR	332	94915497	94930362	14865
EUR_165	20000	EUR	332	96873752	96980903	107151
EUR_165	20000	EUR	333	8348919	8534683	185764
EUR_165	20000	EUR	333	8676684	8714283	37599
EUR_165	20000	EUR	333	17749730	17919616	169886
EUR_165	20000	EUR	333	21150173	21156082	5909
EUR_165	20000	EUR	333	21200799	21216283	15484
EUR_165	20000	EUR	333	21228885	21282925	54040
EUR_165	20000	EUR	333	22898004	22916617	18613
EUR_165	20000	EUR	333	24076703	24094707	18004
EUR_165	20000	EUR	333	24892444	24906091	13647
EUR_165	20000	EUR	333	26375604	26436121	60517
EUR_165	20000	EUR	333	26849817	26889089	39272
EUR_165	20000	EUR	333	28111916	28139866	27950
EUR_165	20000	EUR	333	29306591	29478208	171617
EUR_165	20000	EUR	333	37705403	37817231	111828
EUR_165	20000	EUR	333	39639062	39696725	57663
EUR_165	20000	EUR	333	39821749	40145306	323557
EUR_165	20000	EUR	333	40410992	40602505	191513
EUR_165	20000	EUR	333	42493150	42574352	81202
EUR_165	20000	EUR	333	50093106	50097389	4283
EUR_165	20000	EUR	333	54799832	54904011	104179
EUR_165	20000	EUR	333	57136159	57145192	9033
EUR_165	20000	EUR	333	59554189	59607931	53742
EUR_165	20000	EUR	333	64321831	64519080	197249
EUR_165	20000	EUR	333	74410856	74438736	27880
EUR_165	20000	EUR	333	77879347	77881732	2385
EUR_165	20000	EUR	333	79901897	79936163	34266
EUR_165	20000	EUR	333	80161288	80278256	116968
EUR_165	20000	EUR	333	85650812	85653228	2416
EUR_165	20000	EUR	333	87580327	87628134	47807
EUR_165	20000	EUR	333	88087834	88138845	51011
EUR_165	20000	EUR	333	88224553	88341164	116611
EUR_165	20000	EUR	333	88496413	88877558	381145
EUR_165	20000	EUR	333	89067780	89099823	32043
EUR_165	20000	EUR	333	92081595	92314179	232584
EUR_165	20000	EUR	333	93158329	93258686	100357
EUR_165	20000	EUR	333	93277783	93322262	44479
EUR_165	20000	EUR	333	94299354	94418018	118664
EUR_165	20000	EUR	333	94419260	94544971	125711
EUR_165	20000	EUR	333	95270807	95445533	174726
EUR_165	20000	EUR	333	96136238	96175807	39569
EUR_166	20000	EUR	334	3890786	4134871	244085
EUR_166	20000	EUR	334	11532006	11579583	47577
EUR_166	20000	EUR	334	16243211	16402432	159221
EUR_166	20000	EUR	334	21061270	21202559	141289
EUR_166	20000	EUR	334	22447027	22462305	15278
EUR_166	20000	EUR	334	23165262	23266355	101093
EUR_166	20000	EUR	334	27933038	27974945	41907
EUR_166	20000	EUR	334	30976914	31127610	150696
EUR_166	20000	EUR	334	32730368	32759145	28777
EUR_166	20000	EUR	334	33167789	33295884	128095
EUR_166	20000	EUR	334	39858032	39938835	80803
EUR_166	20000	EUR	334	40410992	40602505	191513
EUR_166	20000	EUR	334	56476588	56480618	4030
EUR_166	20000	EUR	334	78833240	78853136	19896
EUR_166	20000	EUR	334	79901897	79936163	34266
EUR_166	20000	EUR	334	83933477	83957574	24097
EUR_166	20000	EUR	334	85353810	85405856	52046
EUR_166	20000	EUR	334	88221167	88259136	37969
EUR_166	20000	EUR	334	88797692	89081743	284051
EUR_166	20000	EUR	334	89180086	89235318	55232
EUR_166	20000	EUR	334	89997508	90008065	10557
EUR_166	20000	EUR	334	93906508	94010234	103726
EUR_166	20000	EUR	334	94447447	94522438	74991
EUR_166	20000	EUR	334	95774147	95792644	18497
EUR_166	20000	EUR	335	3929740	3982289	52549
EUR_166	20000	EUR	335	13076756	13087785	11029
EUR_166	20000	EUR	335	16202082	16248490	46408
EUR_166	20000	EUR	335	23032354	23168293	135939
EUR_166	20000	EUR	335	24088240	24133961	45721
EUR_166	20000	EUR	335	24456376	24503368	46992
EUR_166	20000	EUR	335	24892444	24906091	13647
EUR_166	20000	EUR	335	25323974	25378298	54324
EUR_166	20000	EUR	335	25867195	25987107	119912
EUR_166	20000	EUR	335	32135867	32179047	43180
EUR_166	20000	EUR	335	36663539	36678544	15005
EUR_166	20000	EUR	335	49860683	49898615	37932
EUR_166	20000	EUR	335	51999951	52007205	7254
EUR_166	20000	EUR	335	53875418	53951058	75640
EUR_166	20000	EUR	335	54659849	54665953	6104
EUR_166	20000	EUR	335	56476588	56480618	4030
EUR_166	20000	EUR	335	58943812	59122460	178648
EUR_166	20000	EUR	335	64338347	64502977	164630
EUR_166	20000	EUR	335	73136973	73172795	35822
EUR_166	20000	EUR	335	73498527	73536154	37627
EUR_166	20000	EUR	335	75263541	75282527	18986
EUR_166	20000	EUR	335	76139818	76143984	4166
EUR_166	20000	EUR	335	77606973	77624905	17932
EUR_166	20000	EUR	335	80973372	81229503	256131
EUR_166	20000	EUR	335	83886982	83921060	34078
EUR_166	20000	EUR	335	86810612	86824341	13729
EUR_166	20000	EUR	335	87504329	87507341	3012
EUR_166	20000	EUR	335	88219640	88382260	162620
EUR_166	20000	EUR	335	88796237	89010522	214285
EUR_166	20000	EUR	335	93123848	93146996	23148
EUR_166	20000	EUR	335	94793518	94818871	25353
EUR_167	20000	EUR	336	1829017	1865867	36850
EUR_167	20000	EUR	336	2622845	2648737	25892
EUR_167	20000	EUR	336	2913315	2963147	49832
EUR_167	20000	EUR	336	7287218	7395677	108459
EUR_167	20000	EUR	336	17333821	17360068	26247
EUR_167	20000	EUR	336	18310807	18368143	57336
EUR_167	20000	EUR	336	21350121	21367194	17073
EUR_167	20000	EUR	336	24076703	24094707	18004
EUR_167	20000	EUR	336	28111916	28139866	27950
EUR_167	20000	EUR	336	29347606	29362257	14651
EUR_167	20000	EUR	336	32694491	32748960	54469
EUR_167	20000	EUR	336	33126757	33151809	25052
EUR_167	20000	EUR	336	37809118	37815963	6845
EUR_167	20000	EUR	336	37960008	38097333	137325
EUR_167	20000	EUR	336	41319133	41360462	41329
EUR_167	20000	EUR	336	58863206	58863428	222
EUR_167	20000	EUR	336	73136973	73172795	35822
EUR_167	20000	EUR	336	73568940	73675439	106499
EUR_167	20000	EUR	336	76137655	76143984	6329
EUR_167	20000	EUR	336	77733985	77735979	1994
EUR_167	20000	EUR	336	79901897	79929594	27697
EUR_167	20000	EUR	336	84235412	84254246	18834
EUR_167	20000	EUR	336	84755692	84810053	54361
EUR_167	20000	EUR	336	89997508	90008065	10557
EUR_167	20000	EUR	336	91049817	91107582	57765
EUR_167	20000	EUR	336	91861895	91882560	20665
EUR_167	20000	EUR	336	96116814	96199691	82877
EUR_167	20000	EUR	337	1762556	1830270	67714
EUR_167	20000	EUR	337	3890786	4134871	244085
EUR_167	20000	EUR	337	17333821	17360068	26247
EUR_167	20000	EUR	337	18310807	18368143	57336
EUR_167	20000	EUR	337	21350121	21367194	17073
EUR_167	20000	EUR	337	24751957	24757234	5277
EUR_167	20000	EUR	337	26375604	26436121	60517
EUR_167	20000	EUR	337	26580016	26580898	882
EUR_167	20000	EUR	337	32877496	33016465	138969
EUR_167	20000	EUR	337	35318235	35413680	95445
EUR_167	20000	EUR	337	39907281	40145306	238025
EUR_167	20000	EUR	337	40410992	40602505	191513
EUR_167	20000	EUR	337	52224085	52440869	216784
EUR_167	20000	EUR	337	59680988	59700527	19539
EUR_167	20000	EUR	337	64338347	64519080	180733
EUR_167	20000	EUR	337	72447779	72471635	23856
EUR_167	20000	EUR	337	75592795	75632489	39694
EUR_167	20000	EUR	337	76759679	76772995	13316
EUR_167	20000	EUR	337	76910764	76913276	2512
EUR_167	20000	EUR	337	77606973	77735858	128885
EUR_167	20000	EUR	337	83933477	83957574	24097
EUR_167	20000	EUR	337	88077880	88172209	94329
EUR_167	20000	EUR	337	90426720	90469639	42919
EUR_167	20000	EUR	337	91847626	91875197	27571
EUR_167	20000	EUR	337	93499176	93647010	147834
EUR_167	20000	EUR	337	94793518	95112420	318902
EUR_168	20000	EUR	338	9235548	9308590	73042
EUR_168	20000	EUR	338	11650811	11652782	1971
EUR_168	20000	EUR	338	12764351	12785371	21020
EUR_168	20000	EUR	338	13076756	13134002	57246
EUR_168	20000	EUR	338	18100331	18140078	39747
EUR_168	20000	EUR	338	18622886	18806641	183755
EUR_168	20000	EUR	338	22519633	22533171	13538
EUR_168	20000	EUR	338	23122511	23134325	11814
EUR_168	20000	EUR	338	24485266	24581630	96364
EUR_168	20000	EUR	338	25140534	25305885	165351
EUR_168	20000	EUR	338	27933038	27974945	41907
EUR_168	20000	EUR	338	29291099	29311528	20429
EUR_168	20000	EUR	338	30904434	31092945	188511
EUR_168	20000	EUR	338	35398401	35528765	130364
EUR_168	20000	EUR	338	54210889	54362674	151785
EUR_168	20000	EUR	338	74595799	74699907	104108
EUR_168	20000	EUR	338	75851931	75915063	63132
EUR_168	20000	EUR	338	78831605	78886366	54761
EUR_168	20000	EUR	338	79086226	79134588	48362
EUR_168	20000	EUR	338	79862860	79933512	70652
EUR_168	20000	EUR	338	83886982	83921060	34078
EUR_168	20000	EUR	338	84755692	84919115	163423
EUR_168	20000	EUR	338	87369479	87389813	20334
EUR_168	20000	EUR	338	87580327	87751923	171596
EUR_168	20000	EUR	338	87969149	87994899	25750
EUR_168	20000	EUR	338	88077880	88113143	35263
EUR_168	20000	EUR	338	91074962	91107582	32620
EUR_168	20000	EUR	338	93908281	93925519	17238
EUR_168	20000	EUR	338	94595895	94713332	117437
EUR_168	20000	EUR	338	95774147	95817637	43490
EUR_168	20000	EUR	339	8348919	8534683	185764
EUR_168	20000	EUR	339	8676684	8714283	37599
EUR_168	20000	EUR	339	11704442	11731498	27056
EUR_168	20000	EUR	339	21350121	21429464	79343
EUR_168	20000	EUR	339	23176150	23184805	8655
EUR_168	20000	EUR	339	24045382	24166883	121501
EUR_168	20000	EUR	339	24528522	24581630	53108
EUR_168	20000	EUR	339	25630747	25727166	96419
EUR_168	20000	EUR	339	29306591	29478208	171617
EUR_168	20000	EUR	339	30872888	30886133	13245
EUR_168	20000	EUR	339	32057270	32141896	84626
EUR_168	20000	EUR	339	41319133	41360462	41329
EUR_168	20000	EUR	339	53821064	54035252	214188
EUR_168	20000	EUR	339	54544870	54904011	359141
EUR_168	20000	EUR	339	58093392	58136140	42748
EUR_168	20000	EUR	339	68675332	68717300	41968
EUR_168	20000	EUR	339	72226457	72297712	71255
EUR_168	20000	EUR	339	72961212	73122070	160858
EUR_168	20000	EUR	339	75263541	75282527	18986
EUR_168	20000	EUR	339	77787138	77885640	98502
EUR_168	20000	EUR	339	78816419	78828338	11919
EUR_168	20000	EUR	339	79831163	79933512	102349
EUR_168	20000	EUR	339	80161288	80234873	73585
EUR_168	20000	EUR	339	83370620	83384810	14190
EUR_168	20000	EUR	339	85353810	85405856	52046
EUR_168	20000	EUR	339	88078757	88161538	82781
EUR_168	20000	EUR	339	88825376	88915947	90571
EUR_168	20000	EUR	339	95774147	95817637	43490
EUR_169	20000	EUR	340	1004770	1079953	75183
EUR_169	20000	EUR	340	8651970	8714283	62313
EUR_169	20000	EUR	340	16234928	16286721	51793
EUR_169	20000	EUR	340	17371076	17397614	26538
EUR_169	20000	EUR	340	18229012	18368143	139131
EUR_169	20000	EUR	340	24372241	24484665	112424
EUR_169	20000	EUR	340	24892444	24906091	13647
EUR_169	20000	EUR	340	25741256	25777999	36743
EUR_169	20000	EUR	340	26375604	26436121	60517
EUR_169	20000	EUR	340	26886230	26991485	105255
EUR_169	20000	EUR	340	27746608	27974945	228337
EUR_169	20000	EUR	340	28111916	28139866	27950
EUR_169	20000	EUR	340	29291099	29311528	20429
EUR_169	20000	EUR	340	37722669	38097333	374664
EUR_169	20000	EUR	340	40047500	40068128	20628
EUR_169	20000	EUR	340	42793149	42823699	30550
EUR_169	20000	EUR	340	49714809	49899094	184285
EUR_169	20000	EUR	340	52168283	52224193	55910
EUR_169	20000	EUR	340	53821064	53837891	16827
EUR_169	20000	EUR	340	54632404	54794755	162351
EUR_169	20000	EUR	340	71700744	71716675	15931
EUR_169	20000	EUR	340	71752624	71761992	9368
EUR_169	20000	EUR	340	74581736	74699907	118171
EUR_169	20000	EUR	340	76798443	77082685	284242
EUR_169	20000	EUR	340	77751346	77795912	44566
EUR_169	20000	EUR	340	80161288	80278256	116968
EUR_169	20000	EUR	340	84806687	84810053	3366
EUR_169	20000	EUR	340	88540851	88877558	336707
EUR_169	20000	EUR	340	89067780	89099823	32043
EUR_169	20000	EUR	340	91891040	91902611	11571
EUR_169	20000	EUR	340	93331071	93411339	80268
EUR_169	20000	EUR	340	93943380	94056780	113400
EUR_169	20000	EUR	340	94297447	94418018	120571
EUR_169	20000	EUR	340	94419260	94544971	125711
EUR_169	20000	EUR	340	95774147	95792644	18497
EUR_169	20000	EUR	341	16243211	16437214	194003
EUR_169	20000	EUR	341	18081536	18107085	25549
EUR_169	20000	EUR	341	21224963	21225412	449
EUR_169	20000	EUR	341	23766790	23877108	110318
EUR_169	20000	EUR	341	24621120	24666053	44933
EUR_169	20000	EUR	341	25140534	25209294	68760
EUR_169	20000	EUR	341	26849817	26883308	33491
EUR_169	20000	EUR	341	30804231	31151086	346855
EUR_169	20000	EUR	341	32855612	32870350	14738
EUR_169	20000	EUR	341	34124908	34182116	57208
EUR_169	20000	EUR	341	35771774	35892995	121221
EUR_169	20000	EUR	341	40074168	40145306	71138
EUR_169	20000	EUR	341	40410992	40498219	87227
EUR_169	20000	EUR	341	42509447	42548664	39217
EUR_169	20000	EUR	341	42792406	42823699	31293
EUR_169	20000	EUR	341	50056018	50072151	16133
EUR_169	20000	EUR	341	54000284	54076786	76502
EUR_169	20000	EUR	341	59578454	59631696	53242
EUR_169	20000	EUR	341	68675332	68717300	41968
EUR_169	20000	EUR	341	72359726	72364190	4464
EUR_169	20000	EUR	341	73488506	73675439	186933
EUR_169	20000	EUR	341	74581736	74738891	157155
EUR_169	20000	EUR	341	77738466	77769137	30671
EUR_169	20000	EUR	341	77805961	77881732	75771
EUR_169	20000	EUR	341	80874989	81079947	204958
EUR_169	20000	EUR	341	88078757	88161538	82781
EUR_169	20000	EUR	341	88825376	88915947	90571
EUR_169	20000	EUR	341	94061105	94126740	65635
EUR_169	20000	EUR	341	94605820	94610527	4707
EUR_169	20000	EUR	341	95774147	95778109	3962
EUR_169	20000	EUR	341	96506025	97008044	502019
EUR_170	20000	EUR	342	2454787	2561877	107090
EUR_170	20000	EUR	342	2984450	2997995	13545
EUR_170	20000	EUR	342	4004059	4134871	130812
EUR_170	20000	EUR	342	13076756	13087785	11029
EUR_170	20000	EUR	342	16243211	16402432	159221
EUR_170	20000	EUR	342	24621120	24695006	73886
EUR_170	20000	EUR	342	24749954	24757234	7280
EUR_170	20000	EUR	342	25141418	25209294	67876
EUR_170	20000	EUR	342	25741256	25777999	36743
EUR_170	20000	EUR	342	31213362	31368982	155620
EUR_170	20000	EUR	342	31671896	31720342	48446
EUR_170	20000	EUR	342	35281602	35456600	174998
EUR_170	20000	EUR	342	35583128	35584922	1794
EUR_170	20000	EUR	342	42613880	42659849	45969
EUR_170	20000	EUR	342	50053800	50097389	43589
EUR_170	20000	EUR	342	53821620	54076786	255166
EUR_170	20000	EUR	342	59064557	59522281	457724
EUR_170	20000	EUR	342	68675332	68717300	41968
EUR_170	20000	EUR	342	73041797	73160136	118339
EUR_170	20000	EUR	342	74092678	74094072	1394
EUR_170	20000	EUR	342	76137655	76143984	6329
EUR_170	20000	EUR	342	78831605	78886366	54761
EUR_170	20000	EUR	342	79086226	79134588	48362
EUR_170	20000	EUR	342	79901897	79903521	1624
EUR_170	20000	EUR	342	87369479	87389813	20334
EUR_170	20000	EUR	342	89449131	89450013	882
EUR_170	20000	EUR	342	90705520	90969654	264134
EUR_170	20000	EUR	342	91847626	91929323	81697
EUR_170	20000	EUR	342	91987726	92171686	183960
EUR_170	20000	EUR	342	93303963	93371609	67646
EUR_170	20000	EUR	342	93721614	93725532	3918
EUR_170	20000	EUR	342	94406727	94556642	149915
EUR_170	20000	EUR	342	95270807	95445533	174726
EUR_170	20000	EUR	343	4093341	4134871	41530
EUR_170	20000	EUR	343	17687142	17689297	2155
EUR_170	20000	EUR	343	23148716	23184805	36089
EUR_170	20000	EUR	343	23752602	23856810	104208
EUR_170	20000	EUR	343	24621120	24666053	44933
EUR_170	20000	EUR	343	24892444	24906091	13647
EUR_170	20000	EUR	343	29693031	29706829	13798
EUR_170	20000	EUR	343	32262916	32267787	4871
EUR_170	20000	EUR	343	35281602	35413025	131423
EUR_170	20000	EUR	343	37727611	37861599	133988
EUR_170	20000	EUR	343	39652652	39692065	39413
EUR_170	20000	EUR	343	39907281	40008876	101595
EUR_170	20000	EUR	343	42493150	42574352	81202
EUR_170	20000	EUR	343	54567449	54612977	45528
EUR_170	20000	EUR	343	54765460	54904011	138551
EUR_170	20000	EUR	343	71700744	71764001	63257
EUR_170	20000	EUR	343	73136973	73165153	28180
EUR_170	20000	EUR	343	76365488	76370460	4972
EUR_170	20000	EUR	343	80170848	80278256	107408
EUR_170	20000	EUR	343	80874989	81229503	354514
EUR_170	20000	EUR	343	83955315	83957574	2259
EUR_170	20000	EUR	343	87547254	87656802	109548
EUR_170	20000	EUR	343	87727929	87846433	118504
EUR_170	20000	EUR	343	88087834	88146039	58205
EUR_170	20000	EUR	343	88460364	88598966	138602
EUR_170	20000	EUR	343	89084957	89124034	39077
EUR_170	20000	EUR	343	94362487	94382190	19703
EUR_171	20000	EUR	344	15890559	16068960	178401
EUR_171	20000	EUR	344	16211469	16325554	114085
EUR_171	20000	EUR	344	21150828	21225412	74584
EUR_171	20000	EUR	344	22890136	23215111	324975
EUR_171	20000	EUR	344	23752602	23828614	76012
EUR_171	20000	EUR	344	24892444	24906091	13647
EUR_171	20000	EUR	344	25323974	25378298	54324
EUR_171	20000	EUR	344	32102558	32141896	39338
EUR_171	20000	EUR	344	34275078	34301915	26837
EUR_171	20000	EUR	344	35281602	35456600	174998
EUR_171	20000	EUR	344	37885686	37943125	57439
EUR_171	20000	EUR	344	39858032	39975061	117029
EUR_171	20000	EUR	344	40953591	41037792	84201
EUR_171	20000	EUR	344	42435376	42550782	115406
EUR_171	20000	EUR	344	52280929	52337003	56074
EUR_171	20000	EUR	344	69023918	69060887	36969
EUR_171	20000	EUR	344	75089161	75095784	6623
EUR_171	20000	EUR	344	76798443	77082685	284242
EUR_171	20000	EUR	344	77879347	77881732	2385
EUR_171	20000	EUR	344	79901897	79936163	34266
EUR_171	20000	EUR	344	80161288	80278256	116968
EUR_171	20000	EUR	344	84755692	84919115	163423
EUR_171	20000	EUR	344	87650695	87656802	6107
EUR_171	20000	EUR	344	88221167	88300295	79128
EUR_171	20000	EUR	344	88324698	88699947	375249
EUR_171	20000	EUR	344	88703422	88703923	501
EUR_171	20000	EUR	344	88761110	89081743	320633
EUR_171	20000	EUR	344	91891040	91902611	11571
EUR_171	20000	EUR	344	94388014	94556642	168628
EUR_171	20000	EUR	344	94885812	94898377	12565
EUR_171	20000	EUR	344	94898715	94930362	31647
EUR_171	20000	EUR	344	96136238	96151871	15633
EUR_171	20000	EUR	345	8749037	8780869	31832
EUR_171	20000	EUR	345	10399704	10402156	2452
EUR_171	20000	EUR	345	16234928	16286721	51793
EUR_171	20000	EUR	345	23148716	23184805	36089
EUR_171	20000	EUR	345	24456376	24503368	46992
EUR_171	20000	EUR	345	24892444	24906091	13647
EUR_171	20000	EUR	345	25323974	25378298	54324
EUR_171	20000	EUR	345	25867195	25987107	119912
EUR_171	20000	EUR	345	30904434	31092945	188511
EUR_171	20000	EUR	345	31671896	31719587	47691
EUR_171	20000	EUR	345	42369514	42468579	99065
EUR_171	20000	EUR	345	52168283	52224193	55910
EUR_171	20000	EUR	345	53821064	53996988	175924
EUR_171	20000	EUR	345	54686744	54714097	27353
EUR_171	20000	EUR	345	54736941	54904011	167070
EUR_171	20000	EUR	345	59064557	59245738	181181
EUR_171	20000	EUR	345	63714218	63732455	18237
EUR_171	20000	EUR	345	71590090	71678663	88573
EUR_171	20000	EUR	345	72961212	73172795	211583
EUR_171	20000	EUR	345	73488506	73493479	4973
EUR_171	20000	EUR	345	75851931	75915063	63132
EUR_171	20000	EUR	345	76365488	76370460	4972
EUR_171	20000	EUR	345	77787138	77885640	98502
EUR_171	20000	EUR	345	78816419	78828338	11919
EUR_171	20000	EUR	345	79831163	79933512	102349
EUR_171	20000	EUR	345	80161288	80197859	36571
EUR_171	20000	EUR	345	88796237	89010522	214285
EUR_171	20000	EUR	345	89029670	89043204	13534
EUR_171	20000	EUR	345	90660950	90697106	36156
EUR_171	20000	EUR	345	91011409	91097487	86078
EUR_171	20000	EUR	345	91999011	92171686	172675
EUR_171	20000	EUR	345	94239181	94337048	97867
EUR_171	20000	EUR	345	94348955	94544971	196016
EUR_171	20000	EUR	345	94898715	94930362	31647
EUR_171	20000	EUR	345	95009623	95112420	102797
EUR_171	20000	EUR	345	95270807	95445533	174726
EUR_172	20000	EUR	346	5018475	5034623	16148
EUR_172	20000	EUR	346	21149491	21175881	26390
EUR_172	20000	EUR	346	24749954	24757234	7280
EUR_172	20000	EUR	346	24892444	24906091	13647
EUR_172	20000	EUR	346	25066876	25088413	21537
EUR_172	20000	EUR	346	25189085	25190547	1462
EUR_172	20000	EUR	346	29282228	29311528	29300
EUR_172	20000	EUR	346	32730368	32759145	28777
EUR_172	20000	EUR	346	32851725	32880042	28317
EUR_172	20000	EUR	346	43520906	43653793	132887
EUR_172	20000	EUR	346	49714605	49899094	184489
EUR_172	20000	EUR	346	52280929	52337003	56074
EUR_172	20000	EUR	346	57136159	57262845	126686
EUR_172	20000	EUR	346	59553546	59700527	146981
EUR_172	20000	EUR	346	73519049	73629683	110634
EUR_172	20000	EUR	346	73852581	73906350	53769
EUR_172	20000	EUR	346	76365488	76370460	4972
EUR_172	20000	EUR	346	88087834	88319207	231373
EUR_172	20000	EUR	346	88527647	88551173	23526
EUR_172	20000	EUR	346	88761110	89012028	250918
EUR_172	20000	EUR	346	90744622	90852419	107797
EUR_172	20000	EUR	346	93585543	93693381	107838
EUR_172	20000	EUR	346	94447447	94522438	74991
EUR_172	20000	EUR	346	94527644	94559172	31528
EUR_172	20000	EUR	346	96760897	97008044	247147
EUR_172	20000	EUR	346	99177558	99280798	103240
EUR_172	20000	EUR	347	2415974	2596238	180264
EUR_172	20000	EUR	347	2984450	2997995	13545
EUR_172	20000	EUR	347	13429221	13471276	42055
EUR_172	20000	EUR	347	17333821	17369300	35479
EUR_172	20000	EUR	347	18635589	18636940	1351
EUR_172	20000	EUR	347	24372241	24384508	12267
EUR_172	20000	EUR	347	24892444	24906091	13647
EUR_172	20000	EUR	347	25264173	25276538	12365
EUR_172	20000	EUR	347	25867195	25987107	119912
EUR_172	20000	EUR	347	29321833	29396318	74485
EUR_172	20000	EUR	347	30904434	30925177	20743
EUR_172	20000	EUR	347	30982709	31092945	110236
EUR_172	20000	EUR	347	36811299	36864514	53215
EUR_172	20000	EUR	347	37727611	37735395	7784
EUR_172	20000	EUR	347	39957500	40021036	63536
EUR_172	20000	EUR	347	40410992	40602505	191513
EUR_172	20000	EUR	347	41359664	41360462	798
EUR_172	20000	EUR	347	51948707	52007205	58498
EUR_172	20000	EUR	347	54113043	54177383	64340
EUR_172	20000	EUR	347	68626746	68648432	21686
EUR_172	20000	EUR	347	71700744	71721449	20705
EUR_172	20000	EUR	347	74871541	74894548	23007
EUR_172	20000	EUR	347	85353810	85405856	52046
EUR_172	20000	EUR	347	88221167	88300295	79128
EUR_172	20000	EUR	347	88324698	88334654	9956
EUR_172	20000	EUR	347	88825376	88915947	90571
EUR_172	20000	EUR	347	90153261	90243516	90255
EUR_172	20000	EUR	347	91891040	91902611	11571
EUR_172	20000	EUR	347	94147632	94317758	170126
EUR_172	20000	EUR	347	95356313	95445533	89220
EUR_172	20000	EUR	347	95774147	95817637	43490
EUR_172	20000	EUR	347	96935088	97008044	72956
EUR_173	20000	EUR	348	1534378	1685328	150950
EUR_173	20000	EUR	348	2546510	2630115	83605
EUR_173	20000	EUR	348	2667696	2893597	225901
EUR_173	20000	EUR	348	4129039	4134871	5832
EUR_173	20000	EUR	348	8783056	8932393	149337
EUR_173	20000	EUR	348	16243211	16401162	157951
EUR_173	20000	EUR	348	18081536	18107085	25549
EUR_173	20000	EUR	348	23721919	23797839	75920
EUR_173	20000	EUR	348	24372241	24581630	209389
EUR_173	20000	EUR	348	24892444	24906091	13647
EUR_173	20000	EUR	348	26819249	26911224	91975
EUR_173	20000	EUR	348	31113073	31116691	3618
EUR_173	20000	EUR	348	32057270	32141896	84626
EUR_173	20000	EUR	348	32667412	32870350	202938
EUR_173	20000	EUR	348	35084593	35087281	2688
EUR_173	20000	EUR	348	35424505	35627884	203379
EUR_173	20000	EUR	348	36284487	36357016	72529
EUR_173	20000	EUR	348	36660352	36847359	187007
EUR_173	20000	EUR	348	37705403	37817231	111828
EUR_173	20000	EUR	348	54074498	54076786	2288
EUR_173	20000	EUR	348	56476588	56480618	4030
EUR_173	20000	EUR	348	57712252	57836625	124373
EUR_173	20000	EUR	348	64803473	64922329	118856
EUR_173	20000	EUR	348	68626746	68648432	21686
EUR_173	20000	EUR	348	73488506	73574713	86207
EUR_173	20000	EUR	348	74037242	74094072	56830
EUR_173	20000	EUR	348	76137655	76143984	6329
EUR_173	20000	EUR	348	78831605	78886366	54761
EUR_173	20000	EUR	348	79086226	79134588	48362
EUR_173	20000	EUR	348	80863277	80899276	35999
EUR_173	20000	EUR	348	84898186	84919115	20929
EUR_173	20000	EUR	348	87512858	87620403	107545
EUR_173	20000	EUR	348	88453841	88762816	308975
EUR_173	20000	EUR	348	88841226	88915947	74721
EUR_173	20000	EUR	348	93123848	93146996	23148
EUR_173	20000	EUR	348	94523809	94559172	35363
EUR_173	20000	EUR	348	96633257	96734113	100856
EUR_173	20000	EUR	348	99230141	99280798	50657
EUR_173	20000	EUR	349	3963309	4029447	66138
EUR_173	20000	EUR	349	11532006	11579583	47577
EUR_173	20000	EUR	349	12764351	12974092	209741
EUR_173	20000	EUR	349	13889315	13904227	14912
EUR_173	20000	EUR	349	18229012	18341983	112971
EUR_173	20000	EUR	349	18677221	18844474	167253
EUR_173	20000	EUR	349	21350121	21429464	79343
EUR_173	20000	EUR	349	22447027	22462305	15278
EUR_173	20000	EUR	349	23120612	23126894	6282
EUR_173	20000	EUR	349	24045382	24155650	110268
EUR_173	20000	EUR	349	24621120	24666053	44933
EUR_173	20000	EUR	349	24892444	24906091	13647
EUR_173	20000	EUR	349	26375604	26436121	60517
EUR_173	20000	EUR	349	29273800	29279379	5579
EUR_173	20000	EUR	349	30904434	30925177	20743
EUR_173	20000	EUR	349	32149032	32179047	30015
EUR_173	20000	EUR	349	32855612	32870350	14738
EUR_173	20000	EUR	349	33126757	33166924	40167
EUR_173	20000	EUR	349	36339512	36357016	17504
EUR_173	20000	EUR	349	40047500	40068128	20628
EUR_173	20000	EUR	349	41161176	41182266	21090
EUR_173	20000	EUR	349	52168283	52388833	220550
EUR_173	20000	EUR	349	53821064	53859932	38868
EUR_173	20000	EUR	349	59474219	59631623	157404
EUR_173	20000	EUR	349	64803473	64820966	17493
EUR_173	20000	EUR	349	73136973	73172795	35822
EUR_173	20000	EUR	349	75263541	75282527	18986
EUR_173	20000	EUR	349	76139818	76140066	248
EUR_173	20000	EUR	349	87075746	87088817	13071
EUR_173	20000	EUR	349	87803395	87858554	55159
EUR_173	20000	EUR	349	88087834	88258188	170354
EUR_173	20000	EUR	349	88793158	88877947	84789
EUR_173	20000	EUR	349	93123848	93146996	23148
EUR_174	20000	EUR	350	1357637	1458138	100501
EUR_174	20000	EUR	350	2984450	3003090	18640
EUR_174	20000	EUR	350	4458174	4517103	58929
EUR_174	20000	EUR	350	8783056	8799713	16657
EUR_174	20000	EUR	350	16243211	16437214	194003
EUR_174	20000	EUR	350	17889447	17902017	12570
EUR_174	20000	EUR	350	18250545	18302049	51504
EUR_174	20000	EUR	350	22454245	22540410	86165
EUR_174	20000	EUR	350	24372241	24384508	12267
EUR_174	20000	EUR	350	25140534	25157132	16598
EUR_174	20000	EUR	350	25817587	25896396	78809
EUR_174	20000	EUR	350	26319359	26513093	193734
EUR_174	20000	EUR	350	31842746	31866371	23625
EUR_174	20000	EUR	350	32824940	32871485	46545
EUR_174	20000	EUR	350	41161176	41182266	21090
EUR_174	20000	EUR	350	52273344	52337003	63659
EUR_174	20000	EUR	350	54653171	54730663	77492
EUR_174	20000	EUR	350	54893690	54904011	10321
EUR_174	20000	EUR	350	58124254	58136140	11886
EUR_174	20000	EUR	350	59553546	59586581	33035
EUR_174	20000	EUR	350	63714218	63732455	18237
EUR_174	20000	EUR	350	74890691	74894548	3857
EUR_174	20000	EUR	350	76365488	76397099	31611
EUR_174	20000	EUR	350	76759679	76869710	110031
EUR_174	20000	EUR	350	76921572	77067204	145632
EUR_174	20000	EUR	350	77800262	77885640	85378
EUR_174	20000	EUR	350	80135541	80139395	3854
EUR_174	20000	EUR	350	80852609	80890918	38309
EUR_174	20000	EUR	350	85377298	85405856	28558
EUR_174	20000	EUR	350	88496413	88877558	381145
EUR_174	20000	EUR	350	91011409	91097487	86078
EUR_174	20000	EUR	350	94241722	94325814	84092
EUR_174	20000	EUR	350	94347548	94418018	70470
EUR_174	20000	EUR	350	94419260	94544971	125711
EUR_174	20000	EUR	351	1853096	1854996	1900
EUR_174	20000	EUR	351	2546510	2614925	68415
EUR_174	20000	EUR	351	16234928	16286721	51793
EUR_174	20000	EUR	351	17749730	17919616	169886
EUR_174	20000	EUR	351	24372241	24412471	40230
EUR_174	20000	EUR	351	26375604	26436121	60517
EUR_174	20000	EUR	351	26580016	26580898	882
EUR_174	20000	EUR	351	29306591	29365834	59243
EUR_174	20000	EUR	351	42793149	42823699	30550
EUR_174	20000	EUR	351	52168283	52185007	16724
EUR_174	20000	EUR	351	53847831	53859932	12101
EUR_174	20000	EUR	351	54567449	54612977	45528
EUR_174	20000	EUR	351	56378802	56448072	69270
EUR_174	20000	EUR	351	59554189	59607931	53742
EUR_174	20000	EUR	351	63714218	63784151	69933
EUR_174	20000	EUR	351	68675332	68717300	41968
EUR_174	20000	EUR	351	72964182	73172795	208613
EUR_174	20000	EUR	351	76022322	76143984	121662
EUR_174	20000	EUR	351	80454885	80489589	34704
EUR_174	20000	EUR	351	80898953	81229503	330550
EUR_174	20000	EUR	351	83370620	83384810	14190
EUR_174	20000	EUR	351	88395997	88419767	23770
EUR_174	20000	EUR	351	91049817	91107582	57765
EUR_174	20000	EUR	351	94210771	94222927	12156
EUR_174	20000	EUR	351	95774147	95778109	3962
EUR_174	20000	EUR	351	96136238	96175807	39569
EUR_174	20000	EUR	351	96379020	96438545	59525
EUR_175	20000	EUR	352	2788906	2927883	138977
EUR_175	20000	EUR	352	9413335	9449917	36582
EUR_175	20000	EUR	352	13613520	13634873	21353
EUR_175	20000	EUR	352	16365496	16437214	71718
EUR_175	20000	EUR	352	18081536	18107085	25549
EUR_175	20000	EUR	352	24892444	24906091	13647
EUR_175	20000	EUR	352	25285126	25305885	20759
EUR_175	20000	EUR	352	25537317	25639784	102467
EUR_175	20000	EUR	352	25868315	25896396	28081
EUR_175	20000	EUR	352	25898105	25905765	7660
EUR_175	20000	EUR	352	26886230	26991485	105255
EUR_175	20000	EUR	352	27746608	27793020	46412
EUR_175	20000	EUR	352	29273800	29279379	5579
EUR_175	20000	EUR	352	31213960	31244622	30662
EUR_175	20000	EUR	352	33280947	33295884	14937
EUR_175	20000	EUR	352	34136759	34182116	45357
EUR_175	20000	EUR	352	34999082	35095643	96561
EUR_175	20000	EUR	352	52168283	52388833	220550
EUR_175	20000	EUR	352	54298647	54422116	123469
EUR_175	20000	EUR	352	59631177	59631623	446
EUR_175	20000	EUR	352	63714218	63784151	69933
EUR_175	20000	EUR	352	68624378	68713281	88903
EUR_175	20000	EUR	352	75263541	75264425	884
EUR_175	20000	EUR	352	76456850	76594146	137296
EUR_175	20000	EUR	352	80863277	81108910	245633
EUR_175	20000	EUR	352	83886982	83921060	34078
EUR_175	20000	EUR	352	88221167	88224922	3755
EUR_175	20000	EUR	352	91541076	91672576	131500
EUR_175	20000	EUR	352	94241722	94325814	84092
EUR_175	20000	EUR	352	94347548	94418018	70470
EUR_175	20000	EUR	352	94419260	94544971	125711
EUR_175	20000	EUR	352	94898715	94930362	31647
EUR_175	20000	EUR	352	95323015	95353984	30969
EUR_175	20000	EUR	352	96116814	96220219	103405
EUR_175	20000	EUR	353	8348919	8386102	37183
EUR_175	20000	EUR	353	11650811	11652782	1971
EUR_175	20000	EUR	353	12764351	12785371	21020
EUR_175	20000	EUR	353	13076756	13134002	57246
EUR_175	20000	EUR	353	17879034	18041675	162641
EUR_175	20000	EUR	353	18091263	18107085	15822
EUR_175	20000	EUR	353	22279659	22313169	33510
EUR_175	20000	EUR	353	25140534	25157132	16598
EUR_175	20000	EUR	353	25847649	25855304	7655
EUR_175	20000	EUR	353	26375604	26429831	54227
EUR_175	20000	EUR	353	32293660	32447123	153463
EUR_175	20000	EUR	353	32731416	32768500	37084
EUR_175	20000	EUR	353	36811299	36864514	53215
EUR_175	20000	EUR	353	37727611	37735395	7784
EUR_175	20000	EUR	353	39957500	40021036	63536
EUR_175	20000	EUR	353	40410992	40602505	191513
EUR_175	20000	EUR	353	41359664	41360462	798
EUR_175	20000	EUR	353	57136159	57262845	126686
EUR_175	20000	EUR	353	59578454	59745811	167357
EUR_175	20000	EUR	353	69023918	69060887	36969
EUR_175	20000	EUR	353	72961212	73172795	211583
EUR_175	20000	EUR	353	74695721	74738891	43170
EUR_175	20000	EUR	353	79901897	79903521	1624
EUR_175	20000	EUR	353	84755692	84790641	34949
EUR_175	20000	EUR	353	86508335	86539843	31508
EUR_175	20000	EUR	353	94468868	94544971	76103
EUR_175	20000	EUR	353	96537974	96947853	409879
EUR_176	20000	EUR	354	2454787	2691190	236403
EUR_176	20000	EUR	354	8348919	8386102	37183
EUR_176	20000	EUR	354	13021482	13178737	157255
EUR_176	20000	EUR	354	22447027	22468823	21796
EUR_176	20000	EUR	354	23721919	23797839	75920
EUR_176	20000	EUR	354	24372241	24425302	53061
EUR_176	20000	EUR	354	24516931	24581630	64699
EUR_176	20000	EUR	354	25867195	25987107	119912
EUR_176	20000	EUR	354	26819249	26911224	91975
EUR_176	20000	EUR	354	28643058	28692721	49663
EUR_176	20000	EUR	354	34124908	34182116	57208
EUR_176	20000	EUR	354	36392759	36460007	67248
EUR_176	20000	EUR	354	40410992	40452272	41280
EUR_176	20000	EUR	354	52168283	52224193	55910
EUR_176	20000	EUR	354	53821620	54076786	255166
EUR_176	20000	EUR	354	59680988	59700527	19539
EUR_176	20000	EUR	354	69023918	69060887	36969
EUR_176	20000	EUR	354	75089161	75095784	6623
EUR_176	20000	EUR	354	81082281	81229503	147222
EUR_176	20000	EUR	354	83533777	83550130	16353
EUR_176	20000	EUR	354	83955315	83957574	2259
EUR_176	20000	EUR	354	88087834	88415057	327223
EUR_176	20000	EUR	354	88825376	89050718	225342
EUR_176	20000	EUR	354	90627118	90969654	342536
EUR_176	20000	EUR	354	91847626	91929323	81697
EUR_176	20000	EUR	354	91987726	92020761	33035
EUR_176	20000	EUR	354	93680632	93680672	40
EUR_176	20000	EUR	354	96136238	96175807	39569
EUR_176	20000	EUR	355	11650811	11652782	1971
EUR_176	20000	EUR	355	16243211	16437214	194003
EUR_176	20000	EUR	355	17889447	17902017	12570
EUR_176	20000	EUR	355	23120612	23184805	64193
EUR_176	20000	EUR	355	23648833	23651476	2643
EUR_176	20000	EUR	355	24892444	24906091	13647
EUR_176	20000	EUR	355	25323974	25378298	54324
EUR_176	20000	EUR	355	27746608	27793020	46412
EUR_176	20000	EUR	355	32057270	32124528	67258
EUR_176	20000	EUR	355	32675477	32748960	73483
EUR_176	20000	EUR	355	32855612	32870350	14738
EUR_176	20000	EUR	355	68626746	68648432	21686
EUR_176	20000	EUR	355	72160732	72205102	44370
EUR_176	20000	EUR	355	75587305	75641163	53858
EUR_176	20000	EUR	355	84755692	84919115	163423
EUR_176	20000	EUR	355	87075746	87120548	44802
EUR_176	20000	EUR	355	87175208	87455574	280366
EUR_176	20000	EUR	355	87758163	87888944	130781
EUR_176	20000	EUR	355	88087834	88319207	231373
EUR_176	20000	EUR	355	88761110	89017146	256036
EUR_176	20000	EUR	355	90141069	90164943	23874
EUR_176	20000	EUR	355	93680632	93680672	40
EUR_176	20000	EUR	355	94243595	94317758	74163
EUR_176	20000	EUR	355	94885812	94898377	12565
EUR_176	20000	EUR	355	94898715	94930362	31647
EUR_176	20000	EUR	355	95774147	95778109	3962
EUR_176	20000	EUR	355	96136238	96175807	39569
EUR_177	20000	EUR	356	1853096	1854996	1900
EUR_177	20000	EUR	356	13574314	13635433	61119
EUR_177	20000	EUR	356	13640984	13644276	3292
EUR_177	20000	EUR	356	21195166	21282925	87759
EUR_177	20000	EUR	356	23120612	23184805	64193
EUR_177	20000	EUR	356	24892444	24906091	13647
EUR_177	20000	EUR	356	25153328	25215904	62576
EUR_177	20000	EUR	356	25847649	25855304	7655
EUR_177	20000	EUR	356	32359359	32431881	72522
EUR_177	20000	EUR	356	32526542	32537277	10735
EUR_177	20000	EUR	356	32694491	32759145	64654
EUR_177	20000	EUR	356	33430359	33479750	49391
EUR_177	20000	EUR	356	35771774	35852161	80387
EUR_177	20000	EUR	356	49860683	49898615	37932
EUR_177	20000	EUR	356	52168283	52337003	168720
EUR_177	20000	EUR	356	71590090	71678663	88573
EUR_177	20000	EUR	356	72961212	73172795	211583
EUR_177	20000	EUR	356	74019705	74094072	74367
EUR_177	20000	EUR	356	75851931	75915063	63132
EUR_177	20000	EUR	356	78816419	79134588	318169
EUR_177	20000	EUR	356	88255903	88409957	154054
EUR_177	20000	EUR	356	88591200	88600577	9377
EUR_177	20000	EUR	356	88752812	88877558	124746
EUR_177	20000	EUR	356	88902842	89081743	178901
EUR_177	20000	EUR	356	90660950	90662442	1492
EUR_177	20000	EUR	356	93190964	93277691	86727
EUR_177	20000	EUR	356	99165891	99188344	22453
EUR_177	20000	EUR	356	99262130	99280798	18668
EUR_177	20000	EUR	357	327186	411145	83959
EUR_177	20000	EUR	357	1927314	1946512	19198
EUR_177	20000	EUR	357	8348919	8386102	37183
EUR_177	20000	EUR	357	22447027	22533171	86144
EUR_177	20000	EUR	357	23177139	23184805	7666
EUR_177	20000	EUR	357	24372241	24384508	12267
EUR_177	20000	EUR	357	24892444	24900968	8524
EUR_177	20000	EUR	357	25140534	25198737	58203
EUR_177	20000	EUR	357	25867195	25906960	39765
EUR_177	20000	EUR	357	26319359	26331325	11966
EUR_177	20000	EUR	357	26849817	26889089	39272
EUR_177	20000	EUR	357	32138726	32179047	40321
EUR_177	20000	EUR	357	35887157	35892995	5838
EUR_177	20000	EUR	357	37722669	38097333	374664
EUR_177	20000	EUR	357	40132875	40145306	12431
EUR_177	20000	EUR	357	54653171	54730663	77492
EUR_177	20000	EUR	357	59064557	59522281	457724
EUR_177	20000	EUR	357	68624378	68632783	8405
EUR_177	20000	EUR	357	68652113	68652916	803
EUR_177	20000	EUR	357	69809636	69942832	133196
EUR_177	20000	EUR	357	70541408	70544348	2940
EUR_177	20000	EUR	357	74055055	74094072	39017
EUR_177	20000	EUR	357	74595799	74699907	104108
EUR_177	20000	EUR	357	77751346	77795912	44566
EUR_177	20000	EUR	357	88395997	88419767	23770
EUR_177	20000	EUR	357	91049817	91107582	57765
EUR_177	20000	EUR	357	91987726	92013641	25915
EUR_177	20000	EUR	357	93158329	93258686	100357
EUR_177	20000	EUR	357	93277783	93322262	44479
EUR_177	20000	EUR	357	94299354	94418018	118664
EUR_177	20000	EUR	357	94419260	94544971	125711
EUR_177	20000	EUR	357	95270807	95445533	174726
EUR_177	20000	EUR	357	96229638	96336399	106761
EUR_178	20000	EUR	358	13097064	13178737	81673
EUR_178	20000	EUR	358	21149491	21237968	88477
EUR_178	20000	EUR	358	23432743	23554604	121861
EUR_178	20000	EUR	358	24621120	24737906	116786
EUR_178	20000	EUR	358	24809049	24866754	57705
EUR_178	20000	EUR	358	25179048	25305885	126837
EUR_178	20000	EUR	358	25847649	25855304	7655
EUR_178	20000	EUR	358	26375604	26436121	60517
EUR_178	20000	EUR	358	26580016	26580898	882
EUR_178	20000	EUR	358	29347606	29396432	48826
EUR_178	20000	EUR	358	30984604	31034898	50294
EUR_178	20000	EUR	358	31113073	31133912	20839
EUR_178	20000	EUR	358	39880113	39885637	5524
EUR_178	20000	EUR	358	43359651	43453960	94309
EUR_178	20000	EUR	358	53821064	54033707	212643
EUR_178	20000	EUR	358	54174611	54177383	2772
EUR_178	20000	EUR	358	73115427	73223816	108389
EUR_178	20000	EUR	358	79824188	79933512	109324
EUR_178	20000	EUR	358	80954431	81229503	275072
EUR_178	20000	EUR	358	87512858	87623148	110290
EUR_178	20000	EUR	358	90103571	90243516	139945
EUR_178	20000	EUR	358	94239181	94337048	97867
EUR_178	20000	EUR	358	94348955	94544971	196016
EUR_178	20000	EUR	358	95774147	95834476	60329
EUR_178	20000	EUR	358	96264202	96346551	82349
EUR_178	20000	EUR	359	1254195	1329694	75499
EUR_178	20000	EUR	359	1945682	1964815	19133
EUR_178	20000	EUR	359	2984450	2997995	13545
EUR_178	20000	EUR	359	13076756	13178737	101981
EUR_178	20000	EUR	359	16243211	16340023	96812
EUR_178	20000	EUR	359	17333821	17397614	63793
EUR_178	20000	EUR	359	20981647	21202559	220912
EUR_178	20000	EUR	359	24372241	24581630	209389
EUR_178	20000	EUR	359	25817587	25840674	23087
EUR_178	20000	EUR	359	25971191	25987107	15916
EUR_178	20000	EUR	359	29321833	29396318	74485
EUR_178	20000	EUR	359	32824940	32871485	46545
EUR_178	20000	EUR	359	33126757	33166924	40167
EUR_178	20000	EUR	359	34845302	34926785	81483
EUR_178	20000	EUR	359	43520906	43653793	132887
EUR_178	20000	EUR	359	49714605	49899094	184489
EUR_178	20000	EUR	359	52572348	52662927	90579
EUR_178	20000	EUR	359	54714203	54797940	83737
EUR_178	20000	EUR	359	59650996	59762964	111968
EUR_178	20000	EUR	359	72288615	72398733	110118
EUR_178	20000	EUR	359	75110846	75189189	78343
EUR_178	20000	EUR	359	84755692	84919115	163423
EUR_178	20000	EUR	359	88398106	88559442	161336
EUR_178	20000	EUR	359	88751576	88762816	11240
EUR_178	20000	EUR	359	88905852	88975974	70122
EUR_178	20000	EUR	359	89608053	89635604	27551
EUR_178	20000	EUR	359	90308521	90558518	249997
EUR_178	20000	EUR	359	93123848	93146996	23148
EUR_179	20000	EUR	360	3890786	4134871	244085
EUR_179	20000	EUR	360	21224963	21225412	449
EUR_179	20000	EUR	360	22519633	22533171	13538
EUR_179	20000	EUR	360	24749954	24757234	7280
EUR_179	20000	EUR	360	25323974	25378298	54324
EUR_179	20000	EUR	360	26375604	26436121	60517
EUR_179	20000	EUR	360	28645700	28746647	100947
EUR_179	20000	EUR	360	31113073	31114919	1846
EUR_179	20000	EUR	360	32855612	32870350	14738
EUR_179	20000	EUR	360	33007991	33062946	54955
EUR_179	20000	EUR	360	35001631	35019786	18155
EUR_179	20000	EUR	360	37705403	37817231	111828
EUR_179	20000	EUR	360	54210230	54365408	155178
EUR_179	20000	EUR	360	63714218	63732455	18237
EUR_179	20000	EUR	360	69023918	69060887	36969
EUR_179	20000	EUR	360	72226457	72297712	71255
EUR_179	20000	EUR	360	72961212	73122070	160858
EUR_179	20000	EUR	360	74032464	74094072	61608
EUR_179	20000	EUR	360	87625743	87858554	232811
EUR_179	20000	EUR	360	88087834	88319207	231373
EUR_179	20000	EUR	360	88761110	88877947	116837
EUR_179	20000	EUR	360	91987726	92171686	183960
EUR_179	20000	EUR	360	94229098	94249460	20362
EUR_179	20000	EUR	361	11622387	11762288	139901
EUR_179	20000	EUR	361	23120612	23126894	6282
EUR_179	20000	EUR	361	24530207	24581630	51423
EUR_179	20000	EUR	361	25183341	25237709	54368
EUR_179	20000	EUR	361	25323974	25378298	54324
EUR_179	20000	EUR	361	25817587	25829923	12336
EUR_179	20000	EUR	361	27894016	27894364	348
EUR_179	20000	EUR	361	32767881	32837729	69848
EUR_179	20000	EUR	361	37722669	38097333	374664
EUR_179	20000	EUR	361	41319133	41360462	41329
EUR_179	20000	EUR	361	53875418	53951058	75640
EUR_179	20000	EUR	361	59578454	59745811	167357
EUR_179	20000	EUR	361	64803473	64820966	17493
EUR_179	20000	EUR	361	73136973	73172795	35822
EUR_179	20000	EUR	361	73498527	73660589	162062
EUR_179	20000	EUR	361	74581736	74699907	118171
EUR_179	20000	EUR	361	75243054	75265596	22542
EUR_179	20000	EUR	361	75587305	75641163	53858
EUR_179	20000	EUR	361	77733985	77735979	1994
EUR_179	20000	EUR	361	79901897	79903521	1624
EUR_179	20000	EUR	361	81130135	81229503	99368
EUR_179	20000	EUR	361	83533777	83550130	16353
EUR_179	20000	EUR	361	84788675	84792787	4112
EUR_179	20000	EUR	361	90972791	91089410	116619
EUR_179	20000	EUR	361	92065436	92171686	106250
EUR_179	20000	EUR	361	93553045	93685892	132847
EUR_179	20000	EUR	361	95829965	95927099	97134
EUR_179	20000	EUR	361	96254221	96352723	98502
EUR_180	20000	EUR	362	18677221	18844474	167253
EUR_180	20000	EUR	362	21093849	21171638	77789
EUR_180	20000	EUR	362	21200799	21274841	74042
EUR_180	20000	EUR	362	23176150	23184805	8655
EUR_180	20000	EUR	362	23992534	24094707	102173
EUR_180	20000	EUR	362	25189085	25217171	28086
EUR_180	20000	EUR	362	25323974	25378298	54324
EUR_180	20000	EUR	362	26319359	26436121	116762
EUR_180	20000	EUR	362	29321833	29396318	74485
EUR_180	20000	EUR	362	30904434	31092945	188511
EUR_180	20000	EUR	362	32694491	32748960	54469
EUR_180	20000	EUR	362	33126757	33151809	25052
EUR_180	20000	EUR	362	39858032	39985028	126996
EUR_180	20000	EUR	362	40410992	40602505	191513
EUR_180	20000	EUR	362	43359651	43471816	112165
EUR_180	20000	EUR	362	53821064	53872495	51431
EUR_180	20000	EUR	362	54113043	54177383	64340
EUR_180	20000	EUR	362	58863206	58863428	222
EUR_180	20000	EUR	362	59423469	59522281	98812
EUR_180	20000	EUR	362	69023918	69060887	36969
EUR_180	20000	EUR	362	72961212	73172795	211583
EUR_180	20000	EUR	362	74410856	74438736	27880
EUR_180	20000	EUR	362	75110846	75189189	78343
EUR_180	20000	EUR	362	76137655	76143984	6329
EUR_180	20000	EUR	362	78831605	78886366	54761
EUR_180	20000	EUR	362	79086226	79134588	48362
EUR_180	20000	EUR	362	84755692	84919115	163423
EUR_180	20000	EUR	362	87720969	87903841	182872
EUR_180	20000	EUR	362	88395997	88419767	23770
EUR_180	20000	EUR	362	89200642	89235318	34676
EUR_180	20000	EUR	362	94447447	94522438	74991
EUR_180	20000	EUR	362	94527644	94559172	31528
EUR_180	20000	EUR	362	95774147	95844558	70411
EUR_180	20000	EUR	362	96229638	96241778	12140
EUR_180	20000	EUR	363	1229602	1329694	100092
EUR_180	20000	EUR	363	1924080	2022517	98437
EUR_180	20000	EUR	363	2625406	2648737	23331
EUR_180	20000	EUR	363	2913315	2963147	49832
EUR_180	20000	EUR	363	9321331	9449917	128586
EUR_180	20000	EUR	363	16234928	16286721	51793
EUR_180	20000	EUR	363	18081536	18107085	25549
EUR_180	20000	EUR	363	18727927	18806641	78714
EUR_180	20000	EUR	363	24621120	24666053	44933
EUR_180	20000	EUR	363	24892444	24906091	13647
EUR_180	20000	EUR	363	31256008	31265547	9539
EUR_180	20000	EUR	363	32057270	32141896	84626
EUR_180	20000	EUR	363	32667412	32870350	202938
EUR_180	20000	EUR	363	33126757	33151809	25052
EUR_180	20000	EUR	363	35887157	35892995	5838
EUR_180	20000	EUR	363	40410992	40602505	191513
EUR_180	20000	EUR	363	40861764	41134712	272948
EUR_180	20000	EUR	363	54113043	54177383	64340
EUR_180	20000	EUR	363	58949043	58995262	46219
EUR_180	20000	EUR	363	73745706	73809533	63827
EUR_180	20000	EUR	363	74871541	74894548	23007
EUR_180	20000	EUR	363	76623190	76640074	16884
EUR_180	20000	EUR	363	80863277	80994321	131044
EUR_180	20000	EUR	363	84755692	84919115	163423
EUR_180	20000	EUR	363	88077880	88172209	94329
EUR_180	20000	EUR	363	91541076	91672576	131500
EUR_180	20000	EUR	363	93331071	93411339	80268
EUR_180	20000	EUR	363	93943380	94056780	113400
EUR_180	20000	EUR	363	94297447	94418018	120571
EUR_180	20000	EUR	363	94419260	94544971	125711
EUR_180	20000	EUR	363	95774147	95792644	18497
EUR_181	20000	EUR	364	4020191	4044195	24004
EUR_181	20000	EUR	364	7287218	7395677	108459
EUR_181	20000	EUR	364	24531164	24581630	50466
EUR_181	20000	EUR	364	29291099	29311528	20429
EUR_181	20000	EUR	364	35624807	35825375	200568
EUR_181	20000	EUR	364	37722669	38097333	374664
EUR_181	20000	EUR	364	42473584	42574352	100768
EUR_181	20000	EUR	364	54403505	54904011	500506
EUR_181	20000	EUR	364	73745706	73809533	63827
EUR_181	20000	EUR	364	74871541	74894548	23007
EUR_181	20000	EUR	364	76623190	76640074	16884
EUR_181	20000	EUR	364	80863277	80994321	131044
EUR_181	20000	EUR	364	84755692	84919115	163423
EUR_181	20000	EUR	364	88077880	88172209	94329
EUR_181	20000	EUR	364	88925448	88988477	63029
EUR_181	20000	EUR	364	89325873	89337206	11333
EUR_181	20000	EUR	364	89356470	89508341	151871
EUR_181	20000	EUR	364	91645289	91678723	33434
EUR_181	20000	EUR	364	94793518	94818871	25353
EUR_181	20000	EUR	364	95857931	95880389	22458
EUR_181	20000	EUR	364	96264202	96346551	82349
EUR_181	20000	EUR	365	375401	411145	35744
EUR_181	20000	EUR	365	3763591	3801794	38203
EUR_181	20000	EUR	365	10399704	10402156	2452
EUR_181	20000	EUR	365	14051019	14112508	61489
EUR_181	20000	EUR	365	16282164	16325554	43390
EUR_181	20000	EUR	365	21246127	21282925	36798
EUR_181	20000	EUR	365	24076703	24094707	18004
EUR_181	20000	EUR	365	29306591	29339651	33060
EUR_181	20000	EUR	365	29357693	29365834	8141
EUR_181	20000	EUR	365	32848174	32893781	45607
EUR_181	20000	EUR	365	35624807	35825375	200568
EUR_181	20000	EUR	365	37727611	37762850	35239
EUR_181	20000	EUR	365	39957500	39960153	2653
EUR_181	20000	EUR	365	41161176	41182266	21090
EUR_181	20000	EUR	365	50093106	50097389	4283
EUR_181	20000	EUR	365	54799832	54904011	104179
EUR_181	20000	EUR	365	57136159	57145192	9033
EUR_181	20000	EUR	365	59554189	59607931	53742
EUR_181	20000	EUR	365	73745706	73906350	160644
EUR_181	20000	EUR	365	75592795	75632489	39694
EUR_181	20000	EUR	365	76759679	76772995	13316
EUR_181	20000	EUR	365	76910764	76912593	1829
EUR_181	20000	EUR	365	80161288	80278256	116968
EUR_181	20000	EUR	365	80874989	81229503	354514
EUR_181	20000	EUR	365	87075746	87120548	44802
EUR_181	20000	EUR	365	87653008	87713350	60342
EUR_181	20000	EUR	365	88093541	88161538	67997
EUR_181	20000	EUR	365	88761110	88877947	116837
EUR_181	20000	EUR	365	91997868	92013641	15773
EUR_181	20000	EUR	365	94447447	94522438	74991
EUR_181	20000	EUR	365	95376413	95445533	69120
EUR_182	20000	EUR	366	12764351	12847009	82658
EUR_182	20000	EUR	366	17687142	17984110	296968
EUR_182	20000	EUR	366	26375604	26436121	60517
EUR_182	20000	EUR	366	29321833	29396318	74485
EUR_182	20000	EUR	366	35001631	35019786	18155
EUR_182	20000	EUR	366	35771774	35892995	121221
EUR_182	20000	EUR	366	37727611	37762850	35239
EUR_182	20000	EUR	366	40047500	40068128	20628
EUR_182	20000	EUR	366	42164278	42208086	43808
EUR_182	20000	EUR	366	42492857	42594504	101647
EUR_182	20000	EUR	366	43359651	43376413	16762
EUR_182	20000	EUR	366	50031962	50246703	214741
EUR_182	20000	EUR	366	53821064	53872495	51431
EUR_182	20000	EUR	366	57181563	57291065	109502
EUR_182	20000	EUR	366	63714218	63732455	18237
EUR_182	20000	EUR	366	69023918	69060887	36969
EUR_182	20000	EUR	366	73115427	73172558	57131
EUR_182	20000	EUR	366	74595799	74699907	104108
EUR_182	20000	EUR	366	75522893	75632489	109596
EUR_182	20000	EUR	366	76139818	76143984	4166
EUR_182	20000	EUR	366	79917607	79933512	15905
EUR_182	20000	EUR	366	80161288	80234873	73585
EUR_182	20000	EUR	366	84755692	84812496	56804
EUR_182	20000	EUR	366	88077880	88172209	94329
EUR_182	20000	EUR	366	88212981	88713784	500803
EUR_182	20000	EUR	366	89126730	89235318	108588
EUR_182	20000	EUR	366	89396010	89508341	112331
EUR_182	20000	EUR	366	94523809	94559172	35363
EUR_182	20000	EUR	367	7387181	7395677	8496
EUR_182	20000	EUR	367	8651970	8689000	37030
EUR_182	20000	EUR	367	11703759	11708397	4638
EUR_182	20000	EUR	367	16243211	16432918	189707
EUR_182	20000	EUR	367	18319962	18357509	37547
EUR_182	20000	EUR	367	18622886	18636940	14054
EUR_182	20000	EUR	367	23752602	23877108	124506
EUR_182	20000	EUR	367	24892444	24906091	13647
EUR_182	20000	EUR	367	25181442	25305885	124443
EUR_182	20000	EUR	367	25847649	25855304	7655
EUR_182	20000	EUR	367	26375604	26436121	60517
EUR_182	20000	EUR	367	26580016	26580898	882
EUR_182	20000	EUR	367	27933038	27974945	41907
EUR_182	20000	EUR	367	37722669	38097333	374664
EUR_182	20000	EUR	367	42793149	42823699	30550
EUR_182	20000	EUR	367	49702405	49853573	151168
EUR_182	20000	EUR	367	54113043	54177383	64340
EUR_182	20000	EUR	367	58093392	58136140	42748
EUR_182	20000	EUR	367	59686990	59762964	75974
EUR_182	20000	EUR	367	71708596	71764001	55405
EUR_182	20000	EUR	367	75851931	75864018	12087
EUR_182	20000	EUR	367	76759679	76869710	110031
EUR_182	20000	EUR	367	76921572	77067204	145632
EUR_182	20000	EUR	367	77800262	77885640	85378
EUR_182	20000	EUR	367	80179758	80278256	98498
EUR_182	20000	EUR	367	83886982	83921060	34078
EUR_182	20000	EUR	367	87512858	87623148	110290
EUR_182	20000	EUR	367	91976671	92000571	23900
EUR_182	20000	EUR	367	93947223	94317758	370535
EUR_182	20000	EUR	367	94447394	94544971	97577
EUR_182	20000	EUR	367	96116814	96220219	103405
EUR_183	20000	EUR	368	2519034	2648737	129703
EUR_183	20000	EUR	368	2892955	2905042	12087
EUR_183	20000	EUR	368	4020191	4044195	24004
EUR_183	20000	EUR	368	17333821	17369300	35479
EUR_183	20000	EUR	368	21093849	21390474	296625
EUR_183	20000	EUR	368	23148716	23184805	36089
EUR_183	20000	EUR	368	24892444	24906091	13647
EUR_183	20000	EUR	368	25066876	25088413	21537
EUR_183	20000	EUR	368	25189085	25231890	42805
EUR_183	20000	EUR	368	25817587	25896396	78809
EUR_183	20000	EUR	368	26477051	26517340	40289
EUR_183	20000	EUR	368	27746608	27800312	53704
EUR_183	20000	EUR	368	29306591	29579668	273077
EUR_183	20000	EUR	368	31551025	31593163	42138
EUR_183	20000	EUR	368	33445186	33479750	34564
EUR_183	20000	EUR	368	35811062	35849669	38607
EUR_183	20000	EUR	368	39858032	39935390	77358
EUR_183	20000	EUR	368	40410992	40602505	191513
EUR_183	20000	EUR	368	54221599	54407949	186350
EUR_183	20000	EUR	368	58093392	58136140	42748
EUR_183	20000	EUR	368	59686990	59762964	75974
EUR_183	20000	EUR	368	63714218	63732455	18237
EUR_183	20000	EUR	368	64321831	64406792	84961
EUR_183	20000	EUR	368	74871541	74894548	23007
EUR_183	20000	EUR	368	75110846	75189189	78343
EUR_183	20000	EUR	368	76022322	76128798	106476
EUR_183	20000	EUR	368	76365488	76370460	4972
EUR_183	20000	EUR	368	79901897	79936163	34266
EUR_183	20000	EUR	368	85388857	85405856	16999
EUR_183	20000	EUR	368	87969149	87994899	25750
EUR_183	20000	EUR	368	88077880	88113143	35263
EUR_183	20000	EUR	368	88405406	88464514	59108
EUR_183	20000	EUR	368	88476761	88537179	60418
EUR_183	20000	EUR	368	89180086	89235318	55232
EUR_183	20000	EUR	368	89997508	90008065	10557
EUR_183	20000	EUR	368	94290726	94412962	122236
EUR_183	20000	EUR	368	94535576	94544971	9395
EUR_183	20000	EUR	368	94805865	94819760	13895
EUR_183	20000	EUR	368	95323015	95353984	30969
EUR_183	20000	EUR	369	3890786	3978709	87923
EUR_183	20000	EUR	369	4020191	4044195	24004
EUR_183	20000	EUR	369	8651970	8714283	62313
EUR_183	20000	EUR	369	9413335	9449917	36582
EUR_183	20000	EUR	369	10399704	10402156	2452
EUR_183	20000	EUR	369	22918884	22976183	57299
EUR_183	20000	EUR	369	23165262	23267376	102114
EUR_183	20000	EUR	369	23564194	23651476	87282
EUR_183	20000	EUR	369	24892444	24906091	13647
EUR_183	20000	EUR	369	26466628	26580898	114270
EUR_183	20000	EUR	369	28087103	28139866	52763
EUR_183	20000	EUR	369	29273800	29300000	26200
EUR_183	20000	EUR	369	30889388	31034898	145510
EUR_183	20000	EUR	369	31113073	31133912	20839
EUR_183	20000	EUR	369	32767431	32880042	112611
EUR_183	20000	EUR	369	37722669	38097333	374664
EUR_183	20000	EUR	369	42792406	42823699	31293
EUR_183	20000	EUR	369	57857678	57861351	3673
EUR_183	20000	EUR	369	59554189	59607931	53742
EUR_183	20000	EUR	369	64338347	64519080	180733
EUR_183	20000	EUR	369	71433365	71457991	24626
EUR_183	20000	EUR	369	76780192	76869710	89518
EUR_183	20000	EUR	369	76921572	76988269	66697
EUR_183	20000	EUR	369	77733985	77735979	1994
EUR_183	20000	EUR	369	87547254	87656802	109548
EUR_183	20000	EUR	369	87727929	87727993	64
EUR_183	20000	EUR	369	88106369	88172209	65840
EUR_183	20000	EUR	369	88737656	88762816	25160
EUR_183	20000	EUR	369	91025410	91107582	82172
EUR_183	20000	EUR	369	93721614	93725532	3918
EUR_183	20000	EUR	369	93891415	93905248	13833
EUR_183	20000	EUR	369	94239181	94337048	97867
EUR_183	20000	EUR	369	94348955	94544971	196016
EUR_183	20000	EUR	369	94898715	94930362	31647
EUR_183	20000	EUR	369	99165891	99280798	114907
EUR_184	20000	EUR	370	1927314	1946512	19198
EUR_184	20000	EUR	370	9321331	9449917	128586
EUR_184	20000	EUR	370	13574314	13635433	61119
EUR_184	20000	EUR	370	13640984	13678187	37203
EUR_184	20000	EUR	370	16243211	16437214	194003
EUR_184	20000	EUR	370	17350938	17365688	14750
EUR_184	20000	EUR	370	18100331	18140078	39747
EUR_184	20000	EUR	370	23766790	23877108	110318
EUR_184	20000	EUR	370	24372241	24484665	112424
EUR_184	20000	EUR	370	24892444	24906091	13647
EUR_184	20000	EUR	370	25336091	25347092	11001
EUR_184	20000	EUR	370	25868315	25896396	28081
EUR_184	20000	EUR	370	26319359	26409483	90124
EUR_184	20000	EUR	370	27746608	27800312	53704
EUR_184	20000	EUR	370	29306591	29579668	273077
EUR_184	20000	EUR	370	35576182	35584922	8740
EUR_184	20000	EUR	370	39652652	39692065	39413
EUR_184	20000	EUR	370	39907281	40049904	142623
EUR_184	20000	EUR	370	42369514	42562539	193025
EUR_184	20000	EUR	370	53821064	54070402	249338
EUR_184	20000	EUR	370	58580135	58694180	114045
EUR_184	20000	EUR	370	71544591	71629966	85375
EUR_184	20000	EUR	370	73145730	73223816	78086
EUR_184	20000	EUR	370	76780192	76869710	89518
EUR_184	20000	EUR	370	76921572	76988269	66697
EUR_184	20000	EUR	370	77611155	77735858	124703
EUR_184	20000	EUR	370	80275303	80278256	2953
EUR_184	20000	EUR	370	81031954	81036282	4328
EUR_184	20000	EUR	370	88087834	88679238	591404
EUR_184	20000	EUR	370	88761110	88877947	116837
EUR_184	20000	EUR	370	90153261	90157462	4201
EUR_184	20000	EUR	370	91891040	91902611	11571
EUR_184	20000	EUR	370	91976671	92000571	23900
EUR_184	20000	EUR	370	94290726	94412962	122236
EUR_184	20000	EUR	370	94535576	94544971	9395
EUR_184	20000	EUR	370	94805865	94819760	13895
EUR_184	20000	EUR	370	95323015	95353984	30969
EUR_184	20000	EUR	370	95774147	95778109	3962
EUR_184	20000	EUR	370	96116814	96337375	220561
EUR_184	20000	EUR	371	3890786	3978709	87923
EUR_184	20000	EUR	371	4020191	4044195	24004
EUR_184	20000	EUR	371	16243211	16437214	194003
EUR_184	20000	EUR	371	17879034	17953987	74953
EUR_184	20000	EUR	371	18100331	18140078	39747
EUR_184	20000	EUR	371	22454245	22540410	86165
EUR_184	20000	EUR	371	23584099	23767868	183769
EUR_184	20000	EUR	371	32767881	32837729	69848
EUR_184	20000	EUR	371	41304381	41393058	88677
EUR_184	20000	EUR	371	54113043	54177383	64340
EUR_184	20000	EUR	371	71433365	71457991	24626
EUR_184	20000	EUR	371	72961212	73172795	211583
EUR_184	20000	EUR	371	74019705	74094072	74367
EUR_184	20000	EUR	371	74871541	74894548	23007
EUR_184	20000	EUR	371	78846360	78865177	18817
EUR_184	20000	EUR	371	81113251	81229503	116252
EUR_184	20000	EUR	371	88395997	88419767	23770
EUR_184	20000	EUR	371	91049817	91107582	57765
EUR_184	20000	EUR	371	94210771	94222927	12156
EUR_184	20000	EUR	371	95774147	95778109	3962
EUR_184	20000	EUR	371	96136238	96175807	39569
EUR_184	20000	EUR	371	96379020	96438545	59525
EUR_185	20000	EUR	372	1209400	1328946	119546
EUR_185	20000	EUR	372	3963309	4029447	66138
EUR_185	20000	EUR	372	12764351	12785371	21020
EUR_185	20000	EUR	372	13621609	13626532	4923
EUR_185	20000	EUR	372	16615459	16681323	65864
EUR_185	20000	EUR	372	17687142	17689297	2155
EUR_185	20000	EUR	372	23176150	23183923	7773
EUR_185	20000	EUR	372	24892444	24906091	13647
EUR_185	20000	EUR	372	30904434	30925177	20743
EUR_185	20000	EUR	372	31440500	31636518	196018
EUR_185	20000	EUR	372	32262916	32267787	4871
EUR_185	20000	EUR	372	32730368	32759145	28777
EUR_185	20000	EUR	372	35001631	35087281	85650
EUR_185	20000	EUR	372	37754246	38097333	343087
EUR_185	20000	EUR	372	42473584	42545802	72218
EUR_185	20000	EUR	372	54748754	54903746	154992
EUR_185	20000	EUR	372	59423469	59522281	98812
EUR_185	20000	EUR	372	59525840	59631623	105783
EUR_185	20000	EUR	372	64321831	64406792	84961
EUR_185	20000	EUR	372	72359726	72373817	14091
EUR_185	20000	EUR	372	74871541	74894548	23007
EUR_185	20000	EUR	372	78816419	79134588	318169
EUR_185	20000	EUR	372	84235412	84254246	18834
EUR_185	20000	EUR	372	84755692	84810053	54361
EUR_185	20000	EUR	372	91025410	91107582	82172
EUR_185	20000	EUR	372	95270807	95397323	126516
EUR_185	20000	EUR	372	95829965	95887608	57643
EUR_185	20000	EUR	373	1004770	1079953	75183
EUR_185	20000	EUR	373	2415974	2620243	204269
EUR_185	20000	EUR	373	2984450	3003090	18640
EUR_185	20000	EUR	373	8783056	8932393	149337
EUR_185	20000	EUR	373	13076756	13178737	101981
EUR_185	20000	EUR	373	16243211	16402432	159221
EUR_185	20000	EUR	373	23648833	23651476	2643
EUR_185	20000	EUR	373	24892444	24906091	13647
EUR_185	20000	EUR	373	25162449	25162865	416
EUR_185	20000	EUR	373	25189085	25217171	28086
EUR_185	20000	EUR	373	25323974	25378298	54324
EUR_185	20000	EUR	373	25817587	25896396	78809
EUR_185	20000	EUR	373	27746608	27974945	228337
EUR_185	20000	EUR	373	28111916	28139866	27950
EUR_185	20000	EUR	373	32855612	32870350	14738
EUR_185	20000	EUR	373	33007991	33281653	273662
EUR_185	20000	EUR	373	37722669	38097333	374664
EUR_185	20000	EUR	373	41104969	41393058	288089
EUR_185	20000	EUR	373	42792406	42823699	31293
EUR_185	20000	EUR	373	52168283	52388833	220550
EUR_185	20000	EUR	373	53821064	53859932	38868
EUR_185	20000	EUR	373	54632404	54794755	162351
EUR_185	20000	EUR	373	59650996	59762964	111968
EUR_185	20000	EUR	373	71544591	71629966	85375
EUR_185	20000	EUR	373	73145730	73223816	78086
EUR_185	20000	EUR	373	77636100	77751872	115772
EUR_185	20000	EUR	373	80520393	80530144	9751
EUR_185	20000	EUR	373	80863277	80899276	35999
EUR_185	20000	EUR	373	88087834	88319207	231373
EUR_185	20000	EUR	373	88527647	88551173	23526
EUR_185	20000	EUR	373	88796237	89010522	214285
EUR_186	20000	EUR	374	2415974	2702115	286141
EUR_186	20000	EUR	374	5121074	5123781	2707
EUR_186	20000	EUR	374	16243211	16320847	77636
EUR_186	20000	EUR	374	18271487	18296696	25209
EUR_186	20000	EUR	374	22447027	22462305	15278
EUR_186	20000	EUR	374	23120612	23126894	6282
EUR_186	20000	EUR	374	25343770	25501390	157620
EUR_186	20000	EUR	374	25953989	25987107	33118
EUR_186	20000	EUR	374	29306591	29365834	59243
EUR_186	20000	EUR	374	32694491	32701120	6629
EUR_186	20000	EUR	374	32824940	32859170	34230
EUR_186	20000	EUR	374	33167789	33295884	128095
EUR_186	20000	EUR	374	36284487	36460007	175520
EUR_186	20000	EUR	374	43359651	43475760	116109
EUR_186	20000	EUR	374	54653171	54730663	77492
EUR_186	20000	EUR	374	54893690	54904011	10321
EUR_186	20000	EUR	374	56447306	56448072	766
EUR_186	20000	EUR	374	57857678	57861351	3673
EUR_186	20000	EUR	374	80863277	80899276	35999
EUR_186	20000	EUR	374	80946931	81087964	141033
EUR_186	20000	EUR	374	81088612	81190655	102043
EUR_186	20000	EUR	374	84788675	84792787	4112
EUR_186	20000	EUR	374	87512858	87622177	109319
EUR_186	20000	EUR	374	88405406	88464514	59108
EUR_186	20000	EUR	374	88476761	88537179	60418
EUR_186	20000	EUR	374	88870230	88877947	7717
EUR_186	20000	EUR	374	89989980	89998439	8459
EUR_186	20000	EUR	374	93218393	93264500	46107
EUR_186	20000	EUR	374	93981861	93992465	10604
EUR_186	20000	EUR	374	94290726	94412962	122236
EUR_186	20000	EUR	374	94898715	94930362	31647
EUR_186	20000	EUR	374	96116814	96246402	129588
EUR_186	20000	EUR	374	99165891	99280798	114907
EUR_186	20000	EUR	375	1927314	1946512	19198
EUR_186	20000	EUR	375	2519034	2648737	129703
EUR_186	20000	EUR	375	8749037	8780869	31832
EUR_186	20000	EUR	375	11532006	11542173	10167
EUR_186	20000	EUR	375	14051019	14112508	61489
EUR_186	20000	EUR	375	16080883	16095779	14896
EUR_186	20000	EUR	375	18081536	18098112	16576
EUR_186	20000	EUR	375	24892444	24906091	13647
EUR_186	20000	EUR	375	25066876	25088413	21537
EUR_186	20000	EUR	375	25264173	25276538	12365
EUR_186	20000	EUR	375	27746608	27834359	87751
EUR_186	20000	EUR	375	28087103	28110553	23450
EUR_186	20000	EUR	375	29357693	29365834	8141
EUR_186	20000	EUR	375	32057270	32124528	67258
EUR_186	20000	EUR	375	34124908	34182116	57208
EUR_186	20000	EUR	375	37808828	37943125	134297
EUR_186	20000	EUR	375	39639568	39696725	57157
EUR_186	20000	EUR	375	39821749	40145306	323557
EUR_186	20000	EUR	375	40410992	40602505	191513
EUR_186	20000	EUR	375	52626149	52638142	11993
EUR_186	20000	EUR	375	54403505	54904011	500506
EUR_186	20000	EUR	375	57149895	57261193	111298
EUR_186	20000	EUR	375	59436810	59522281	85471
EUR_186	20000	EUR	375	69023918	69082650	58732
EUR_186	20000	EUR	375	73167201	73172795	5594
EUR_186	20000	EUR	375	75263541	75282527	18986
EUR_186	20000	EUR	375	80874989	81229503	354514
EUR_186	20000	EUR	375	88106369	88172209	65840
EUR_186	20000	EUR	375	88398783	88553171	154388
EUR_186	20000	EUR	375	89989980	89998439	8459
EUR_186	20000	EUR	375	91976671	92000571	23900
EUR_186	20000	EUR	375	93981861	94126740	144879
EUR_186	20000	EUR	375	94793518	95112420	318902
EUR_186	20000	EUR	375	95880924	95927099	46175
EUR_186	20000	EUR	375	99177558	99280798	103240
EUR_187	20000	EUR	376	1762556	1830270	67714
EUR_187	20000	EUR	376	17333821	17360068	26247
EUR_187	20000	EUR	376	18310807	18368143	57336
EUR_187	20000	EUR	376	21113467	21282925	169458
EUR_187	20000	EUR	376	22447027	22516689	69662
EUR_187	20000	EUR	376	23120612	23184805	64193
EUR_187	20000	EUR	376	25264173	25276538	12365
EUR_187	20000	EUR	376	25817587	25840674	23087
EUR_187	20000	EUR	376	25971191	25987107	15916
EUR_187	20000	EUR	376	29321833	29396318	74485
EUR_187	20000	EUR	376	31102544	31244622	142078
EUR_187	20000	EUR	376	32262916	32267787	4871
EUR_187	20000	EUR	376	32848174	32870870	22696
EUR_187	20000	EUR	376	33430359	33479750	49391
EUR_187	20000	EUR	376	35084593	35087281	2688
EUR_187	20000	EUR	376	35424505	35627884	203379
EUR_187	20000	EUR	376	36284487	36357016	72529
EUR_187	20000	EUR	376	36660352	36714961	54609
EUR_187	20000	EUR	376	39858032	39985028	126996
EUR_187	20000	EUR	376	40410992	40602505	191513
EUR_187	20000	EUR	376	53821064	54035252	214188
EUR_187	20000	EUR	376	54686744	54714097	27353
EUR_187	20000	EUR	376	59436810	59522281	85471
EUR_187	20000	EUR	376	77606973	77700470	93497
EUR_187	20000	EUR	376	83933477	83957574	24097
EUR_187	20000	EUR	376	85353810	85405856	52046
EUR_187	20000	EUR	376	87504329	87507341	3012
EUR_187	20000	EUR	376	88077880	88172209	94329
EUR_187	20000	EUR	376	88797692	88812922	15230
EUR_187	20000	EUR	376	91847626	91875197	27571
EUR_187	20000	EUR	376	94126349	94222927	96578
EUR_187	20000	EUR	376	94447447	94522438	74991
EUR_187	20000	EUR	376	94915497	94925699	10202
EUR_187	20000	EUR	376	95774147	95774999	852
EUR_187	20000	EUR	376	96229638	96241778	12140
EUR_187	20000	EUR	377	2415974	2596238	180264
EUR_187	20000	EUR	377	2984450	2997995	13545
EUR_187	20000	EUR	377	5257656	5276460	18804
EUR_187	20000	EUR	377	8783056	8932393	149337
EUR_187	20000	EUR	377	11622387	11762288	139901
EUR_187	20000	EUR	377	13047963	13067431	19468
EUR_187	20000	EUR	377	13574314	13635433	61119
EUR_187	20000	EUR	377	13640984	13678187	37203
EUR_187	20000	EUR	377	21194944	21271328	76384
EUR_187	20000	EUR	377	25741256	25777999	36743
EUR_187	20000	EUR	377	26375604	26429831	54227
EUR_187	20000	EUR	377	29273800	29311528	37728
EUR_187	20000	EUR	377	31842746	31866371	23625
EUR_187	20000	EUR	377	35281602	35413025	131423
EUR_187	20000	EUR	377	43444654	43453960	9306
EUR_187	20000	EUR	377	59674842	59700527	25685
EUR_187	20000	EUR	377	63714218	63803837	89619
EUR_187	20000	EUR	377	72961212	73172795	211583
EUR_187	20000	EUR	377	73488506	73493479	4973
EUR_187	20000	EUR	377	74102364	74212177	109813
EUR_187	20000	EUR	377	74640712	74738891	98179
EUR_187	20000	EUR	377	77606973	77700470	93497
EUR_187	20000	EUR	377	84874734	84919115	44381
EUR_187	20000	EUR	377	87685728	87751923	66195
EUR_187	20000	EUR	377	88662416	88679238	16822
EUR_187	20000	EUR	377	88761110	89050718	289608
EUR_187	20000	EUR	377	89989980	89998439	8459
EUR_187	20000	EUR	377	93123848	93146996	23148
EUR_187	20000	EUR	377	94362487	94382190	19703
EUR_187	20000	EUR	377	99177558	99280798	103240
EUR_188	20000	EUR	378	1735950	2022517	286567
EUR_188	20000	EUR	378	4020191	4044195	24004
EUR_188	20000	EUR	378	8348919	8386102	37183
EUR_188	20000	EUR	378	12764351	12785371	21020
EUR_188	20000	EUR	378	13574314	13635433	61119
EUR_188	20000	EUR	378	13640984	13678187	37203
EUR_188	20000	EUR	378	16397154	16454511	57357
EUR_188	20000	EUR	378	17333821	17369300	35479
EUR_188	20000	EUR	378	18081536	18107085	25549
EUR_188	20000	EUR	378	18622886	18636940	14054
EUR_188	20000	EUR	378	21150173	21156082	5909
EUR_188	20000	EUR	378	21200799	21216283	15484
EUR_188	20000	EUR	378	24621120	24737906	116786
EUR_188	20000	EUR	378	26375604	26436121	60517
EUR_188	20000	EUR	378	26886230	26991485	105255
EUR_188	20000	EUR	378	33271998	33295884	23886
EUR_188	20000	EUR	378	33326865	33429152	102287
EUR_188	20000	EUR	378	35486962	35693478	206516
EUR_188	20000	EUR	378	35699524	35892995	193471
EUR_188	20000	EUR	378	36050639	36089268	38629
EUR_188	20000	EUR	378	42430229	42468277	38048
EUR_188	20000	EUR	378	54113043	54177383	64340
EUR_188	20000	EUR	378	59680988	59700527	19539
EUR_188	20000	EUR	378	71544591	71563119	18528
EUR_188	20000	EUR	378	73488506	73574713	86207
EUR_188	20000	EUR	378	75851931	75915063	63132
EUR_188	20000	EUR	378	76370265	76397099	26834
EUR_188	20000	EUR	378	76849157	77070477	221320
EUR_188	20000	EUR	378	78816419	78823786	7367
EUR_188	20000	EUR	378	81082281	81162369	80088
EUR_188	20000	EUR	378	90160978	90243516	82538
EUR_188	20000	EUR	378	94241722	94325814	84092
EUR_188	20000	EUR	378	94347548	94418018	70470
EUR_188	20000	EUR	378	94419260	94544971	125711
EUR_188	20000	EUR	378	94898715	94930362	31647
EUR_188	20000	EUR	378	99165891	99280798	114907
EUR_188	20000	EUR	379	4004059	4134871	130812
EUR_188	20000	EUR	379	8676684	8714283	37599
EUR_188	20000	EUR	379	11650811	11652782	1971
EUR_188	20000	EUR	379	13574314	13635433	61119
EUR_188	20000	EUR	379	13640984	13678187	37203
EUR_188	20000	EUR	379	16243211	16437214	194003
EUR_188	20000	EUR	379	17350938	17365688	14750
EUR_188	20000	EUR	379	18100331	18140078	39747
EUR_188	20000	EUR	379	21098420	21135854	37434
EUR_188	20000	EUR	379	23648833	23651476	2643
EUR_188	20000	EUR	379	25153328	25215904	62576
EUR_188	20000	EUR	379	25847649	25855304	7655
EUR_188	20000	EUR	379	27746608	27894364	147756
EUR_188	20000	EUR	379	28599684	28643784	44100
EUR_188	20000	EUR	379	30976914	31127610	150696
EUR_188	20000	EUR	379	33167789	33194230	26441
EUR_188	20000	EUR	379	37722669	38097333	374664
EUR_188	20000	EUR	379	39858032	40001122	143090
EUR_188	20000	EUR	379	42473584	42574352	100768
EUR_188	20000	EUR	379	59680988	59700527	19539
EUR_188	20000	EUR	379	72326056	72408775	82719
EUR_188	20000	EUR	379	73082356	73223816	141460
EUR_188	20000	EUR	379	79901897	79936163	34266
EUR_188	20000	EUR	379	80161288	80278256	116968
EUR_188	20000	EUR	379	83533777	83550130	16353
EUR_188	20000	EUR	379	88496413	88767389	270976
EUR_188	20000	EUR	379	89997508	90008065	10557
EUR_188	20000	EUR	379	91074962	91107582	32620
EUR_188	20000	EUR	379	94468868	94544971	76103
EUR_188	20000	EUR	379	99177558	99280798	103240
EUR_189	20000	EUR	380	3794084	3982289	188205
EUR_189	20000	EUR	380	13429221	13752117	322896
EUR_189	20000	EUR	380	17833953	17984110	150157
EUR_189	20000	EUR	380	21195166	21282925	87759
EUR_189	20000	EUR	380	22447027	22465519	18492
EUR_189	20000	EUR	380	23122511	23184805	62294
EUR_189	20000	EUR	380	24485266	24581630	96364
EUR_189	20000	EUR	380	25140534	25305885	165351
EUR_189	20000	EUR	380	32138726	32179047	40321
EUR_189	20000	EUR	380	34124908	34182116	57208
EUR_189	20000	EUR	380	37727611	37861599	133988
EUR_189	20000	EUR	380	39957500	40021036	63536
EUR_189	20000	EUR	380	40410992	40602505	191513
EUR_189	20000	EUR	380	41359664	41360462	798
EUR_189	20000	EUR	380	49702405	49881449	179044
EUR_189	20000	EUR	380	50187413	50246703	59290
EUR_189	20000	EUR	380	54653171	54730663	77492
EUR_189	20000	EUR	380	54893690	54904011	10321
EUR_189	20000	EUR	380	56405262	56480618	75356
EUR_189	20000	EUR	380	79860282	79933512	73230
EUR_189	20000	EUR	380	89189593	89235318	45725
EUR_189	20000	EUR	380	90103571	90243516	139945
EUR_189	20000	EUR	380	91025410	91107582	82172
EUR_189	20000	EUR	380	95270807	95445533	174726
EUR_189	20000	EUR	381	1534378	1628761	94383
EUR_189	20000	EUR	381	1853096	1854996	1900
EUR_189	20000	EUR	381	2519034	2648737	129703
EUR_189	20000	EUR	381	2788906	2963147	174241
EUR_189	20000	EUR	381	4458174	4504997	46823
EUR_189	20000	EUR	381	9414397	9449917	35520
EUR_189	20000	EUR	381	10399704	10402156	2452
EUR_189	20000	EUR	381	13621609	13626532	4923
EUR_189	20000	EUR	381	21093849	21390474	296625
EUR_189	20000	EUR	381	23648833	23651476	2643
EUR_189	20000	EUR	381	24621120	24737906	116786
EUR_189	20000	EUR	381	24809049	24866754	57705
EUR_189	20000	EUR	381	25179048	25305885	126837
EUR_189	20000	EUR	381	25847649	25855304	7655
EUR_189	20000	EUR	381	26375604	26436121	60517
EUR_189	20000	EUR	381	26580016	26580898	882
EUR_189	20000	EUR	381	30904434	30925177	20743
EUR_189	20000	EUR	381	32149032	32179047	30015
EUR_189	20000	EUR	381	32855612	32870350	14738
EUR_189	20000	EUR	381	33126757	33166924	40167
EUR_189	20000	EUR	381	36339512	36357016	17504
EUR_189	20000	EUR	381	40047500	40068128	20628
EUR_189	20000	EUR	381	41161176	41182266	21090
EUR_189	20000	EUR	381	54210889	54362674	151785
EUR_189	20000	EUR	381	57712252	57759216	46964
EUR_189	20000	EUR	381	73023523	73172795	149272
EUR_189	20000	EUR	381	73488506	73493479	4973
EUR_189	20000	EUR	381	74102364	74212177	109813
EUR_189	20000	EUR	381	74640712	74738891	98179
EUR_189	20000	EUR	381	76022322	76143984	121662
EUR_189	20000	EUR	381	80135541	80139395	3854
EUR_189	20000	EUR	381	84755692	84778736	23044
EUR_189	20000	EUR	381	85650812	85653228	2416
EUR_189	20000	EUR	381	88152919	88153791	872
EUR_189	20000	EUR	381	88455401	88558762	103361
EUR_189	20000	EUR	381	88851331	88877947	26616
EUR_189	20000	EUR	381	93553045	93713967	160922
EUR_189	20000	EUR	381	94005320	94105458	100138
EUR_189	20000	EUR	381	94239181	94313443	74262
EUR_189	20000	EUR	381	94522778	94544971	22193
EUR_189	20000	EUR	381	95270807	95445533	174726
EUR_189	20000	EUR	381	96136238	96175807	39569
EUR_190	20000	EUR	382	2546510	2648737	102227
EUR_190	20000	EUR	382	11703759	11814111	110352
EUR_190	20000	EUR	382	21061270	21202559	141289
EUR_190	20000	EUR	382	22447027	22533171	86144
EUR_190	20000	EUR	382	22918884	23020784	101900
EUR_190	20000	EUR	382	24621120	24666053	44933
EUR_190	20000	EUR	382	24892444	24906091	13647
EUR_190	20000	EUR	382	29273800	29300000	26200
EUR_190	20000	EUR	382	31113073	31133912	20839
EUR_190	20000	EUR	382	32767431	32880042	112611
EUR_190	20000	EUR	382	35485771	35575915	90144
EUR_190	20000	EUR	382	36284487	36357016	72529
EUR_190	20000	EUR	382	36793192	36795080	1888
EUR_190	20000	EUR	382	42473584	42478119	4535
EUR_190	20000	EUR	382	54210889	54362674	151785
EUR_190	20000	EUR	382	59617240	59714920	97680
EUR_190	20000	EUR	382	63714218	63784151	69933
EUR_190	20000	EUR	382	68675332	68717300	41968
EUR_190	20000	EUR	382	75851931	75915063	63132
EUR_190	20000	EUR	382	80135541	80139395	3854
EUR_190	20000	EUR	382	80954431	81140800	186369
EUR_190	20000	EUR	382	84898186	84919115	20929
EUR_190	20000	EUR	382	87653008	87713350	60342
EUR_190	20000	EUR	382	93388343	93453796	65453
EUR_190	20000	EUR	382	93680632	93680672	40
EUR_190	20000	EUR	382	94297447	94369281	71834
EUR_190	20000	EUR	382	94898715	94922443	23728
EUR_190	20000	EUR	382	99165891	99280798	114907
EUR_190	20000	EUR	383	2813723	2954696	140973
EUR_190	20000	EUR	383	17333821	17369300	35479
EUR_190	20000	EUR	383	17749730	17919616	169886
EUR_190	20000	EUR	383	21093849	21390474	296625
EUR_190	20000	EUR	383	22447027	22468823	21796
EUR_190	20000	EUR	383	23752602	23877108	124506
EUR_190	20000	EUR	383	24892444	24906091	13647
EUR_190	20000	EUR	383	26375604	26420785	45181
EUR_190	20000	EUR	383	27746608	27894364	147756
EUR_190	20000	EUR	383	35771774	35849669	77895
EUR_190	20000	EUR	383	37754246	38097333	343087
EUR_190	20000	EUR	383	42367715	42387565	19850
EUR_190	20000	EUR	383	42793149	42823699	30550
EUR_190	20000	EUR	383	52168283	52388833	220550
EUR_190	20000	EUR	383	53821064	53859932	38868
EUR_190	20000	EUR	383	54632404	54794755	162351
EUR_190	20000	EUR	383	58093392	58136140	42748
EUR_190	20000	EUR	383	59686990	59762964	75974
EUR_190	20000	EUR	383	68626746	68648432	21686
EUR_190	20000	EUR	383	74889460	74894548	5088
EUR_190	20000	EUR	383	76365488	76397099	31611
EUR_190	20000	EUR	383	77606973	77624905	17932
EUR_190	20000	EUR	383	79831163	79933512	102349
EUR_190	20000	EUR	383	80161288	80234873	73585
EUR_190	20000	EUR	383	83931086	83957574	26488
EUR_190	20000	EUR	383	88077880	88113143	35263
EUR_190	20000	EUR	383	88761110	89051514	290404
EUR_190	20000	EUR	383	89067780	89099823	32043
EUR_190	20000	EUR	383	89989980	89998439	8459
EUR_190	20000	EUR	383	93190964	93277691	86727
EUR_190	20000	EUR	383	94388014	94477644	89630
EUR_190	20000	EUR	383	94793518	94930362	136844
EUR_190	20000	EUR	383	95774147	95834476	60329
EUR_190	20000	EUR	383	96711877	96756986	45109
EUR_191	20000	EUR	384	5018475	5034623	16148
EUR_191	20000	EUR	384	13621609	13626532	4923
EUR_191	20000	EUR	384	18081536	18098112	16576
EUR_191	20000	EUR	384	22447027	22520595	73568
EUR_191	20000	EUR	384	23148716	23184805	36089
EUR_191	20000	EUR	384	24892444	24906091	13647
EUR_191	20000	EUR	384	25066876	25088413	21537
EUR_191	20000	EUR	384	25189085	25231890	42805
EUR_191	20000	EUR	384	25817587	25896396	78809
EUR_191	20000	EUR	384	26477051	26517340	40289
EUR_191	20000	EUR	384	27746608	27800312	53704
EUR_191	20000	EUR	384	29306591	29579668	273077
EUR_191	20000	EUR	384	31551025	31593163	42138
EUR_191	20000	EUR	384	33445186	33479750	34564
EUR_191	20000	EUR	384	35811062	35849669	38607
EUR_191	20000	EUR	384	50053800	50097389	43589
EUR_191	20000	EUR	384	54113043	54177383	64340
EUR_191	20000	EUR	384	54899898	54904011	4113
EUR_191	20000	EUR	384	73145730	73223816	78086
EUR_191	20000	EUR	384	77636100	77751872	115772
EUR_191	20000	EUR	384	80520393	80530144	9751
EUR_191	20000	EUR	384	80863277	80899276	35999
EUR_191	20000	EUR	384	88087834	88319207	231373
EUR_191	20000	EUR	384	88527647	88551173	23526
EUR_191	20000	EUR	384	88796237	89010522	214285
EUR_191	20000	EUR	385	2622845	2648737	25892
EUR_191	20000	EUR	385	8348919	8386102	37183
EUR_191	20000	EUR	385	16397154	16454511	57357
EUR_191	20000	EUR	385	18142449	18302049	159600
EUR_191	20000	EUR	385	23176150	23184805	8655
EUR_191	20000	EUR	385	24434464	24578020	143556
EUR_191	20000	EUR	385	25995113	26169692	174579
EUR_191	20000	EUR	385	26375604	26436121	60517
EUR_191	20000	EUR	385	29306591	29478208	171617
EUR_191	20000	EUR	385	34136759	34182116	45357
EUR_191	20000	EUR	385	40410992	40475911	64919
EUR_191	20000	EUR	385	41319133	41360462	41329
EUR_191	20000	EUR	385	54403505	54904011	500506
EUR_191	20000	EUR	385	68626746	68648432	21686
EUR_191	20000	EUR	385	71700744	71764001	63257
EUR_191	20000	EUR	385	74871541	74874118	2577
EUR_191	20000	EUR	385	76567582	76594146	26564
EUR_191	20000	EUR	385	77606973	77700470	93497
EUR_191	20000	EUR	385	80874989	81118702	243713
EUR_191	20000	EUR	385	84755692	84919115	163423
EUR_191	20000	EUR	385	87720969	87903841	182872
EUR_191	20000	EUR	385	89325873	89422884	97011
EUR_191	20000	EUR	385	90426720	90558518	131798
EUR_191	20000	EUR	385	99177558	99200505	22947
EUR_192	20000	EUR	386	9414397	9449917	35520
EUR_192	20000	EUR	386	14085017	14112508	27491
EUR_192	20000	EUR	386	16646358	16681323	34965
EUR_192	20000	EUR	386	18271487	18296696	25209
EUR_192	20000	EUR	386	22447027	22462305	15278
EUR_192	20000	EUR	386	23120612	23126894	6282
EUR_192	20000	EUR	386	25343770	25501390	157620
EUR_192	20000	EUR	386	25953989	25987107	33118
EUR_192	20000	EUR	386	27746608	27894364	147756
EUR_192	20000	EUR	386	32262916	32267787	4871
EUR_192	20000	EUR	386	32730368	32759145	28777
EUR_192	20000	EUR	386	33129736	33221037	91301
EUR_192	20000	EUR	386	35424505	35627884	203379
EUR_192	20000	EUR	386	36284487	36357016	72529
EUR_192	20000	EUR	386	36793192	36795080	1888
EUR_192	20000	EUR	386	40410992	40498219	87227
EUR_192	20000	EUR	386	42805387	42823699	18312
EUR_192	20000	EUR	386	49714809	49899094	184285
EUR_192	20000	EUR	386	53821064	54075933	254869
EUR_192	20000	EUR	386	54714203	54904011	189808
EUR_192	20000	EUR	386	56378802	56406040	27238
EUR_192	20000	EUR	386	57712252	57806900	94648
EUR_192	20000	EUR	386	59718356	59745811	27455
EUR_192	20000	EUR	386	73593016	73702901	109885
EUR_192	20000	EUR	386	75110846	75189189	78343
EUR_192	20000	EUR	386	77606973	77652066	45093
EUR_192	20000	EUR	386	83533777	83550130	16353
EUR_192	20000	EUR	386	84898186	84919115	20929
EUR_192	20000	EUR	386	88087834	88679238	591404
EUR_192	20000	EUR	386	88761110	89081743	320633
EUR_192	20000	EUR	386	90103571	90243516	139945
EUR_192	20000	EUR	386	93981861	94126740	144879
EUR_192	20000	EUR	386	96116814	96220219	103405
EUR_192	20000	EUR	387	1762556	1801916	39360
EUR_192	20000	EUR	387	3763591	3801794	38203
EUR_192	20000	EUR	387	11532006	11542173	10167
EUR_192	20000	EUR	387	13432461	13805391	372930
EUR_192	20000	EUR	387	21150173	21156082	5909
EUR_192	20000	EUR	387	21200799	21216283	15484
EUR_192	20000	EUR	387	23122511	23134325	11814
EUR_192	20000	EUR	387	23727288	23797839	70551
EUR_192	20000	EUR	387	24372241	24581630	209389
EUR_192	20000	EUR	387	25235100	25247804	12704
EUR_192	20000	EUR	387	29277445	29279379	1934
EUR_192	20000	EUR	387	31842746	31866371	23625
EUR_192	20000	EUR	387	35811062	35849669	38607
EUR_192	20000	EUR	387	40410992	40602505	191513
EUR_192	20000	EUR	387	40861764	41134712	272948
EUR_192	20000	EUR	387	43520906	43576329	55423
EUR_192	20000	EUR	387	54403505	54404581	1076
EUR_192	20000	EUR	387	56384631	56448072	63441
EUR_192	20000	EUR	387	57288509	57291065	2556
EUR_192	20000	EUR	387	57712252	57861351	149099
EUR_192	20000	EUR	387	63714218	63732455	18237
EUR_192	20000	EUR	387	74871541	74894548	23007
EUR_192	20000	EUR	387	75110846	75189189	78343
EUR_192	20000	EUR	387	76022322	76128798	106476
EUR_192	20000	EUR	387	76365488	76370460	4972
EUR_192	20000	EUR	387	78816419	79134588	318169
EUR_192	20000	EUR	387	88077880	88161538	83658
EUR_192	20000	EUR	387	88761110	88877947	116837
EUR_192	20000	EUR	387	91025410	91107582	82172
EUR_192	20000	EUR	387	94239181	94337048	97867
EUR_192	20000	EUR	387	94348955	94510180	161225
EUR_192	20000	EUR	387	94898715	94930362	31647
EUR_192	20000	EUR	387	95270807	95397323	126516
EUR_192	20000	EUR	387	95829965	95887608	57643
EUR_193	20000	EUR	388	2813723	3065958	252235
EUR_193	20000	EUR	388	8783056	8883310	100254
EUR_193	20000	EUR	388	13574314	13635433	61119
EUR_193	20000	EUR	388	13640984	13678187	37203
EUR_193	20000	EUR	388	17240420	17244285	3865
EUR_193	20000	EUR	388	21150173	21156082	5909
EUR_193	20000	EUR	388	21200799	21216283	15484
EUR_193	20000	EUR	388	21228885	21282925	54040
EUR_193	20000	EUR	388	26849817	26889089	39272
EUR_193	20000	EUR	388	31102544	31244622	142078
EUR_193	20000	EUR	388	32262916	32267787	4871
EUR_193	20000	EUR	388	32848174	32870870	22696
EUR_193	20000	EUR	388	36432793	36460007	27214
EUR_193	20000	EUR	388	42369514	42472558	103044
EUR_193	20000	EUR	388	54567449	54612977	45528
EUR_193	20000	EUR	388	57805237	57861351	56114
EUR_193	20000	EUR	388	72961212	73172795	211583
EUR_193	20000	EUR	388	73488506	73493479	4973
EUR_193	20000	EUR	388	74644219	74738891	94672
EUR_193	20000	EUR	388	80973372	81067344	93972
EUR_193	20000	EUR	388	85353810	85405856	52046
EUR_193	20000	EUR	388	87665598	87751923	86325
EUR_193	20000	EUR	388	87969149	87994899	25750
EUR_193	20000	EUR	388	88077880	88113143	35263
EUR_193	20000	EUR	388	88617174	88762816	145642
EUR_193	20000	EUR	388	89037352	89065618	28266
EUR_193	20000	EUR	388	91847626	91925341	77715
EUR_193	20000	EUR	388	93721614	93725532	3918
EUR_193	20000	EUR	388	93891415	93905248	13833
EUR_193	20000	EUR	388	94239181	94337048	97867
EUR_193	20000	EUR	388	94348955	94544971	196016
EUR_193	20000	EUR	388	94898715	94930362	31647
EUR_193	20000	EUR	388	95817511	95880389	62878
EUR_193	20000	EUR	388	96264202	96324010	59808
EUR_193	20000	EUR	389	1762556	1913079	150523
EUR_193	20000	EUR	389	2885290	2963147	77857
EUR_193	20000	EUR	389	8348919	8386102	37183
EUR_193	20000	EUR	389	8769034	8780869	11835
EUR_193	20000	EUR	389	21150173	21156082	5909
EUR_193	20000	EUR	389	21200799	21216283	15484
EUR_193	20000	EUR	389	23766790	23877108	110318
EUR_193	20000	EUR	389	24734599	24737906	3307
EUR_193	20000	EUR	389	25847649	25855304	7655
EUR_193	20000	EUR	389	29273800	29279379	5579
EUR_193	20000	EUR	389	31528053	31575105	47052
EUR_193	20000	EUR	389	33183122	33429152	246030
EUR_193	20000	EUR	389	34124908	34182116	57208
EUR_193	20000	EUR	389	40410992	40602505	191513
EUR_193	20000	EUR	389	40973349	40979135	5786
EUR_193	20000	EUR	389	58093392	58136140	42748
EUR_193	20000	EUR	389	59686990	59762964	75974
EUR_193	20000	EUR	389	63714218	63732455	18237
EUR_193	20000	EUR	389	64321831	64406792	84961
EUR_193	20000	EUR	389	74092456	74139119	46663
EUR_193	20000	EUR	389	75587305	75641163	53858
EUR_193	20000	EUR	389	76139818	76140066	248
EUR_193	20000	EUR	389	80973372	81067344	93972
EUR_193	20000	EUR	389	85353810	85405856	52046
EUR_193	20000	EUR	389	88221167	88259136	37969
EUR_193	20000	EUR	389	88867617	89001971	134354
EUR_193	20000	EUR	389	94299354	94418018	118664
EUR_193	20000	EUR	389	94419260	94544971	125711
EUR_193	20000	EUR	389	95270807	95445533	174726
EUR_193	20000	EUR	389	96116814	96337375	220561
EUR_194	20000	EUR	390	3281249	3302065	20816
EUR_194	20000	EUR	390	4004059	4134871	130812
EUR_194	20000	EUR	390	9413335	9449917	36582
EUR_194	20000	EUR	390	21164327	21282925	118598
EUR_194	20000	EUR	390	23122511	23184805	62294
EUR_194	20000	EUR	390	24045382	24079544	34162
EUR_194	20000	EUR	390	25867195	25987107	119912
EUR_194	20000	EUR	390	26069214	26169692	100478
EUR_194	20000	EUR	390	32170839	32187563	16724
EUR_194	20000	EUR	390	32262916	32267787	4871
EUR_194	20000	EUR	390	32694491	32709855	15364
EUR_194	20000	EUR	390	35001631	35019786	18155
EUR_194	20000	EUR	390	42473584	42545802	72218
EUR_194	20000	EUR	390	53821064	53837891	16827
EUR_194	20000	EUR	390	59064557	59245738	181181
EUR_194	20000	EUR	390	63714218	63732455	18237
EUR_194	20000	EUR	390	71590090	71678663	88573
EUR_194	20000	EUR	390	72961212	73172795	211583
EUR_194	20000	EUR	390	73488506	73493479	4973
EUR_194	20000	EUR	390	76022322	76143984	121662
EUR_194	20000	EUR	390	77716962	77775382	58420
EUR_194	20000	EUR	390	77823655	77881732	58077
EUR_194	20000	EUR	390	79901897	79936163	34266
EUR_194	20000	EUR	390	84235412	84254246	18834
EUR_194	20000	EUR	390	84755692	84810053	54361
EUR_194	20000	EUR	390	88087834	88679238	591404
EUR_194	20000	EUR	390	88761110	89081743	320633
EUR_194	20000	EUR	390	90627118	90883111	255993
EUR_194	20000	EUR	390	94388014	94477644	89630
EUR_194	20000	EUR	390	94793518	94930362	136844
EUR_194	20000	EUR	390	95774147	95834476	60329
EUR_194	20000	EUR	391	1004770	1079953	75183
EUR_194	20000	EUR	391	5018475	5041230	22755
EUR_194	20000	EUR	391	8783056	8919648	136592
EUR_194	20000	EUR	391	12764351	12974092	209741
EUR_194	20000	EUR	391	13889315	13904227	14912
EUR_194	20000	EUR	391	16243211	16437214	194003
EUR_194	20000	EUR	391	21150173	21156082	5909
EUR_194	20000	EUR	391	21200799	21216283	15484
EUR_194	20000	EUR	391	23148716	23184805	36089
EUR_194	20000	EUR	391	24621120	24666053	44933
EUR_194	20000	EUR	391	24892444	24906091	13647
EUR_194	20000	EUR	391	25817896	25839696	21800
EUR_194	20000	EUR	391	26048379	26195455	147076
EUR_194	20000	EUR	391	26886230	26991485	105255
EUR_194	20000	EUR	391	29273800	29300000	26200
EUR_194	20000	EUR	391	30889388	30914840	25452
EUR_194	20000	EUR	391	31113073	31133912	20839
EUR_194	20000	EUR	391	31671896	31807339	135443
EUR_194	20000	EUR	391	33293653	33295884	2231
EUR_194	20000	EUR	391	37885686	37943125	57439
EUR_194	20000	EUR	391	40047500	40068128	20628
EUR_194	20000	EUR	391	42551043	42574352	23309
EUR_194	20000	EUR	391	42793149	42823699	30550
EUR_194	20000	EUR	391	54210230	54365408	155178
EUR_194	20000	EUR	391	54893690	54904011	10321
EUR_194	20000	EUR	391	59576740	59700527	123787
EUR_194	20000	EUR	391	63714218	63732455	18237
EUR_194	20000	EUR	391	64321831	64406792	84961
EUR_194	20000	EUR	391	72226457	72297712	71255
EUR_194	20000	EUR	391	73633815	73702901	69086
EUR_194	20000	EUR	391	76567582	76594146	26564
EUR_194	20000	EUR	391	78816419	79134588	318169
EUR_194	20000	EUR	391	88796237	89010522	214285
EUR_194	20000	EUR	391	89029670	89043204	13534
EUR_194	20000	EUR	391	93416072	93429042	12970
EUR_194	20000	EUR	391	94448274	94544971	96697
EUR_194	20000	EUR	391	95270807	95445533	174726
EUR_194	20000	EUR	391	99165891	99280798	114907
EUR_195	20000	EUR	392	1762556	1830270	67714
EUR_195	20000	EUR	392	3281249	3302065	20816
EUR_195	20000	EUR	392	5018475	5041230	22755
EUR_195	20000	EUR	392	7572302	7793592	221290
EUR_195	20000	EUR	392	11703759	11708397	4638
EUR_195	20000	EUR	392	16243211	16320847	77636
EUR_195	20000	EUR	392	22237044	22313169	76125
EUR_195	20000	EUR	392	23432743	23554604	121861
EUR_195	20000	EUR	392	24542388	24581630	39242
EUR_195	20000	EUR	392	25816021	25855304	39283
EUR_195	20000	EUR	392	32767431	32880042	112611
EUR_195	20000	EUR	392	39858032	39938835	80803
EUR_195	20000	EUR	392	40410992	40602505	191513
EUR_195	20000	EUR	392	41109339	41393058	283719
EUR_195	20000	EUR	392	42164278	42208086	43808
EUR_195	20000	EUR	392	53847831	53859932	12101
EUR_195	20000	EUR	392	57712252	57783737	71485
EUR_195	20000	EUR	392	58863206	58863428	222
EUR_195	20000	EUR	392	59423469	59522281	98812
EUR_195	20000	EUR	392	59525840	59631623	105783
EUR_195	20000	EUR	392	71544591	71678524	133933
EUR_195	20000	EUR	392	73015178	73040765	25587
EUR_195	20000	EUR	392	73136973	73172795	35822
EUR_195	20000	EUR	392	74019705	74058264	38559
EUR_195	20000	EUR	392	74092456	74139119	46663
EUR_195	20000	EUR	392	76567582	76594146	26564
EUR_195	20000	EUR	392	77606973	77700470	93497
EUR_195	20000	EUR	392	83533777	83550130	16353
EUR_195	20000	EUR	392	83554127	83592822	38695
EUR_195	20000	EUR	392	88087834	88146039	58205
EUR_195	20000	EUR	392	88761110	88877947	116837
EUR_195	20000	EUR	392	89989980	89998439	8459
EUR_195	20000	EUR	392	91552179	91688404	136225
EUR_195	20000	EUR	392	93553045	93713967	160922
EUR_195	20000	EUR	392	94147632	94317758	170126
EUR_195	20000	EUR	392	96116814	96259584	142770
EUR_195	20000	EUR	393	246629	411145	164516
EUR_195	20000	EUR	393	1762556	1801916	39360
EUR_195	20000	EUR	393	2546510	2630115	83605
EUR_195	20000	EUR	393	2667696	2893597	225901
EUR_195	20000	EUR	393	16243211	16402432	159221
EUR_195	20000	EUR	393	22992959	23099324	106365
EUR_195	20000	EUR	393	23156936	23184805	27869
EUR_195	20000	EUR	393	25183341	25237709	54368
EUR_195	20000	EUR	393	28111916	28139866	27950
EUR_195	20000	EUR	393	29306591	29478208	171617
EUR_195	20000	EUR	393	31102544	31244622	142078
EUR_195	20000	EUR	393	32262916	32267787	4871
EUR_195	20000	EUR	393	32848174	32870870	22696
EUR_195	20000	EUR	393	33430359	33479750	49391
EUR_195	20000	EUR	393	35887157	35892995	5838
EUR_195	20000	EUR	393	40410992	40475911	64919
EUR_195	20000	EUR	393	40978192	40979135	943
EUR_195	20000	EUR	393	53821064	53837891	16827
EUR_195	20000	EUR	393	54632404	54794755	162351
EUR_195	20000	EUR	393	73745706	73906350	160644
EUR_195	20000	EUR	393	75592795	75632489	39694
EUR_195	20000	EUR	393	81107841	81229503	121662
EUR_195	20000	EUR	393	83955315	83957574	2259
EUR_195	20000	EUR	393	84898186	84919115	20929
EUR_195	20000	EUR	393	87659942	87751923	91981
EUR_195	20000	EUR	393	89087504	89099823	12319
EUR_195	20000	EUR	393	93943380	94056780	113400
EUR_195	20000	EUR	393	94297447	94418018	120571
EUR_195	20000	EUR	393	94419260	94544971	125711
EUR_195	20000	EUR	393	95774147	95781842	7695
EUR_195	20000	EUR	393	96116814	96127414	10600
EUR_195	20000	EUR	393	96506025	97008044	502019
EUR_196	20000	EUR	394	21224963	21225412	449
EUR_196	20000	EUR	394	22519633	22533171	13538
EUR_196	20000	EUR	394	23648833	23651476	2643
EUR_196	20000	EUR	394	24372241	24384508	12267
EUR_196	20000	EUR	394	25140534	25157132	16598
EUR_196	20000	EUR	394	26180848	26195455	14607
EUR_196	20000	EUR	394	26319359	26343601	24242
EUR_196	20000	EUR	394	26886230	26991485	105255
EUR_196	20000	EUR	394	36846999	36869887	22888
EUR_196	20000	EUR	394	37727611	37735395	7784
EUR_196	20000	EUR	394	39957500	40021036	63536
EUR_196	20000	EUR	394	40410992	40602505	191513
EUR_196	20000	EUR	394	49714605	49899094	184489
EUR_196	20000	EUR	394	59617240	59714920	97680
EUR_196	20000	EUR	394	68624378	68673073	48695
EUR_196	20000	EUR	394	71700744	71764001	63257
EUR_196	20000	EUR	394	72961212	73172795	211583
EUR_196	20000	EUR	394	73645076	73702901	57825
EUR_196	20000	EUR	394	74055055	74094072	39017
EUR_196	20000	EUR	394	84755692	84919115	163423
EUR_196	20000	EUR	394	87382730	87435149	52419
EUR_196	20000	EUR	394	87727929	87874122	146193
EUR_196	20000	EUR	394	88338208	88646288	308080
EUR_196	20000	EUR	394	93585543	93713967	128424
EUR_196	20000	EUR	394	96136238	96137817	1579
EUR_196	20000	EUR	394	99165891	99213383	47492
EUR_196	20000	EUR	395	8783056	8932393	149337
EUR_196	20000	EUR	395	18677221	18844474	167253
EUR_196	20000	EUR	395	21195166	21282925	87759
EUR_196	20000	EUR	395	23766790	23877108	110318
EUR_196	20000	EUR	395	24734599	24737906	3307
EUR_196	20000	EUR	395	25847649	25855304	7655
EUR_196	20000	EUR	395	40572310	40602505	30195
EUR_196	20000	EUR	395	40861764	41134712	272948
EUR_196	20000	EUR	395	42369514	42472558	103044
EUR_196	20000	EUR	395	49702405	49881449	179044
EUR_196	20000	EUR	395	69023918	69060887	36969
EUR_196	20000	EUR	395	75089161	75095784	6623
EUR_196	20000	EUR	395	76798443	77082685	284242
EUR_196	20000	EUR	395	77879347	77881732	2385
EUR_196	20000	EUR	395	79901897	79936163	34266
EUR_196	20000	EUR	395	80161288	80278256	116968
EUR_196	20000	EUR	395	84755692	84919115	163423
EUR_196	20000	EUR	395	87650695	87656802	6107
EUR_196	20000	EUR	395	88221167	88300295	79128
EUR_196	20000	EUR	395	88324698	88699947	375249
EUR_196	20000	EUR	395	88703422	88703923	501
EUR_196	20000	EUR	395	88761110	89081743	320633
EUR_196	20000	EUR	395	91891040	91902611	11571
EUR_196	20000	EUR	395	94388014	94556642	168628
EUR_196	20000	EUR	395	94885812	94898377	12565
EUR_196	20000	EUR	395	94898715	94930362	31647
EUR_196	20000	EUR	395	96136238	96151871	15633
EUR_197	20000	EUR	396	7349356	7349567	211
EUR_197	20000	EUR	396	16234928	16286721	51793
EUR_197	20000	EUR	396	18081536	18107085	25549
EUR_197	20000	EUR	396	23432743	23554604	121861
EUR_197	20000	EUR	396	24542388	24581630	39242
EUR_197	20000	EUR	396	25153328	25215904	62576
EUR_197	20000	EUR	396	26319359	26436121	116762
EUR_197	20000	EUR	396	26886230	26991485	105255
EUR_197	20000	EUR	396	31102544	31217865	115321
EUR_197	20000	EUR	396	31431938	31446638	14700
EUR_197	20000	EUR	396	32039879	32057645	17766
EUR_197	20000	EUR	396	32824940	32828620	3680
EUR_197	20000	EUR	396	32858056	32870350	12294
EUR_197	20000	EUR	396	34124908	34182116	57208
EUR_197	20000	EUR	396	43359651	43453960	94309
EUR_197	20000	EUR	396	52168283	52224193	55910
EUR_197	20000	EUR	396	59693122	59762964	69842
EUR_197	20000	EUR	396	68675332	68717300	41968
EUR_197	20000	EUR	396	75263541	75264425	884
EUR_197	20000	EUR	396	76456850	76594146	137296
EUR_197	20000	EUR	396	87665598	87751923	86325
EUR_197	20000	EUR	396	87969149	87994899	25750
EUR_197	20000	EUR	396	88077880	88113143	35263
EUR_197	20000	EUR	396	89989980	89998439	8459
EUR_197	20000	EUR	396	91847626	91875197	27571
EUR_197	20000	EUR	396	94290726	94412962	122236
EUR_197	20000	EUR	396	94898715	94930362	31647
EUR_197	20000	EUR	396	95270807	95319420	48613
EUR_197	20000	EUR	396	96229638	96336399	106761
EUR_197	20000	EUR	397	22447027	22462305	15278
EUR_197	20000	EUR	397	23120612	23126894	6282
EUR_197	20000	EUR	397	25412616	25424688	12072
EUR_197	20000	EUR	397	26375604	26429831	54227
EUR_197	20000	EUR	397	31087987	31314394	226407
EUR_197	20000	EUR	397	32694491	32748960	54469
EUR_197	20000	EUR	397	33126757	33151809	25052
EUR_197	20000	EUR	397	37809118	37815963	6845
EUR_197	20000	EUR	397	37960008	38097333	137325
EUR_197	20000	EUR	397	41319133	41360462	41329
EUR_197	20000	EUR	397	52168283	52224193	55910
EUR_197	20000	EUR	397	54714203	54904011	189808
EUR_197	20000	EUR	397	56378802	56386732	7930
EUR_197	20000	EUR	397	58064915	58088114	23199
EUR_197	20000	EUR	397	68624378	68713281	88903
EUR_197	20000	EUR	397	73115427	73223816	108389
EUR_197	20000	EUR	397	74660426	74699907	39481
EUR_197	20000	EUR	397	75110846	75189189	78343
EUR_197	20000	EUR	397	88087834	88675013	587179
EUR_197	20000	EUR	397	88797692	89172519	374827
EUR_197	20000	EUR	397	89989980	89998439	8459
EUR_197	20000	EUR	397	91074962	91107582	32620
EUR_197	20000	EUR	397	94126349	94222927	96578
EUR_197	20000	EUR	397	94447447	94522438	74991
EUR_197	20000	EUR	397	94915497	94925699	10202
EUR_197	20000	EUR	397	96303215	96314465	11250
EUR_197	20000	EUR	397	96537974	97008044	470070
EUR_197	20000	EUR	397	99266697	99280798	14101
EUR_198	20000	EUR	398	1004770	1079953	75183
EUR_198	20000	EUR	398	2415974	2620243	204269
EUR_198	20000	EUR	398	2984450	3003090	18640
EUR_198	20000	EUR	398	8651970	8714283	62313
EUR_198	20000	EUR	398	17333821	17369300	35479
EUR_198	20000	EUR	398	21061270	21202559	141289
EUR_198	20000	EUR	398	22447027	22533171	86144
EUR_198	20000	EUR	398	22918884	23020784	101900
EUR_198	20000	EUR	398	24621120	24666053	44933
EUR_198	20000	EUR	398	24892444	24906091	13647
EUR_198	20000	EUR	398	29273800	29300000	26200
EUR_198	20000	EUR	398	31113073	31133912	20839
EUR_198	20000	EUR	398	32730368	32759145	28777
EUR_198	20000	EUR	398	32851725	32880042	28317
EUR_198	20000	EUR	398	34999082	35095643	96561
EUR_198	20000	EUR	398	41319133	41360462	41329
EUR_198	20000	EUR	398	49860683	49898615	37932
EUR_198	20000	EUR	398	52168283	52337003	168720
EUR_198	20000	EUR	398	54653171	54730663	77492
EUR_198	20000	EUR	398	54893690	54904011	10321
EUR_198	20000	EUR	398	57857678	57861351	3673
EUR_198	20000	EUR	398	68626746	68648432	21686
EUR_198	20000	EUR	398	69023918	69060887	36969
EUR_198	20000	EUR	398	73017878	73060131	42253
EUR_198	20000	EUR	398	73115427	73223816	108389
EUR_198	20000	EUR	398	73488506	73608269	119763
EUR_198	20000	EUR	398	73896313	73986181	89868
EUR_198	20000	EUR	398	74871541	74894548	23007
EUR_198	20000	EUR	398	80135541	80139395	3854
EUR_198	20000	EUR	398	88152919	88153791	872
EUR_198	20000	EUR	398	88455401	88558762	103361
EUR_198	20000	EUR	398	96116814	96333512	216698
EUR_198	20000	EUR	399	1762556	1830270	67714
EUR_198	20000	EUR	399	16243211	16402432	159221
EUR_198	20000	EUR	399	21093849	21390474	296625
EUR_198	20000	EUR	399	23648833	23651476	2643
EUR_198	20000	EUR	399	24621120	24666053	44933
EUR_198	20000	EUR	399	24892444	24906091	13647
EUR_198	20000	EUR	399	25817896	25839223	21327
EUR_198	20000	EUR	399	30889388	31034898	145510
EUR_198	20000	EUR	399	31113073	31133912	20839
EUR_198	20000	EUR	399	39933346	40008876	75530
EUR_198	20000	EUR	399	42493150	42574352	81202
EUR_198	20000	EUR	399	52391500	52440869	49369
EUR_198	20000	EUR	399	54210889	54254727	43838
EUR_198	20000	EUR	399	58093392	58136140	42748
EUR_198	20000	EUR	399	73488506	73675439	186933
EUR_198	20000	EUR	399	75263541	75282527	18986
EUR_198	20000	EUR	399	79860282	79933512	73230
EUR_198	20000	EUR	399	80954431	80989417	34986
EUR_198	20000	EUR	399	83370620	83384810	14190
EUR_198	20000	EUR	399	88087834	88415057	327223
EUR_198	20000	EUR	399	88825376	89050718	225342
EUR_198	20000	EUR	399	90627118	90969654	342536
EUR_198	20000	EUR	399	91847626	91929323	81697
EUR_198	20000	EUR	399	91987726	92020761	33035
EUR_198	20000	EUR	399	93172929	93217584	44655
EUR_198	20000	EUR	399	94263579	94317758	54179
EUR_198	20000	EUR	399	99165891	99280798	114907
EUR_199	20000	EUR	400	327186	411145	83959
EUR_199	20000	EUR	400	1927314	1946512	19198
EUR_199	20000	EUR	400	16243211	16402432	159221
EUR_199	20000	EUR	400	17207713	17322650	114937
EUR_199	20000	EUR	400	21224963	21225412	449
EUR_199	20000	EUR	400	24892444	24906091	13647
EUR_199	20000	EUR	400	33245767	33429152	183385
EUR_199	20000	EUR	400	34124908	34182116	57208
EUR_199	20000	EUR	400	39639062	39692065	53003
EUR_199	20000	EUR	400	39907281	40145306	238025
EUR_199	20000	EUR	400	43359651	43453960	94309
EUR_199	20000	EUR	400	57149895	57291065	141170
EUR_199	20000	EUR	400	63714218	63803837	89619
EUR_199	20000	EUR	400	74019705	74094072	74367
EUR_199	20000	EUR	400	75263541	75282527	18986
EUR_199	20000	EUR	400	77009113	77082685	73572
EUR_199	20000	EUR	400	78816419	79134588	318169
EUR_199	20000	EUR	400	84755692	84919115	163423
EUR_199	20000	EUR	400	88078757	88161538	82781
EUR_199	20000	EUR	400	88825376	88915947	90571
EUR_199	20000	EUR	400	91999011	92171686	172675
EUR_199	20000	EUR	400	94196868	94317758	120890
EUR_199	20000	EUR	400	96117434	96217388	99954
EUR_199	20000	EUR	401	8348919	8386102	37183
EUR_199	20000	EUR	401	16243211	16261982	18771
EUR_199	20000	EUR	401	21033731	21041802	8071
EUR_199	20000	EUR	401	26849817	26883308	33491
EUR_199	20000	EUR	401	34845302	34926785	81483
EUR_199	20000	EUR	401	53821064	53996988	175924
EUR_199	20000	EUR	401	59554189	59631623	77434
EUR_199	20000	EUR	401	75851931	75915063	63132
EUR_199	20000	EUR	401	77733985	77735979	1994
EUR_199	20000	EUR	401	79860282	79933512	73230
EUR_199	20000	EUR	401	83370620	83384810	14190
EUR_199	20000	EUR	401	88796237	88879268	83031
EUR_199	20000	EUR	401	88907979	89001971	93992
EUR_199	20000	EUR	401	93943380	94056780	113400
EUR_199	20000	EUR	401	94297447	94418018	120571
EUR_199	20000	EUR	401	94419260	94515224	95964
EUR_199	20000	EUR	401	96325089	96352723	27634
EUR_200	20000	EUR	402	9180036	9449917	269881
EUR_200	20000	EUR	402	16243211	16397990	154779
EUR_200	20000	EUR	402	21150173	21156082	5909
EUR_200	20000	EUR	402	21200799	21216283	15484
EUR_200	20000	EUR	402	23122511	23134325	11814
EUR_200	20000	EUR	402	24892444	24906091	13647
EUR_200	20000	EUR	402	25323974	25377647	53673
EUR_200	20000	EUR	402	25995113	26009403	14290
EUR_200	20000	EUR	402	26375604	26436121	60517
EUR_200	20000	EUR	402	29273800	29279379	5579
EUR_200	20000	EUR	402	31842746	31866371	23625
EUR_200	20000	EUR	402	40942496	41134712	192216
EUR_200	20000	EUR	402	43359651	43453960	94309
EUR_200	20000	EUR	402	49714605	50246703	532098
EUR_200	20000	EUR	402	52224085	52440869	216784
EUR_200	20000	EUR	402	59554189	59607931	53742
EUR_200	20000	EUR	402	71700744	71764001	63257
EUR_200	20000	EUR	402	73488506	73491846	3340
EUR_200	20000	EUR	402	73498527	73660589	162062
EUR_200	20000	EUR	402	74032464	74094072	61608
EUR_200	20000	EUR	402	75587305	75641163	53858
EUR_200	20000	EUR	402	80863277	80899276	35999
EUR_200	20000	EUR	402	80946931	81087964	141033
EUR_200	20000	EUR	402	81088612	81190655	102043
EUR_200	20000	EUR	402	84788675	84792787	4112
EUR_200	20000	EUR	402	88106369	88172209	65840
EUR_200	20000	EUR	402	93303963	93371609	67646
EUR_200	20000	EUR	402	93721614	93725532	3918
EUR_200	20000	EUR	402	94406727	94556642	149915
EUR_200	20000	EUR	402	94885812	94898377	12565
EUR_200	20000	EUR	402	94898715	94930362	31647
EUR_200	20000	EUR	402	95880924	95927099	46175
EUR_200	20000	EUR	402	96379020	96546756	167736
EUR_200	20000	EUR	402	96800979	97008044	207065
EUR_200	20000	EUR	403	25971191	25987107	15916
EUR_200	20000	EUR	403	30904434	31092945	188511
EUR_200	20000	EUR	403	36744092	36793403	49311
EUR_200	20000	EUR	403	37809118	37815963	6845
EUR_200	20000	EUR	403	39639062	39696725	57663
EUR_200	20000	EUR	403	39907281	39942623	35342
EUR_200	20000	EUR	403	54653171	54730663	77492
EUR_200	20000	EUR	403	54893690	54904011	10321
EUR_200	20000	EUR	403	59637408	59700527	63119
EUR_200	20000	EUR	403	64362636	64406792	44156
EUR_200	20000	EUR	403	71544591	71629966	85375
EUR_200	20000	EUR	403	73488506	73668232	179726
EUR_200	20000	EUR	403	74595799	74699907	104108
EUR_200	20000	EUR	403	76365488	76399941	34453
EUR_200	20000	EUR	403	78832752	78908217	75465
EUR_200	20000	EUR	403	88761110	88807613	46503
EUR_200	20000	EUR	403	88867617	89001971	134354
EUR_200	20000	EUR	403	94006035	94010234	4199
EUR_200	20000	EUR	403	96116814	96217388	100574
EUR_201	10000	EUR	404	1330157	1385444	55287
EUR_201	10000	EUR	404	3963320	4134871	171551
EUR_201	10000	EUR	404	13621609	13626532	4923
EUR_201	10000	EUR	404	14053026	14108442	55416
EUR_201	10000	EUR	404	16234928	16286721	51793
EUR_201	10000	EUR	404	16322068	16402432	80364
EUR_201	10000	EUR	404	18536950	18538440	1490
EUR_201	10000	EUR	404	23752602	23856810	104208
EUR_201	10000	EUR	404	24045382	24166883	121501
EUR_201	10000	EUR	404	24372241	24384508	12267
EUR_201	10000	EUR	404	24535579	24581630	46051
EUR_201	10000	EUR	404	25325282	25325345	63
EUR_201	10000	EUR	404	25343770	25501390	157620
EUR_201	10000	EUR	404	25978368	25987107	8739
EUR_201	10000	EUR	404	29347606	29396432	48826
EUR_201	10000	EUR	404	30904434	30925177	20743
EUR_201	10000	EUR	404	32431231	32446630	15399
EUR_201	10000	EUR	404	32824940	32871485	46545
EUR_201	10000	EUR	404	35771774	35849669	77895
EUR_201	10000	EUR	404	36744092	36864514	120422
EUR_201	10000	EUR	404	37809118	37815963	6845
EUR_201	10000	EUR	404	40410992	40602505	191513
EUR_201	10000	EUR	404	42369514	42431902	62388
EUR_201	10000	EUR	404	53875418	53947462	72044
EUR_201	10000	EUR	404	54503155	54794755	291600
EUR_201	10000	EUR	404	69048774	69068474	19700
EUR_201	10000	EUR	404	73498527	73653531	155004
EUR_201	10000	EUR	404	76137655	76143984	6329
EUR_201	10000	EUR	404	76456850	76594146	137296
EUR_201	10000	EUR	404	79086226	79134588	48362
EUR_201	10000	EUR	404	79901897	79903521	1624
EUR_201	10000	EUR	404	83370620	83384810	14190
EUR_201	10000	EUR	404	83955315	83957574	2259
EUR_201	10000	EUR	404	84235412	84245003	9591
EUR_201	10000	EUR	404	88452177	88464514	12337
EUR_201	10000	EUR	404	88476761	88537179	60418
EUR_201	10000	EUR	404	89037352	89091247	53895
EUR_201	10000	EUR	404	89356470	89465942	109472
EUR_201	10000	EUR	404	93800814	93869231	68417
EUR_201	10000	EUR	404	94350732	94375754	25022
EUR_201	10000	EUR	404	94473086	94544971	71885
EUR_201	10000	EUR	404	94915497	94930362	14865
EUR_201	10000	EUR	405	22523307	22533171	9864
EUR_201	10000	EUR	405	23122511	23184805	62294
EUR_201	10000	EUR	405	24580740	24581630	890
EUR_201	10000	EUR	405	24892444	24906091	13647
EUR_201	10000	EUR	405	26319359	26331325	11966
EUR_201	10000	EUR	405	28087103	28139866	52763
EUR_201	10000	EUR	405	29333333	29367055	33722
EUR_201	10000	EUR	405	35085236	35087281	2045
EUR_201	10000	EUR	405	40978824	41134712	155888
EUR_201	10000	EUR	405	42799702	42823699	23997
EUR_201	10000	EUR	405	54403505	54544211	140706
EUR_201	10000	EUR	405	63714218	63732455	18237
EUR_201	10000	EUR	405	68626746	68648432	21686
EUR_201	10000	EUR	405	69023918	69060887	36969
EUR_201	10000	EUR	405	72288615	72398733	110118
EUR_201	10000	EUR	405	75587305	75641163	53858
EUR_201	10000	EUR	405	76456850	76594146	137296
EUR_201	10000	EUR	405	79082049	79134588	52539
EUR_201	10000	EUR	405	83955315	83957574	2259
EUR_201	10000	EUR	405	87653008	87835159	182151
EUR_201	10000	EUR	405	88077880	88113143	35263
EUR_201	10000	EUR	405	88761110	88930987	169877
EUR_201	10000	EUR	405	90103571	90243516	139945
EUR_201	10000	EUR	405	91025410	91107582	82172
EUR_201	10000	EUR	405	91891040	91902611	11571
EUR_201	10000	EUR	405	93123848	93146996	23148
EUR_201	10000	EUR	405	93680632	93680672	40
EUR_201	10000	EUR	405	94447447	94522438	74991
EUR_201	10000	EUR	405	96665448	96921990	256542
EUR_202	10000	EUR	406	2593484	2648737	55253
EUR_202	10000	EUR	406	3929740	3975764	46024
EUR_202	10000	EUR	406	4042638	4044195	1557
EUR_202	10000	EUR	406	16243211	16397990	154779
EUR_202	10000	EUR	406	21093849	21308823	214974
EUR_202	10000	EUR	406	23721919	23797839	75920
EUR_202	10000	EUR	406	27894016	27894364	348
EUR_202	10000	EUR	406	29347606	29396432	48826
EUR_202	10000	EUR	406	31235544	31314394	78850
EUR_202	10000	EUR	406	33126706	33180725	54019
EUR_202	10000	EUR	406	35328645	35413680	85035
EUR_202	10000	EUR	406	38065368	38097333	31965
EUR_202	10000	EUR	406	40142894	40145306	2412
EUR_202	10000	EUR	406	40410992	40498219	87227
EUR_202	10000	EUR	406	40861764	40975939	114175
EUR_202	10000	EUR	406	41336542	41360462	23920
EUR_202	10000	EUR	406	42430229	42468277	38048
EUR_202	10000	EUR	406	50097264	50097389	125
EUR_202	10000	EUR	406	53821064	53842770	21706
EUR_202	10000	EUR	406	54693132	54796245	103113
EUR_202	10000	EUR	406	63714218	63766635	52417
EUR_202	10000	EUR	406	72288615	72398733	110118
EUR_202	10000	EUR	406	77733985	77735979	1994
EUR_202	10000	EUR	406	79082049	79134588	52539
EUR_202	10000	EUR	406	87369479	87389813	20334
EUR_202	10000	EUR	406	87504329	87507341	3012
EUR_202	10000	EUR	406	88796237	88859018	62781
EUR_202	10000	EUR	406	91011409	91097487	86078
EUR_202	10000	EUR	406	92062604	92076907	14303
EUR_202	10000	EUR	406	93553045	93623717	70672
EUR_202	10000	EUR	406	93943380	94041746	98366
EUR_202	10000	EUR	406	94595895	94701010	105115
EUR_202	10000	EUR	406	96537974	96638901	100927
EUR_202	10000	EUR	406	99269391	99280798	11407
EUR_202	10000	EUR	407	1924080	2022517	98437
EUR_202	10000	EUR	407	2454787	2527168	72381
EUR_202	10000	EUR	407	8662954	8714283	51329
EUR_202	10000	EUR	407	16397154	16454511	57357
EUR_202	10000	EUR	407	18100331	18140078	39747
EUR_202	10000	EUR	407	18622886	18751123	128237
EUR_202	10000	EUR	407	21393457	21429464	36007
EUR_202	10000	EUR	407	22523307	22533171	9864
EUR_202	10000	EUR	407	23122511	23184805	62294
EUR_202	10000	EUR	407	23781897	23797541	15644
EUR_202	10000	EUR	407	24621120	24643764	22644
EUR_202	10000	EUR	407	24892444	24906091	13647
EUR_202	10000	EUR	407	26445132	26525365	80233
EUR_202	10000	EUR	407	26575524	26580898	5374
EUR_202	10000	EUR	407	27746608	27974945	228337
EUR_202	10000	EUR	407	29444267	29483168	38901
EUR_202	10000	EUR	407	31087987	31151086	63099
EUR_202	10000	EUR	407	32694491	32759145	64654
EUR_202	10000	EUR	407	37754246	38097333	343087
EUR_202	10000	EUR	407	42493150	42574352	81202
EUR_202	10000	EUR	407	43359651	43453960	94309
EUR_202	10000	EUR	407	50053800	50097389	43589
EUR_202	10000	EUR	407	56378802	56448072	69270
EUR_202	10000	EUR	407	57712252	57806900	94648
EUR_202	10000	EUR	407	69023918	69060887	36969
EUR_202	10000	EUR	407	75089161	75095784	6623
EUR_202	10000	EUR	407	75552356	75597255	44899
EUR_202	10000	EUR	407	75851931	75915063	63132
EUR_202	10000	EUR	407	79082049	79134588	52539
EUR_202	10000	EUR	407	83370620	83384810	14190
EUR_202	10000	EUR	407	84755692	84760554	4862
EUR_202	10000	EUR	407	87969149	87974244	5095
EUR_202	10000	EUR	407	88219640	88382260	162620
EUR_202	10000	EUR	407	91891040	91902611	11571
EUR_202	10000	EUR	407	92008918	92171686	162768
EUR_202	10000	EUR	407	93800814	93817006	16192
EUR_202	10000	EUR	407	94290726	94418018	127292
EUR_202	10000	EUR	407	94419260	94544971	125711
EUR_202	10000	EUR	407	94805865	94819760	13895
EUR_202	10000	EUR	407	94898715	94930362	31647
EUR_203	10000	EUR	408	2593484	2648737	55253
EUR_203	10000	EUR	408	5121074	5123781	2707
EUR_203	10000	EUR	408	13621609	13626532	4923
EUR_203	10000	EUR	408	16243211	16286721	43510
EUR_203	10000	EUR	408	17687142	17689297	2155
EUR_203	10000	EUR	408	17889447	17902017	12570
EUR_203	10000	EUR	408	20981647	21202559	220912
EUR_203	10000	EUR	408	23752602	23856810	104208
EUR_203	10000	EUR	408	24081639	24166883	85244
EUR_203	10000	EUR	408	25847649	25855304	7655
EUR_203	10000	EUR	408	26319359	26552409	233050
EUR_203	10000	EUR	408	29444267	29483168	38901
EUR_203	10000	EUR	408	32057270	32084128	26858
EUR_203	10000	EUR	408	32824940	32828620	3680
EUR_203	10000	EUR	408	32858056	32870350	12294
EUR_203	10000	EUR	408	35091612	35095643	4031
EUR_203	10000	EUR	408	37885686	37943125	57439
EUR_203	10000	EUR	408	43359651	43471816	112165
EUR_203	10000	EUR	408	53821064	53859932	38868
EUR_203	10000	EUR	408	54123719	54150257	26538
EUR_203	10000	EUR	408	54659849	54667387	7538
EUR_203	10000	EUR	408	59631177	59631623	446
EUR_203	10000	EUR	408	72388504	72398733	10229
EUR_203	10000	EUR	408	75110846	75189189	78343
EUR_203	10000	EUR	408	79901897	79936163	34266
EUR_203	10000	EUR	408	81031954	81036282	4328
EUR_203	10000	EUR	408	88761110	89047979	286869
EUR_203	10000	EUR	408	89084957	89124034	39077
EUR_203	10000	EUR	408	90487279	90532466	45187
EUR_203	10000	EUR	408	90972791	91089410	116619
EUR_203	10000	EUR	408	91847626	91929323	81697
EUR_203	10000	EUR	408	92062604	92171686	109082
EUR_203	10000	EUR	408	93553045	93567584	14539
EUR_203	10000	EUR	408	96229638	96241778	12140
EUR_203	10000	EUR	409	1330157	1336755	6598
EUR_203	10000	EUR	409	1762556	1793930	31374
EUR_203	10000	EUR	409	1951091	1959936	8845
EUR_203	10000	EUR	409	3963309	4130169	166860
EUR_203	10000	EUR	409	5121074	5123781	2707
EUR_203	10000	EUR	409	21150173	21156082	5909
EUR_203	10000	EUR	409	21200799	21216283	15484
EUR_203	10000	EUR	409	23176150	23184805	8655
EUR_203	10000	EUR	409	24045382	24155650	110268
EUR_203	10000	EUR	409	24734599	24737906	3307
EUR_203	10000	EUR	409	26477051	26507298	30247
EUR_203	10000	EUR	409	26886230	26972181	85951
EUR_203	10000	EUR	409	29291099	29311528	20429
EUR_203	10000	EUR	409	31233297	31314394	81097
EUR_203	10000	EUR	409	31478668	31502542	23874
EUR_203	10000	EUR	409	32081977	32141896	59919
EUR_203	10000	EUR	409	33143811	33166924	23113
EUR_203	10000	EUR	409	37727446	37817231	89785
EUR_203	10000	EUR	409	40047500	40068128	20628
EUR_203	10000	EUR	409	43556834	43624720	67886
EUR_203	10000	EUR	409	53826246	53994973	168727
EUR_203	10000	EUR	409	54503155	54577206	74051
EUR_203	10000	EUR	409	56378802	56448072	69270
EUR_203	10000	EUR	409	57204714	57291065	86351
EUR_203	10000	EUR	409	59464397	59522281	57884
EUR_203	10000	EUR	409	69023918	69060887	36969
EUR_203	10000	EUR	409	73039375	73160136	120761
EUR_203	10000	EUR	409	73488506	73493479	4973
EUR_203	10000	EUR	409	74581736	74738891	157155
EUR_203	10000	EUR	409	74889460	74894548	5088
EUR_203	10000	EUR	409	77733985	77735979	1994
EUR_203	10000	EUR	409	78846360	78860876	14516
EUR_203	10000	EUR	409	78990132	79071109	80977
EUR_203	10000	EUR	409	80852609	80890918	38309
EUR_203	10000	EUR	409	83886982	83921060	34078
EUR_203	10000	EUR	409	88452177	88464514	12337
EUR_203	10000	EUR	409	88789226	88961976	172750
EUR_203	10000	EUR	409	90195857	90275500	79643
EUR_203	10000	EUR	409	91531949	91566381	34432
EUR_203	10000	EUR	409	91891040	91902611	11571
EUR_203	10000	EUR	409	94447447	94522438	74991
EUR_203	10000	EUR	409	96264202	96339914	75712
EUR_203	10000	EUR	409	96988153	96992855	4702
EUR_204	10000	EUR	410	1361900	1385444	23544
EUR_204	10000	EUR	410	3963309	4004848	41539
EUR_204	10000	EUR	410	4458174	4517103	58929
EUR_204	10000	EUR	410	11778115	11814111	35996
EUR_204	10000	EUR	410	13574314	13635433	61119
EUR_204	10000	EUR	410	13640984	13678187	37203
EUR_204	10000	EUR	410	14051019	14112508	61489
EUR_204	10000	EUR	410	16248080	16291005	42925
EUR_204	10000	EUR	410	18310807	18323451	12644
EUR_204	10000	EUR	410	18622886	18678327	55441
EUR_204	10000	EUR	410	22519633	22533171	13538
EUR_204	10000	EUR	410	23648833	23650239	1406
EUR_204	10000	EUR	410	24621120	24737906	116786
EUR_204	10000	EUR	410	25140534	25305885	165351
EUR_204	10000	EUR	410	25817587	25841457	23870
EUR_204	10000	EUR	410	29306591	29347390	40799
EUR_204	10000	EUR	410	29347606	29579668	232062
EUR_204	10000	EUR	410	30976914	31127610	150696
EUR_204	10000	EUR	410	32730368	32759145	28777
EUR_204	10000	EUR	410	32851725	32880042	28317
EUR_204	10000	EUR	410	33430359	33479750	49391
EUR_204	10000	EUR	410	36056184	36089268	33084
EUR_204	10000	EUR	410	36663539	36678544	15005
EUR_204	10000	EUR	410	40410992	40508892	97900
EUR_204	10000	EUR	410	41319133	41360462	41329
EUR_204	10000	EUR	410	42542529	42550782	8253
EUR_204	10000	EUR	410	50053800	50097389	43589
EUR_204	10000	EUR	410	53821064	54035252	214188
EUR_204	10000	EUR	410	58580135	58597337	17202
EUR_204	10000	EUR	410	59513660	59522281	8621
EUR_204	10000	EUR	410	63714218	63732455	18237
EUR_204	10000	EUR	410	69880538	69942832	62294
EUR_204	10000	EUR	410	70541408	70544348	2940
EUR_204	10000	EUR	410	72288615	72298050	9435
EUR_204	10000	EUR	410	74595799	74699907	104108
EUR_204	10000	EUR	410	75851931	75868347	16416
EUR_204	10000	EUR	410	76022322	76143984	121662
EUR_204	10000	EUR	410	80135541	80139395	3854
EUR_204	10000	EUR	410	81059267	81108910	49643
EUR_204	10000	EUR	410	83886982	83921060	34078
EUR_204	10000	EUR	410	84755692	84810053	54361
EUR_204	10000	EUR	410	87369479	87389813	20334
EUR_204	10000	EUR	410	87580327	87631398	51071
EUR_204	10000	EUR	410	88761110	88877947	116837
EUR_204	10000	EUR	410	90058636	90243516	184880
EUR_204	10000	EUR	410	91018779	91107582	88803
EUR_204	10000	EUR	410	93680632	93680672	40
EUR_204	10000	EUR	410	94239181	94337048	97867
EUR_204	10000	EUR	410	94348955	94375754	26799
EUR_204	10000	EUR	410	94793518	95011492	217974
EUR_204	10000	EUR	410	96136238	96175807	39569
EUR_204	10000	EUR	411	3763591	3801794	38203
EUR_204	10000	EUR	411	8348919	8386102	37183
EUR_204	10000	EUR	411	9149188	9164904	15716
EUR_204	10000	EUR	411	13621609	13626532	4923
EUR_204	10000	EUR	411	17918899	18041675	122776
EUR_204	10000	EUR	411	21164327	21282925	118598
EUR_204	10000	EUR	411	23176150	23183923	7773
EUR_204	10000	EUR	411	23648833	23651476	2643
EUR_204	10000	EUR	411	25867195	25906725	39530
EUR_204	10000	EUR	411	26477051	26562248	85197
EUR_204	10000	EUR	411	29306591	29347390	40799
EUR_204	10000	EUR	411	29347606	29396432	48826
EUR_204	10000	EUR	411	30976914	31127610	150696
EUR_204	10000	EUR	411	35084593	35087281	2688
EUR_204	10000	EUR	411	37776227	37804686	28459
EUR_204	10000	EUR	411	43359651	43471816	112165
EUR_204	10000	EUR	411	54570690	54609491	38801
EUR_204	10000	EUR	411	58580135	58694180	114045
EUR_204	10000	EUR	411	59464397	59522281	57884
EUR_204	10000	EUR	411	64410265	64519080	108815
EUR_204	10000	EUR	411	72961212	73172795	211583
EUR_204	10000	EUR	411	73645076	73700859	55783
EUR_204	10000	EUR	411	76567582	76572244	4662
EUR_204	10000	EUR	411	80999290	81087964	88674
EUR_204	10000	EUR	411	87504329	87507341	3012
EUR_204	10000	EUR	411	88211398	88319207	107809
EUR_204	10000	EUR	411	88908199	88915947	7748
EUR_204	10000	EUR	411	89189593	89235318	45725
EUR_204	10000	EUR	411	91891040	91902611	11571
EUR_204	10000	EUR	411	93702886	93713967	11081
EUR_204	10000	EUR	411	94447447	94522438	74991
EUR_204	10000	EUR	411	94915497	94930362	14865
EUR_205	10000	EUR	412	3963309	4029447	66138
EUR_205	10000	EUR	412	4111555	4119644	8089
EUR_205	10000	EUR	412	5253381	5312534	59153
EUR_205	10000	EUR	412	8662954	8714283	51329
EUR_205	10000	EUR	412	14051019	14108442	57423
EUR_205	10000	EUR	412	16243211	16286721	43510
EUR_205	10000	EUR	412	18655119	18751123	96004
EUR_205	10000	EUR	412	21150173	21156082	5909
EUR_205	10000	EUR	412	21200799	21216283	15484
EUR_205	10000	EUR	412	23721919	23797839	75920
EUR_205	10000	EUR	412	24621120	24737906	116786
EUR_205	10000	EUR	412	24809049	24866754	57705
EUR_205	10000	EUR	412	25323974	25357719	33745
EUR_205	10000	EUR	412	28111916	28139866	27950
EUR_205	10000	EUR	412	32057270	32124528	67258
EUR_205	10000	EUR	412	34124908	34182116	57208
EUR_205	10000	EUR	412	35887157	35892995	5838
EUR_205	10000	EUR	412	36350791	36460007	109216
EUR_205	10000	EUR	412	38062578	38097333	34755
EUR_205	10000	EUR	412	39683574	39692065	8491
EUR_205	10000	EUR	412	53835895	53837891	1996
EUR_205	10000	EUR	412	58863206	58863428	222
EUR_205	10000	EUR	412	64496625	64519080	22455
EUR_205	10000	EUR	412	69023918	69060887	36969
EUR_205	10000	EUR	412	71447073	71457991	10918
EUR_205	10000	EUR	412	74032464	74067213	34749
EUR_205	10000	EUR	412	75110846	75189189	78343
EUR_205	10000	EUR	412	77751346	77795912	44566
EUR_205	10000	EUR	412	79901897	79936163	34266
EUR_205	10000	EUR	412	83533777	83550130	16353
EUR_205	10000	EUR	412	83955315	83957574	2259
EUR_205	10000	EUR	412	85353810	85405856	52046
EUR_205	10000	EUR	412	88077880	88161538	83658
EUR_205	10000	EUR	412	94447447	94522438	74991
EUR_205	10000	EUR	412	94532669	94544971	12302
EUR_205	10000	EUR	412	99256882	99280798	23916
EUR_205	10000	EUR	413	2415974	2702115	286141
EUR_205	10000	EUR	413	17889447	17902017	12570
EUR_205	10000	EUR	413	18716646	18844474	127828
EUR_205	10000	EUR	413	23752602	23856810	104208
EUR_205	10000	EUR	413	24045382	24166883	121501
EUR_205	10000	EUR	413	24372241	24384508	12267
EUR_205	10000	EUR	413	25323974	25378298	54324
EUR_205	10000	EUR	413	25868315	25896396	28081
EUR_205	10000	EUR	413	25971191	25987107	15916
EUR_205	10000	EUR	413	26849817	26889089	39272
EUR_205	10000	EUR	413	27956636	27974945	18309
EUR_205	10000	EUR	413	29347606	29396432	48826
EUR_205	10000	EUR	413	29501911	29579668	77757
EUR_205	10000	EUR	413	31087987	31109532	21545
EUR_205	10000	EUR	413	39639062	39692065	53003
EUR_205	10000	EUR	413	40410992	40424856	13864
EUR_205	10000	EUR	413	43359651	43515922	156271
EUR_205	10000	EUR	413	50085590	50097389	11799
EUR_205	10000	EUR	413	52168283	52224193	55910
EUR_205	10000	EUR	413	54313684	54362674	48990
EUR_205	10000	EUR	413	56378802	56448072	69270
EUR_205	10000	EUR	413	63714218	63732455	18237
EUR_205	10000	EUR	413	64372692	64406792	34100
EUR_205	10000	EUR	413	72288615	72398733	110118
EUR_205	10000	EUR	413	72994673	73022663	27990
EUR_205	10000	EUR	413	76137655	76143984	6329
EUR_205	10000	EUR	413	77880564	77881732	1168
EUR_205	10000	EUR	413	79901897	79936163	34266
EUR_205	10000	EUR	413	83370620	83384810	14190
EUR_205	10000	EUR	413	88221167	88300295	79128
EUR_205	10000	EUR	413	88324698	88412977	88279
EUR_205	10000	EUR	413	88908199	88915947	7748
EUR_205	10000	EUR	413	89189593	89235318	45725
EUR_205	10000	EUR	413	91891040	91902611	11571
EUR_205	10000	EUR	413	93553045	93713967	160922
EUR_205	10000	EUR	413	93908281	93925519	17238
EUR_205	10000	EUR	413	94915497	94930362	14865
EUR_205	10000	EUR	413	94962888	95011492	48604
EUR_205	10000	EUR	413	96136238	96175807	39569
EUR_206	10000	EUR	414	1762556	1775693	13137
EUR_206	10000	EUR	414	2454787	2527168	72381
EUR_206	10000	EUR	414	3285306	3302065	16759
EUR_206	10000	EUR	414	9413335	9449917	36582
EUR_206	10000	EUR	414	11703759	11708397	4638
EUR_206	10000	EUR	414	13592472	13805391	212919
EUR_206	10000	EUR	414	16234928	16286721	51793
EUR_206	10000	EUR	414	22519633	22533171	13538
EUR_206	10000	EUR	414	22992959	23099324	106365
EUR_206	10000	EUR	414	23156936	23184805	27869
EUR_206	10000	EUR	414	23863969	23877108	13139
EUR_206	10000	EUR	414	24045382	24166883	121501
EUR_206	10000	EUR	414	24528522	24581630	53108
EUR_206	10000	EUR	414	24892444	24906091	13647
EUR_206	10000	EUR	414	25343770	25501390	157620
EUR_206	10000	EUR	414	29306591	29341169	34578
EUR_206	10000	EUR	414	32081977	32141896	59919
EUR_206	10000	EUR	414	33245767	33429152	183385
EUR_206	10000	EUR	414	34136759	34182116	45357
EUR_206	10000	EUR	414	35887157	35892995	5838
EUR_206	10000	EUR	414	36744092	36864514	120422
EUR_206	10000	EUR	414	37809118	37815963	6845
EUR_206	10000	EUR	414	40410992	40495016	84024
EUR_206	10000	EUR	414	40861764	40889660	27896
EUR_206	10000	EUR	414	40973349	41037792	64443
EUR_206	10000	EUR	414	43359651	43453960	94309
EUR_206	10000	EUR	414	53889936	54053346	163410
EUR_206	10000	EUR	414	54113043	54129534	16491
EUR_206	10000	EUR	414	54686744	54688209	1465
EUR_206	10000	EUR	414	63714218	63732455	18237
EUR_206	10000	EUR	414	71722082	71732410	10328
EUR_206	10000	EUR	414	72964182	73160627	196445
EUR_206	10000	EUR	414	73498527	73660589	162062
EUR_206	10000	EUR	414	76567582	76594146	26564
EUR_206	10000	EUR	414	77751346	77795912	44566
EUR_206	10000	EUR	414	79860282	79933512	73230
EUR_206	10000	EUR	414	83533777	83550130	16353
EUR_206	10000	EUR	414	83554127	83592822	38695
EUR_206	10000	EUR	414	84898186	84919115	20929
EUR_206	10000	EUR	414	85377298	85405856	28558
EUR_206	10000	EUR	414	87369479	87389813	20334
EUR_206	10000	EUR	414	87650695	87656802	6107
EUR_206	10000	EUR	414	88219640	88357321	137681
EUR_206	10000	EUR	414	88877686	88915947	38261
EUR_206	10000	EUR	414	93553045	93607994	54949
EUR_206	10000	EUR	414	94793518	94950031	156513
EUR_206	10000	EUR	415	3963309	4000297	36988
EUR_206	10000	EUR	415	13621609	13626532	4923
EUR_206	10000	EUR	415	14053026	14108442	55416
EUR_206	10000	EUR	415	16234928	16286721	51793
EUR_206	10000	EUR	415	21150173	21156082	5909
EUR_206	10000	EUR	415	21224963	21225412	449
EUR_206	10000	EUR	415	24081636	24094707	13071
EUR_206	10000	EUR	415	24380643	24581630	200987
EUR_206	10000	EUR	415	25162449	25162865	416
EUR_206	10000	EUR	415	25189085	25217171	28086
EUR_206	10000	EUR	415	25323974	25378298	54324
EUR_206	10000	EUR	415	26319359	26450313	130954
EUR_206	10000	EUR	415	26849817	26883308	33491
EUR_206	10000	EUR	415	29291099	29311528	20429
EUR_206	10000	EUR	415	30904434	30925177	20743
EUR_206	10000	EUR	415	31087987	31151086	63099
EUR_206	10000	EUR	415	32057270	32084128	26858
EUR_206	10000	EUR	415	34845302	34926785	81483
EUR_206	10000	EUR	415	37727611	37861599	133988
EUR_206	10000	EUR	415	40861764	41134712	272948
EUR_206	10000	EUR	415	43359651	43471816	112165
EUR_206	10000	EUR	415	57712252	57806900	94648
EUR_206	10000	EUR	415	59439907	59522281	82374
EUR_206	10000	EUR	415	64496625	64519080	22455
EUR_206	10000	EUR	415	72288615	72398733	110118
EUR_206	10000	EUR	415	73633815	73702901	69086
EUR_206	10000	EUR	415	74019705	74094072	74367
EUR_206	10000	EUR	415	77733985	77735979	1994
EUR_206	10000	EUR	415	80863277	80899276	35999
EUR_206	10000	EUR	415	80946931	81032996	86065
EUR_206	10000	EUR	415	83955315	83957574	2259
EUR_206	10000	EUR	415	87369479	87389813	20334
EUR_206	10000	EUR	415	87650695	87656802	6107
EUR_206	10000	EUR	415	88258345	88319207	60862
EUR_206	10000	EUR	415	88527647	88679238	151591
EUR_206	10000	EUR	415	88761110	88856646	95536
EUR_206	10000	EUR	415	89076084	89081743	5659
EUR_206	10000	EUR	415	91552179	91637603	85424
EUR_206	10000	EUR	415	93628871	93713967	85096
EUR_206	10000	EUR	415	94595895	94701010	105115
EUR_206	10000	EUR	415	96116814	96220219	103405
EUR_207	10000	EUR	416	16335052	16345906	10854
EUR_207	10000	EUR	416	21164327	21282925	118598
EUR_207	10000	EUR	416	22365602	22393602	28000
EUR_207	10000	EUR	416	22519633	22533171	13538
EUR_207	10000	EUR	416	23752602	23856810	104208
EUR_207	10000	EUR	416	24621120	24736323	115203
EUR_207	10000	EUR	416	25285126	25293981	8855
EUR_207	10000	EUR	416	26477051	26562248	85197
EUR_207	10000	EUR	416	26946861	26991485	44624
EUR_207	10000	EUR	416	29444267	29483168	38901
EUR_207	10000	EUR	416	31233297	31314394	81097
EUR_207	10000	EUR	416	31478668	31502542	23874
EUR_207	10000	EUR	416	35771774	35849669	77895
EUR_207	10000	EUR	416	42164278	42208086	43808
EUR_207	10000	EUR	416	53875418	53947462	72044
EUR_207	10000	EUR	416	54659849	54665953	6104
EUR_207	10000	EUR	416	59423469	59440361	16892
EUR_207	10000	EUR	416	59683857	59696190	12333
EUR_207	10000	EUR	416	68675332	68701435	26103
EUR_207	10000	EUR	416	73595375	73660589	65214
EUR_207	10000	EUR	416	73884457	73906350	21893
EUR_207	10000	EUR	416	76137655	76143984	6329
EUR_207	10000	EUR	416	79860282	79933512	73230
EUR_207	10000	EUR	416	83533777	83550130	16353
EUR_207	10000	EUR	416	84877445	84919115	41670
EUR_207	10000	EUR	416	88452177	88464514	12337
EUR_207	10000	EUR	416	88476761	88537179	60418
EUR_207	10000	EUR	416	91847626	91875197	27571
EUR_207	10000	EUR	416	92062604	92105471	42867
EUR_207	10000	EUR	416	93123848	93146996	23148
EUR_207	10000	EUR	416	93318121	93371609	53488
EUR_207	10000	EUR	416	93800814	93852835	52021
EUR_207	10000	EUR	416	93908281	93925519	17238
EUR_207	10000	EUR	416	94297447	94418018	120571
EUR_207	10000	EUR	416	94419260	94544971	125711
EUR_207	10000	EUR	416	95774147	95776143	1996
EUR_207	10000	EUR	416	96144084	96220219	76135
EUR_207	10000	EUR	417	1330157	1385444	55287
EUR_207	10000	EUR	417	2506997	2702115	195118
EUR_207	10000	EUR	417	2996253	2997995	1742
EUR_207	10000	EUR	417	5018475	5041230	22755
EUR_207	10000	EUR	417	8348919	8385134	36215
EUR_207	10000	EUR	417	14051019	14108442	57423
EUR_207	10000	EUR	417	16243211	16293593	50382
EUR_207	10000	EUR	417	18716646	18844474	127828
EUR_207	10000	EUR	417	21149491	21223896	74405
EUR_207	10000	EUR	417	23721919	23797839	75920
EUR_207	10000	EUR	417	24580740	24581630	890
EUR_207	10000	EUR	417	25868315	25896396	28081
EUR_207	10000	EUR	417	29306591	29478208	171617
EUR_207	10000	EUR	417	31040663	31092945	52282
EUR_207	10000	EUR	417	32667412	32667833	421
EUR_207	10000	EUR	417	34136759	34138136	1377
EUR_207	10000	EUR	417	35437965	35584975	147010
EUR_207	10000	EUR	417	37791435	37895954	104519
EUR_207	10000	EUR	417	40083840	40137080	53240
EUR_207	10000	EUR	417	40410992	40502818	91826
EUR_207	10000	EUR	417	40572310	40602505	30195
EUR_207	10000	EUR	417	40901145	41024466	123321
EUR_207	10000	EUR	417	43427932	43471816	43884
EUR_207	10000	EUR	417	53821620	53873347	51727
EUR_207	10000	EUR	417	59208358	59245710	37352
EUR_207	10000	EUR	417	59674842	59696190	21348
EUR_207	10000	EUR	417	64338347	64519080	180733
EUR_207	10000	EUR	417	68675332	68717300	41968
EUR_207	10000	EUR	417	72359726	72373817	14091
EUR_207	10000	EUR	417	77733985	77735979	1994
EUR_207	10000	EUR	417	80135541	80139395	3854
EUR_207	10000	EUR	417	81107841	81229503	121662
EUR_207	10000	EUR	417	85683081	85705213	22132
EUR_207	10000	EUR	417	88077880	88161538	83658
EUR_207	10000	EUR	417	91891040	91902611	11571
EUR_207	10000	EUR	417	93628871	93713967	85096
EUR_207	10000	EUR	417	94898715	94930362	31647
EUR_208	10000	EUR	418	2519034	2648737	129703
EUR_208	10000	EUR	418	2984450	2997995	13545
EUR_208	10000	EUR	418	4091052	4126878	35826
EUR_208	10000	EUR	418	5018475	5041230	22755
EUR_208	10000	EUR	418	8712318	8714283	1965
EUR_208	10000	EUR	418	9413335	9449917	36582
EUR_208	10000	EUR	418	12764351	12780195	15844
EUR_208	10000	EUR	418	16202082	16325554	123472
EUR_208	10000	EUR	418	17919269	17953987	34718
EUR_208	10000	EUR	418	18100331	18140078	39747
EUR_208	10000	EUR	418	28111916	28139866	27950
EUR_208	10000	EUR	418	29347606	29396432	48826
EUR_208	10000	EUR	418	32731788	32870350	138562
EUR_208	10000	EUR	418	49765478	49856342	90864
EUR_208	10000	EUR	418	49860683	49899094	38411
EUR_208	10000	EUR	418	51953708	52007205	53497
EUR_208	10000	EUR	418	53821064	53931126	110062
EUR_208	10000	EUR	418	64857298	64922329	65031
EUR_208	10000	EUR	418	69023918	69060887	36969
EUR_208	10000	EUR	418	72994673	73022663	27990
EUR_208	10000	EUR	418	75263541	75282527	18986
EUR_208	10000	EUR	418	76022322	76093521	71199
EUR_208	10000	EUR	418	76566986	76594146	27160
EUR_208	10000	EUR	418	81031954	81036282	4328
EUR_208	10000	EUR	418	83533777	83550130	16353
EUR_208	10000	EUR	418	83554127	83592822	38695
EUR_208	10000	EUR	418	84898186	84919115	20929
EUR_208	10000	EUR	418	85377298	85405856	28558
EUR_208	10000	EUR	418	88452177	88464514	12337
EUR_208	10000	EUR	418	88476761	88537179	60418
EUR_208	10000	EUR	418	89989980	89998439	8459
EUR_208	10000	EUR	418	91011409	91060943	49534
EUR_208	10000	EUR	418	94915497	94930362	14865
EUR_208	10000	EUR	418	96379020	96546756	167736
EUR_208	10000	EUR	418	96665448	96921990	256542
EUR_208	10000	EUR	419	1853096	1854996	1900
EUR_208	10000	EUR	419	2415974	2435603	19629
EUR_208	10000	EUR	419	14051019	14054804	3785
EUR_208	10000	EUR	419	16243211	16367500	124289
EUR_208	10000	EUR	419	22519633	22533171	13538
EUR_208	10000	EUR	419	23176150	23183923	7773
EUR_208	10000	EUR	419	24892444	24906091	13647
EUR_208	10000	EUR	419	25162449	25162865	416
EUR_208	10000	EUR	419	25189085	25217171	28086
EUR_208	10000	EUR	419	25323974	25378298	54324
EUR_208	10000	EUR	419	25817587	25841457	23870
EUR_208	10000	EUR	419	27746608	27834359	87751
EUR_208	10000	EUR	419	28645700	28663032	17332
EUR_208	10000	EUR	419	29373765	29390654	16889
EUR_208	10000	EUR	419	30904434	31040753	136319
EUR_208	10000	EUR	419	31528053	31593163	65110
EUR_208	10000	EUR	419	32170839	32187563	16724
EUR_208	10000	EUR	419	32667412	32870350	202938
EUR_208	10000	EUR	419	35091612	35095643	4031
EUR_208	10000	EUR	419	35887157	35892995	5838
EUR_208	10000	EUR	419	37858951	38097333	238382
EUR_208	10000	EUR	419	43635671	43653793	18122
EUR_208	10000	EUR	419	49828382	49856342	27960
EUR_208	10000	EUR	419	49860683	49899094	38411
EUR_208	10000	EUR	419	54843018	54904011	60993
EUR_208	10000	EUR	419	57194879	57291065	96186
EUR_208	10000	EUR	419	59423469	59440361	16892
EUR_208	10000	EUR	419	59554189	59607931	53742
EUR_208	10000	EUR	419	68667259	68713281	46022
EUR_208	10000	EUR	419	69809636	69942832	133196
EUR_208	10000	EUR	419	70541408	70544348	2940
EUR_208	10000	EUR	419	73209823	73223816	13993
EUR_208	10000	EUR	419	73519049	73675439	156390
EUR_208	10000	EUR	419	74640712	74701524	60812
EUR_208	10000	EUR	419	76022322	76143984	121662
EUR_208	10000	EUR	419	78697685	78785374	87689
EUR_208	10000	EUR	419	79860282	79933512	73230
EUR_208	10000	EUR	419	80874989	80899585	24596
EUR_208	10000	EUR	419	81107841	81229503	121662
EUR_208	10000	EUR	419	85683081	85705213	22132
EUR_208	10000	EUR	419	88025602	88030185	4583
EUR_208	10000	EUR	419	88087834	88201158	113324
EUR_208	10000	EUR	419	88219640	88363592	143952
EUR_208	10000	EUR	419	88527647	88679238	151591
EUR_208	10000	EUR	419	88761110	89081743	320633
EUR_208	10000	EUR	419	91891040	91902611	11571
EUR_208	10000	EUR	419	93628871	93713967	85096
EUR_209	10000	EUR	420	24621120	24666053	44933
EUR_209	10000	EUR	420	25153328	25215904	62576
EUR_209	10000	EUR	420	25325282	25351680	26398
EUR_209	10000	EUR	420	25880739	25896396	15657
EUR_209	10000	EUR	420	25971191	25987107	15916
EUR_209	10000	EUR	420	26319359	26525365	206006
EUR_209	10000	EUR	420	26575524	26580898	5374
EUR_209	10000	EUR	420	29306591	29347390	40799
EUR_209	10000	EUR	420	29347606	29396432	48826
EUR_209	10000	EUR	420	31235544	31314394	78850
EUR_209	10000	EUR	420	32081977	32141896	59919
EUR_209	10000	EUR	420	37777055	37779396	2341
EUR_209	10000	EUR	420	39681230	39692065	10835
EUR_209	10000	EUR	420	40142894	40145306	2412
EUR_209	10000	EUR	420	40572310	40602505	30195
EUR_209	10000	EUR	420	40861764	41076995	215231
EUR_209	10000	EUR	420	54686744	54688209	1465
EUR_209	10000	EUR	420	54714203	54904011	189808
EUR_209	10000	EUR	420	58093392	58136140	42748
EUR_209	10000	EUR	420	68675332	68717300	41968
EUR_209	10000	EUR	420	69809636	69864575	54939
EUR_209	10000	EUR	420	72375810	72408775	32965
EUR_209	10000	EUR	420	79860282	79933512	73230
EUR_209	10000	EUR	420	81175932	81229503	53571
EUR_209	10000	EUR	420	83548561	83550130	1569
EUR_209	10000	EUR	420	83554127	83592822	38695
EUR_209	10000	EUR	420	85398398	85405856	7458
EUR_209	10000	EUR	420	86508335	86539843	31508
EUR_209	10000	EUR	420	88452177	88464514	12337
EUR_209	10000	EUR	420	88476761	88537179	60418
EUR_209	10000	EUR	420	89054631	89235318	180687
EUR_209	10000	EUR	420	91891040	91902611	11571
EUR_209	10000	EUR	420	93308720	93312065	3345
EUR_209	10000	EUR	420	94164542	94313443	148901
EUR_209	10000	EUR	420	96229638	96336399	106761
EUR_209	10000	EUR	420	99177558	99280798	103240
EUR_209	10000	EUR	421	1853096	1854996	1900
EUR_209	10000	EUR	421	2546510	2648737	102227
EUR_209	10000	EUR	421	5121074	5123781	2707
EUR_209	10000	EUR	421	9149188	9164904	15716
EUR_209	10000	EUR	421	23721919	23771929	50010
EUR_209	10000	EUR	421	24101175	24155650	54475
EUR_209	10000	EUR	421	24485266	24581630	96364
EUR_209	10000	EUR	421	24866126	24866754	628
EUR_209	10000	EUR	421	26375604	26436121	60517
EUR_209	10000	EUR	421	26580016	26580898	882
EUR_209	10000	EUR	421	27746608	27974945	228337
EUR_209	10000	EUR	421	31547733	31636518	88785
EUR_209	10000	EUR	421	35091612	35095643	4031
EUR_209	10000	EUR	421	40410992	40498219	87227
EUR_209	10000	EUR	421	40861764	41076094	214330
EUR_209	10000	EUR	421	49714605	49899094	184489
EUR_209	10000	EUR	421	53821064	53887824	66760
EUR_209	10000	EUR	421	54711881	54714097	2216
EUR_209	10000	EUR	421	59752756	59762964	10208
EUR_209	10000	EUR	421	72288615	72298050	9435
EUR_209	10000	EUR	421	74595799	74699907	104108
EUR_209	10000	EUR	421	75851931	75868347	16416
EUR_209	10000	EUR	421	76022322	76143984	121662
EUR_209	10000	EUR	421	80135541	80139395	3854
EUR_209	10000	EUR	421	81059267	81108910	49643
EUR_209	10000	EUR	421	83886982	83921060	34078
EUR_209	10000	EUR	421	84755692	84810053	54361
EUR_209	10000	EUR	421	87369479	87389813	20334
EUR_209	10000	EUR	421	87580327	87751923	171596
EUR_209	10000	EUR	421	88877686	88914997	37311
EUR_209	10000	EUR	421	89076084	89081743	5659
EUR_209	10000	EUR	421	91552179	91637603	85424
EUR_209	10000	EUR	421	93800814	93869231	68417
EUR_209	10000	EUR	421	94482552	94538222	55670
EUR_210	10000	EUR	422	166193	340142	173949
EUR_210	10000	EUR	422	2415974	2702115	286141
EUR_210	10000	EUR	422	2996253	2997995	1742
EUR_210	10000	EUR	422	4020191	4044195	24004
EUR_210	10000	EUR	422	9414397	9449917	35520
EUR_210	10000	EUR	422	11532006	11542173	10167
EUR_210	10000	EUR	422	16234928	16286721	51793
EUR_210	10000	EUR	422	17749730	17813082	63352
EUR_210	10000	EUR	422	21093849	21390474	296625
EUR_210	10000	EUR	422	22523307	22533171	9864
EUR_210	10000	EUR	422	23122511	23184805	62294
EUR_210	10000	EUR	422	24580740	24581630	890
EUR_210	10000	EUR	422	24892444	24906091	13647
EUR_210	10000	EUR	422	27746608	27894364	147756
EUR_210	10000	EUR	422	29273800	29300000	26200
EUR_210	10000	EUR	422	30804231	30889504	85273
EUR_210	10000	EUR	422	34136759	34182116	45357
EUR_210	10000	EUR	422	35091612	35095643	4031
EUR_210	10000	EUR	422	36350791	36376380	25589
EUR_210	10000	EUR	422	36663539	36678544	15005
EUR_210	10000	EUR	422	40410992	40495016	84024
EUR_210	10000	EUR	422	40973349	41037792	64443
EUR_210	10000	EUR	422	42533340	42550782	17442
EUR_210	10000	EUR	422	43359651	43471816	112165
EUR_210	10000	EUR	422	49735613	49899094	163481
EUR_210	10000	EUR	422	53821064	53842770	21706
EUR_210	10000	EUR	422	54570690	54612977	42287
EUR_210	10000	EUR	422	59650996	59762964	111968
EUR_210	10000	EUR	422	88221167	88300295	79128
EUR_210	10000	EUR	422	88324698	88412977	88279
EUR_210	10000	EUR	422	88908199	88915947	7748
EUR_210	10000	EUR	422	89189593	89235318	45725
EUR_210	10000	EUR	422	91891040	91902611	11571
EUR_210	10000	EUR	422	93628871	93713967	85096
EUR_210	10000	EUR	422	96116814	96161396	44582
EUR_210	10000	EUR	423	2492488	2568492	76004
EUR_210	10000	EUR	423	11729237	11814111	84874
EUR_210	10000	EUR	423	16582116	16622814	40698
EUR_210	10000	EUR	423	16633422	16681323	47901
EUR_210	10000	EUR	423	18339554	18368143	28589
EUR_210	10000	EUR	423	18536950	18538440	1490
EUR_210	10000	EUR	423	25285126	25293981	8855
EUR_210	10000	EUR	423	26477051	26562248	85197
EUR_210	10000	EUR	423	31087987	31138800	50813
EUR_210	10000	EUR	423	32039879	32057645	17766
EUR_210	10000	EUR	423	32431231	32446630	15399
EUR_210	10000	EUR	423	32824940	32830826	5886
EUR_210	10000	EUR	423	35437965	35584975	147010
EUR_210	10000	EUR	423	37705403	37749485	44082
EUR_210	10000	EUR	423	37809118	37815963	6845
EUR_210	10000	EUR	423	40555384	40602505	47121
EUR_210	10000	EUR	423	40973349	41037792	64443
EUR_210	10000	EUR	423	42473584	42545802	72218
EUR_210	10000	EUR	423	53847831	53859932	12101
EUR_210	10000	EUR	423	54411291	54622189	210898
EUR_210	10000	EUR	423	54693132	54767938	74806
EUR_210	10000	EUR	423	54893690	54904011	10321
EUR_210	10000	EUR	423	59464397	59522281	57884
EUR_210	10000	EUR	423	79901897	79910575	8678
EUR_210	10000	EUR	423	80135541	80139395	3854
EUR_210	10000	EUR	423	81059267	81108910	49643
EUR_210	10000	EUR	423	83886982	83921060	34078
EUR_210	10000	EUR	423	90426720	90486618	59898
EUR_210	10000	EUR	423	90916970	90939817	22847
EUR_210	10000	EUR	423	94297447	94418018	120571
EUR_210	10000	EUR	423	94419260	94544971	125711
EUR_210	10000	EUR	423	94793518	94874373	80855
EUR_210	10000	EUR	423	94915497	94930362	14865
EUR_210	10000	EUR	423	99239197	99280798	41601
EUR_211	10000	EUR	424	9149188	9164904	15716
EUR_211	10000	EUR	424	16582116	16622814	40698
EUR_211	10000	EUR	424	16670198	16681323	11125
EUR_211	10000	EUR	424	18100331	18140078	39747
EUR_211	10000	EUR	424	18622886	18751123	128237
EUR_211	10000	EUR	424	21224963	21225412	449
EUR_211	10000	EUR	424	23752602	23856810	104208
EUR_211	10000	EUR	424	25323974	25378298	54324
EUR_211	10000	EUR	424	25817587	25896396	78809
EUR_211	10000	EUR	424	26319359	26331325	11966
EUR_211	10000	EUR	424	27746608	27974945	228337
EUR_211	10000	EUR	424	28111916	28138518	26602
EUR_211	10000	EUR	424	29273800	29279379	5579
EUR_211	10000	EUR	424	30904434	30964170	59736
EUR_211	10000	EUR	424	31440500	31636518	196018
EUR_211	10000	EUR	424	40919189	41024466	105277
EUR_211	10000	EUR	424	43359651	43457750	98099
EUR_211	10000	EUR	424	69880538	69942832	62294
EUR_211	10000	EUR	424	70541408	70544348	2940
EUR_211	10000	EUR	424	74644219	74724702	80483
EUR_211	10000	EUR	424	75597441	75632489	35048
EUR_211	10000	EUR	424	78697685	78785374	87689
EUR_211	10000	EUR	424	87358390	87455574	97184
EUR_211	10000	EUR	424	88077880	88172209	94329
EUR_211	10000	EUR	424	88212981	88333763	120782
EUR_211	10000	EUR	424	88405406	88444615	39209
EUR_211	10000	EUR	424	88452177	88464514	12337
EUR_211	10000	EUR	424	88476761	88537179	60418
EUR_211	10000	EUR	424	88760668	88762816	2148
EUR_211	10000	EUR	424	91018779	91107582	88803
EUR_211	10000	EUR	424	91891040	91902611	11571
EUR_211	10000	EUR	424	93123848	93146996	23148
EUR_211	10000	EUR	424	93680632	93680672	40
EUR_211	10000	EUR	424	94447447	94522438	74991
EUR_211	10000	EUR	424	99214840	99280798	65958
EUR_211	10000	EUR	425	1330157	1385444	55287
EUR_211	10000	EUR	425	2415974	2588808	172834
EUR_211	10000	EUR	425	4020191	4044195	24004
EUR_211	10000	EUR	425	8348919	8386102	37183
EUR_211	10000	EUR	425	16202082	16325554	123472
EUR_211	10000	EUR	425	21150173	21156082	5909
EUR_211	10000	EUR	425	21200799	21216283	15484
EUR_211	10000	EUR	425	23176150	23183923	7773
EUR_211	10000	EUR	425	25264173	25276538	12365
EUR_211	10000	EUR	425	25343770	25501390	157620
EUR_211	10000	EUR	425	26886230	26972181	85951
EUR_211	10000	EUR	425	28645700	28663032	17332
EUR_211	10000	EUR	425	39681230	39692065	10835
EUR_211	10000	EUR	425	43443784	43453960	10176
EUR_211	10000	EUR	425	50053800	50097389	43589
EUR_211	10000	EUR	425	54673850	54688593	14743
EUR_211	10000	EUR	425	57149895	57291065	141170
EUR_211	10000	EUR	425	57712252	57803873	91621
EUR_211	10000	EUR	425	57857678	57861351	3673
EUR_211	10000	EUR	425	59464397	59490327	25930
EUR_211	10000	EUR	425	73167084	73172795	5711
EUR_211	10000	EUR	425	73488506	73493479	4973
EUR_211	10000	EUR	425	73815588	73906350	90762
EUR_211	10000	EUR	425	74410856	74438736	27880
EUR_211	10000	EUR	425	77751346	77795912	44566
EUR_211	10000	EUR	425	81113251	81140731	27480
EUR_211	10000	EUR	425	88543868	88600577	56709
EUR_211	10000	EUR	425	93312291	93411339	99048
EUR_211	10000	EUR	425	94241722	94325814	84092
EUR_211	10000	EUR	425	95418231	95445533	27302
EUR_211	10000	EUR	425	95774147	95817637	43490
EUR_212	10000	EUR	426	166193	184169	17976
EUR_212	10000	EUR	426	1924080	1943663	19583
EUR_212	10000	EUR	426	1945682	1959936	14254
EUR_212	10000	EUR	426	9279789	9308590	28801
EUR_212	10000	EUR	426	12779446	12785371	5925
EUR_212	10000	EUR	426	16258452	16437214	178762
EUR_212	10000	EUR	426	22519633	22533171	13538
EUR_212	10000	EUR	426	23176150	23183923	7773
EUR_212	10000	EUR	426	23863969	23877108	13139
EUR_212	10000	EUR	426	24621120	24737906	116786
EUR_212	10000	EUR	426	25066876	25088413	21537
EUR_212	10000	EUR	426	25189085	25231618	42533
EUR_212	10000	EUR	426	25817587	25896396	78809
EUR_212	10000	EUR	426	29306591	29347390	40799
EUR_212	10000	EUR	426	29347606	29396432	48826
EUR_212	10000	EUR	426	31528053	31593163	65110
EUR_212	10000	EUR	426	32767431	32880042	112611
EUR_212	10000	EUR	426	33316683	33429152	112469
EUR_212	10000	EUR	426	37722669	37749485	26816
EUR_212	10000	EUR	426	37809118	37815963	6845
EUR_212	10000	EUR	426	40572310	40602505	30195
EUR_212	10000	EUR	426	40861764	40944443	82679
EUR_212	10000	EUR	426	41359664	41360462	798
EUR_212	10000	EUR	426	49714605	49846762	132157
EUR_212	10000	EUR	426	50053800	50097389	43589
EUR_212	10000	EUR	426	51948707	52003808	55101
EUR_212	10000	EUR	426	54302008	54362674	60666
EUR_212	10000	EUR	426	56442176	56448072	5896
EUR_212	10000	EUR	426	57136159	57141457	5298
EUR_212	10000	EUR	426	57188385	57259820	71435
EUR_212	10000	EUR	426	57712252	57806900	94648
EUR_212	10000	EUR	426	64803473	64922329	118856
EUR_212	10000	EUR	426	68675332	68717300	41968
EUR_212	10000	EUR	426	73060320	73172795	112475
EUR_212	10000	EUR	426	73577181	73632251	55070
EUR_212	10000	EUR	426	75263541	75282527	18986
EUR_212	10000	EUR	426	76022322	76093521	71199
EUR_212	10000	EUR	426	87533821	87546866	13045
EUR_212	10000	EUR	426	88247698	88319207	71509
EUR_212	10000	EUR	426	88761110	89081743	320633
EUR_212	10000	EUR	426	89356470	89427560	71090
EUR_212	10000	EUR	426	89989980	89998439	8459
EUR_212	10000	EUR	426	91864074	91875197	11123
EUR_212	10000	EUR	426	93553045	93607994	54949
EUR_212	10000	EUR	426	94333325	94412962	79637
EUR_212	10000	EUR	426	96136238	96175807	39569
EUR_212	10000	EUR	427	1820511	1830270	9759
EUR_212	10000	EUR	427	3963309	4029447	66138
EUR_212	10000	EUR	427	4111555	4119644	8089
EUR_212	10000	EUR	427	9235548	9308590	73042
EUR_212	10000	EUR	427	9356784	9449917	93133
EUR_212	10000	EUR	427	11703759	11708397	4638
EUR_212	10000	EUR	427	13626361	13626532	171
EUR_212	10000	EUR	427	22279659	22313169	33510
EUR_212	10000	EUR	427	23648833	23651476	2643
EUR_212	10000	EUR	427	23841523	23877108	35585
EUR_212	10000	EUR	427	24892444	24906091	13647
EUR_212	10000	EUR	427	25867195	25906960	39765
EUR_212	10000	EUR	427	26319359	26331325	11966
EUR_212	10000	EUR	427	30976914	31127610	150696
EUR_212	10000	EUR	427	32667412	32679016	11604
EUR_212	10000	EUR	427	34124908	34182116	57208
EUR_212	10000	EUR	427	35091612	35095643	4031
EUR_212	10000	EUR	427	39681230	39692065	10835
EUR_212	10000	EUR	427	40410992	40602505	191513
EUR_212	10000	EUR	427	42369514	42431902	62388
EUR_212	10000	EUR	427	43359651	43413247	53596
EUR_212	10000	EUR	427	53821064	53842770	21706
EUR_212	10000	EUR	427	54570690	54612977	42287
EUR_212	10000	EUR	427	56378802	56448072	69270
EUR_212	10000	EUR	427	57273621	57291065	17444
EUR_212	10000	EUR	427	59064557	59289101	224544
EUR_212	10000	EUR	427	59669577	59741255	71678
EUR_212	10000	EUR	427	64321831	64519080	197249
EUR_212	10000	EUR	427	73498527	73536154	37627
EUR_212	10000	EUR	427	76022322	76093521	71199
EUR_212	10000	EUR	427	76780192	76855179	74987
EUR_212	10000	EUR	427	77733985	77735979	1994
EUR_212	10000	EUR	427	81113251	81229503	116252
EUR_212	10000	EUR	427	84755692	84760330	4638
EUR_212	10000	EUR	427	87665598	87679660	14062
EUR_212	10000	EUR	427	88452177	88464514	12337
EUR_212	10000	EUR	427	88476761	88488566	11805
EUR_212	10000	EUR	427	89037352	89235318	197966
EUR_212	10000	EUR	427	90201882	90243516	41634
EUR_212	10000	EUR	427	91891040	91902611	11571
EUR_212	10000	EUR	427	93553045	93713967	160922
EUR_212	10000	EUR	427	93943380	94056780	113400
EUR_212	10000	EUR	427	94297447	94392780	95333
EUR_212	10000	EUR	427	94451319	94544971	93652
EUR_213	10000	EUR	428	340121	401572	61451
EUR_213	10000	EUR	428	16243211	16367500	124289
EUR_213	10000	EUR	428	17879034	17948724	69690
EUR_213	10000	EUR	428	18622886	18636940	14054
EUR_213	10000	EUR	428	21150173	21156082	5909
EUR_213	10000	EUR	428	21200799	21216283	15484
EUR_213	10000	EUR	428	22519633	22533171	13538
EUR_213	10000	EUR	428	23176150	23184805	8655
EUR_213	10000	EUR	428	23721919	23725831	3912
EUR_213	10000	EUR	428	24045382	24166883	121501
EUR_213	10000	EUR	428	24372241	24384508	12267
EUR_213	10000	EUR	428	25323974	25378298	54324
EUR_213	10000	EUR	428	25817587	25896396	78809
EUR_213	10000	EUR	428	31087987	31138800	50813
EUR_213	10000	EUR	428	31431938	31446638	14700
EUR_213	10000	EUR	428	32694491	32732057	37566
EUR_213	10000	EUR	428	32848174	32893781	45607
EUR_213	10000	EUR	428	34999082	35095643	96561
EUR_213	10000	EUR	428	35691557	35693478	1921
EUR_213	10000	EUR	428	36284487	36316786	32299
EUR_213	10000	EUR	428	37727611	38025102	297491
EUR_213	10000	EUR	428	39639062	39692065	53003
EUR_213	10000	EUR	428	40132875	40145306	12431
EUR_213	10000	EUR	428	43520906	43624720	103814
EUR_213	10000	EUR	428	53828533	54008815	180282
EUR_213	10000	EUR	428	54551091	54904011	352920
EUR_213	10000	EUR	428	57249879	57262845	12966
EUR_213	10000	EUR	428	69023918	69052189	28271
EUR_213	10000	EUR	428	71670386	71678663	8277
EUR_213	10000	EUR	428	73488506	73521539	33033
EUR_213	10000	EUR	428	74595799	74699907	104108
EUR_213	10000	EUR	428	76137655	76143984	6329
EUR_213	10000	EUR	428	76365488	76368751	3263
EUR_213	10000	EUR	428	80852609	80881534	28925
EUR_213	10000	EUR	428	83886982	83943271	56289
EUR_213	10000	EUR	428	88117924	88571140	453216
EUR_213	10000	EUR	428	88810221	88888114	77893
EUR_213	10000	EUR	428	89189593	89235318	45725
EUR_213	10000	EUR	428	94034997	94105458	70461
EUR_213	10000	EUR	428	94239181	94313443	74262
EUR_213	10000	EUR	428	96116814	96161396	44582
EUR_213	10000	EUR	429	5253381	5312534	59153
EUR_213	10000	EUR	429	8783056	8799713	16657
EUR_213	10000	EUR	429	9428449	9449917	21468
EUR_213	10000	EUR	429	16234928	16286721	51793
EUR_213	10000	EUR	429	21093849	21234342	140493
EUR_213	10000	EUR	429	23165262	23244178	78916
EUR_213	10000	EUR	429	23752602	23809514	56912
EUR_213	10000	EUR	429	24380643	24581630	200987
EUR_213	10000	EUR	429	24866126	24866754	628
EUR_213	10000	EUR	429	26967722	26991485	23763
EUR_213	10000	EUR	429	28111916	28139866	27950
EUR_213	10000	EUR	429	31235544	31314394	78850
EUR_213	10000	EUR	429	35556451	35627884	71433
EUR_213	10000	EUR	429	38062578	38097333	34755
EUR_213	10000	EUR	429	40410992	40424856	13864
EUR_213	10000	EUR	429	41319133	41360462	41329
EUR_213	10000	EUR	429	57181563	57259146	77583
EUR_213	10000	EUR	429	72447779	72471635	23856
EUR_213	10000	EUR	429	73544769	73675439	130670
EUR_213	10000	EUR	429	74700049	74701524	1475
EUR_213	10000	EUR	429	74871541	74894548	23007
EUR_213	10000	EUR	429	75522893	75632489	109596
EUR_213	10000	EUR	429	75912517	75915063	2546
EUR_213	10000	EUR	429	76365488	76370460	4972
EUR_213	10000	EUR	429	77733985	77735979	1994
EUR_213	10000	EUR	429	85650812	85653228	2416
EUR_213	10000	EUR	429	88077880	88172209	94329
EUR_213	10000	EUR	429	88212981	88281196	68215
EUR_213	10000	EUR	429	88882446	89081743	199297
EUR_213	10000	EUR	429	91072171	91107582	35411
EUR_213	10000	EUR	429	91891040	91902611	11571
EUR_213	10000	EUR	429	93886899	93950260	63361
EUR_213	10000	EUR	429	94450634	94510654	60020
EUR_214	10000	EUR	430	1924080	1943663	19583
EUR_214	10000	EUR	430	1945682	1959936	14254
EUR_214	10000	EUR	430	5018475	5041230	22755
EUR_214	10000	EUR	430	7572302	7792322	220020
EUR_214	10000	EUR	430	8348919	8386102	37183
EUR_214	10000	EUR	430	9413335	9449917	36582
EUR_214	10000	EUR	430	11532006	11542173	10167
EUR_214	10000	EUR	430	25867195	25906960	39765
EUR_214	10000	EUR	430	26371392	26522090	150698
EUR_214	10000	EUR	430	29373765	29390654	16889
EUR_214	10000	EUR	430	30904434	31040753	136319
EUR_214	10000	EUR	430	31528053	31593163	65110
EUR_214	10000	EUR	430	32170839	32187563	16724
EUR_214	10000	EUR	430	32667412	32870350	202938
EUR_214	10000	EUR	430	37722669	37895954	173285
EUR_214	10000	EUR	430	49714605	49741250	26645
EUR_214	10000	EUR	430	56378802	56448072	69270
EUR_214	10000	EUR	430	59464397	59522281	57884
EUR_214	10000	EUR	430	68675332	68717300	41968
EUR_214	10000	EUR	430	72964182	73172795	208613
EUR_214	10000	EUR	430	76022322	76048092	25770
EUR_214	10000	EUR	430	86916801	86926886	10085
EUR_214	10000	EUR	430	88211398	88319207	107809
EUR_214	10000	EUR	430	88908199	88915947	7748
EUR_214	10000	EUR	430	89189593	89235318	45725
EUR_214	10000	EUR	430	91891040	91902611	11571
EUR_214	10000	EUR	430	93702886	93713967	11081
EUR_214	10000	EUR	430	94898715	94930362	31647
EUR_214	10000	EUR	430	95831568	95927099	95531
EUR_214	10000	EUR	431	11741388	11762288	20900
EUR_214	10000	EUR	431	18310807	18352711	41904
EUR_214	10000	EUR	431	21149491	21223896	74405
EUR_214	10000	EUR	431	23648833	23651476	2643
EUR_214	10000	EUR	431	24045382	24166883	121501
EUR_214	10000	EUR	431	24528522	24581630	53108
EUR_214	10000	EUR	431	29306591	29396432	89841
EUR_214	10000	EUR	431	30976914	31127610	150696
EUR_214	10000	EUR	431	31528053	31575105	47052
EUR_214	10000	EUR	431	32039879	32057645	17766
EUR_214	10000	EUR	431	32824940	32871485	46545
EUR_214	10000	EUR	431	33126706	33180725	54019
EUR_214	10000	EUR	431	33255315	33429152	173837
EUR_214	10000	EUR	431	35521107	35677592	156485
EUR_214	10000	EUR	431	35881405	35892995	11590
EUR_214	10000	EUR	431	37722669	37725313	2644
EUR_214	10000	EUR	431	38062578	38097333	34755
EUR_214	10000	EUR	431	42473584	42574352	100768
EUR_214	10000	EUR	431	53821064	54035252	214188
EUR_214	10000	EUR	431	57181563	57291065	109502
EUR_214	10000	EUR	431	57718480	57806900	88420
EUR_214	10000	EUR	431	58943812	59009171	65359
EUR_214	10000	EUR	431	59423469	59522281	98812
EUR_214	10000	EUR	431	63714218	63784151	69933
EUR_214	10000	EUR	431	64496625	64519080	22455
EUR_214	10000	EUR	431	72160732	72205102	44370
EUR_214	10000	EUR	431	72388504	72398733	10229
EUR_214	10000	EUR	431	72961212	73040018	78806
EUR_214	10000	EUR	431	76567582	76594146	26564
EUR_214	10000	EUR	431	77800262	77885640	85378
EUR_214	10000	EUR	431	81031954	81036282	4328
EUR_214	10000	EUR	431	87533821	87546866	13045
EUR_214	10000	EUR	431	88761110	89047979	286869
EUR_214	10000	EUR	431	89084957	89124034	39077
EUR_214	10000	EUR	431	89404942	89508341	103399
EUR_214	10000	EUR	431	91074962	91107582	32620
EUR_214	10000	EUR	431	91566552	91688404	121852
EUR_214	10000	EUR	431	93680632	93680672	40
EUR_214	10000	EUR	431	94290726	94412962	122236
EUR_214	10000	EUR	431	95774147	95844558	70411
EUR_215	10000	EUR	432	2944163	3053070	108907
EUR_215	10000	EUR	432	9279789	9308590	28801
EUR_215	10000	EUR	432	13621609	13626532	4923
EUR_215	10000	EUR	432	18100331	18140078	39747
EUR_215	10000	EUR	432	21150173	21156082	5909
EUR_215	10000	EUR	432	22279659	22313169	33510
EUR_215	10000	EUR	432	23721919	23797839	75920
EUR_215	10000	EUR	432	24485266	24581630	96364
EUR_215	10000	EUR	432	25953989	25987107	33118
EUR_215	10000	EUR	432	29373765	29478208	104443
EUR_215	10000	EUR	432	30976914	31127610	150696
EUR_215	10000	EUR	432	32855612	32870350	14738
EUR_215	10000	EUR	432	33245767	33429152	183385
EUR_215	10000	EUR	432	33456444	33479750	23306
EUR_215	10000	EUR	432	35084593	35087281	2688
EUR_215	10000	EUR	432	35790195	35849669	59474
EUR_215	10000	EUR	432	37727446	37817231	89785
EUR_215	10000	EUR	432	40410992	40435634	24642
EUR_215	10000	EUR	432	42164278	42208086	43808
EUR_215	10000	EUR	432	43359651	43471816	112165
EUR_215	10000	EUR	432	49714605	49741250	26645
EUR_215	10000	EUR	432	56378802	56448072	69270
EUR_215	10000	EUR	432	63714218	63732455	18237
EUR_215	10000	EUR	432	71722082	71764001	41919
EUR_215	10000	EUR	432	75110846	75189189	78343
EUR_215	10000	EUR	432	76567582	76594146	26564
EUR_215	10000	EUR	432	77751346	77795912	44566
EUR_215	10000	EUR	432	79928404	79936163	7759
EUR_215	10000	EUR	432	83370620	83384810	14190
EUR_215	10000	EUR	432	83955315	83957574	2259
EUR_215	10000	EUR	432	87369479	87389562	20083
EUR_215	10000	EUR	432	88452177	88464514	12337
EUR_215	10000	EUR	432	88476761	88537179	60418
EUR_215	10000	EUR	432	89054631	89235318	180687
EUR_215	10000	EUR	432	94280856	94317758	36902
EUR_215	10000	EUR	432	94793518	95011492	217974
EUR_215	10000	EUR	432	96116814	96199691	82877
EUR_215	10000	EUR	432	96264202	96346551	82349
EUR_215	10000	EUR	433	3929740	3975764	46024
EUR_215	10000	EUR	433	4042638	4044195	1557
EUR_215	10000	EUR	433	11703759	11708397	4638
EUR_215	10000	EUR	433	16243211	16397990	154779
EUR_215	10000	EUR	433	21093849	21308823	214974
EUR_215	10000	EUR	433	23721919	23797839	75920
EUR_215	10000	EUR	433	27894016	27894364	348
EUR_215	10000	EUR	433	29347606	29396432	48826
EUR_215	10000	EUR	433	31235544	31314394	78850
EUR_215	10000	EUR	433	33126706	33180725	54019
EUR_215	10000	EUR	433	35328645	35413680	85035
EUR_215	10000	EUR	433	38065368	38097333	31965
EUR_215	10000	EUR	433	40142894	40145306	2412
EUR_215	10000	EUR	433	40410992	40498219	87227
EUR_215	10000	EUR	433	40861764	40975939	114175
EUR_215	10000	EUR	433	41336542	41360462	23920
EUR_215	10000	EUR	433	42430229	42468277	38048
EUR_215	10000	EUR	433	54653171	54671678	18507
EUR_215	10000	EUR	433	54693132	54796245	103113
EUR_215	10000	EUR	433	57136159	57141457	5298
EUR_215	10000	EUR	433	57188385	57259820	71435
EUR_215	10000	EUR	433	64338347	64364129	25782
EUR_215	10000	EUR	433	64857298	64922329	65031
EUR_215	10000	EUR	433	68626746	68648432	21686
EUR_215	10000	EUR	433	72288615	72315334	26719
EUR_215	10000	EUR	433	72359726	72373817	14091
EUR_215	10000	EUR	433	74640712	74701524	60812
EUR_215	10000	EUR	433	76022322	76059358	37036
EUR_215	10000	EUR	433	76365488	76368751	3263
EUR_215	10000	EUR	433	77716962	77767567	50605
EUR_215	10000	EUR	433	79901897	79936163	34266
EUR_215	10000	EUR	433	80161288	80278256	116968
EUR_215	10000	EUR	433	80874989	80917694	42705
EUR_215	10000	EUR	433	84235412	84254246	18834
EUR_215	10000	EUR	433	86916801	86971491	54690
EUR_215	10000	EUR	433	88504749	88512638	7889
EUR_215	10000	EUR	433	88797692	89001971	204279
EUR_215	10000	EUR	433	89069223	89081743	12520
EUR_215	10000	EUR	433	90195857	90206616	10759
EUR_215	10000	EUR	433	93800814	93869231	68417
EUR_215	10000	EUR	433	94805865	94819760	13895
EUR_215	10000	EUR	433	95081637	95112420	30783
EUR_216	10000	EUR	434	2415974	2702115	286141
EUR_216	10000	EUR	434	8348919	8386102	37183
EUR_216	10000	EUR	434	16248080	16259130	11050
EUR_216	10000	EUR	434	18631803	18636940	5137
EUR_216	10000	EUR	434	21150173	21156082	5909
EUR_216	10000	EUR	434	21200799	21216283	15484
EUR_216	10000	EUR	434	21350121	21429464	79343
EUR_216	10000	EUR	434	23176150	23183923	7773
EUR_216	10000	EUR	434	24894243	24906091	11848
EUR_216	10000	EUR	434	31087987	31109872	21885
EUR_216	10000	EUR	434	39639062	39696725	57663
EUR_216	10000	EUR	434	39838138	39895074	56936
EUR_216	10000	EUR	434	43520906	43653793	132887
EUR_216	10000	EUR	434	49714605	49899094	184489
EUR_216	10000	EUR	434	52224776	52231250	6474
EUR_216	10000	EUR	434	56378802	56448072	69270
EUR_216	10000	EUR	434	57857678	57861351	3673
EUR_216	10000	EUR	434	64338347	64519080	180733
EUR_216	10000	EUR	434	68675332	68717300	41968
EUR_216	10000	EUR	434	72471551	72471635	84
EUR_216	10000	EUR	434	73498527	73564505	65978
EUR_216	10000	EUR	434	74732529	74738891	6362
EUR_216	10000	EUR	434	75914388	75915063	675
EUR_216	10000	EUR	434	77865503	77881732	16229
EUR_216	10000	EUR	434	81189033	81229503	40470
EUR_216	10000	EUR	434	86916801	86971491	54690
EUR_216	10000	EUR	434	87533821	87546866	13045
EUR_216	10000	EUR	434	88126552	88319207	192655
EUR_216	10000	EUR	434	88825376	89047979	222603
EUR_216	10000	EUR	434	89084957	89124034	39077
EUR_216	10000	EUR	434	90159786	90243516	83730
EUR_216	10000	EUR	434	92062604	92171686	109082
EUR_216	10000	EUR	434	93123848	93146996	23148
EUR_216	10000	EUR	434	93553045	93713967	160922
EUR_216	10000	EUR	434	94239181	94242718	3537
EUR_216	10000	EUR	434	95878015	95887608	9593
EUR_216	10000	EUR	435	1970243	2022517	52274
EUR_216	10000	EUR	435	2546510	2602093	55583
EUR_216	10000	EUR	435	22523307	22533171	9864
EUR_216	10000	EUR	435	23122511	23184805	62294
EUR_216	10000	EUR	435	24580740	24581630	890
EUR_216	10000	EUR	435	24892444	24906091	13647
EUR_216	10000	EUR	435	26319359	26331325	11966
EUR_216	10000	EUR	435	29306591	29339651	33060
EUR_216	10000	EUR	435	29357693	29365834	8141
EUR_216	10000	EUR	435	31087987	31138800	50813
EUR_216	10000	EUR	435	31573220	31636518	63298
EUR_216	10000	EUR	435	36744092	36864514	120422
EUR_216	10000	EUR	435	37809118	37815963	6845
EUR_216	10000	EUR	435	39681230	39692065	10835
EUR_216	10000	EUR	435	54714203	54860875	146672
EUR_216	10000	EUR	435	58569405	58593792	24387
EUR_216	10000	EUR	435	63714218	63732455	18237
EUR_216	10000	EUR	435	74581736	74738891	157155
EUR_216	10000	EUR	435	76365488	76368751	3263
EUR_216	10000	EUR	435	79860282	79933512	73230
EUR_216	10000	EUR	435	87533821	87546866	13045
EUR_216	10000	EUR	435	88077880	88172209	94329
EUR_216	10000	EUR	435	88212981	88333763	120782
EUR_216	10000	EUR	435	88527647	88679238	151591
EUR_216	10000	EUR	435	88761110	88939797	178687
EUR_216	10000	EUR	435	91018779	91107582	88803
EUR_216	10000	EUR	435	93680632	93680672	40
EUR_216	10000	EUR	435	94239181	94337048	97867
EUR_216	10000	EUR	435	94348955	94375754	26799
EUR_216	10000	EUR	435	94793518	95011492	217974
EUR_217	10000	EUR	436	1853096	1854996	1900
EUR_217	10000	EUR	436	11703759	11814111	110352
EUR_217	10000	EUR	436	13970992	14057978	86986
EUR_217	10000	EUR	436	16397154	16454511	57357
EUR_217	10000	EUR	436	17749730	17822978	73248
EUR_217	10000	EUR	436	17946005	18041675	95670
EUR_217	10000	EUR	436	23165262	23266699	101437
EUR_217	10000	EUR	436	24621120	24684466	63346
EUR_217	10000	EUR	436	24892444	24906091	13647
EUR_217	10000	EUR	436	25264173	25276538	12365
EUR_217	10000	EUR	436	26371392	26522090	150698
EUR_217	10000	EUR	436	28111916	28139866	27950
EUR_217	10000	EUR	436	29306591	29579668	273077
EUR_217	10000	EUR	436	30904434	31092945	188511
EUR_217	10000	EUR	436	37748178	37895954	147776
EUR_217	10000	EUR	436	40097079	40137080	40001
EUR_217	10000	EUR	436	40410992	40602505	191513
EUR_217	10000	EUR	436	51948707	52003808	55101
EUR_217	10000	EUR	436	54302008	54362674	60666
EUR_217	10000	EUR	436	57712252	57806900	94648
EUR_217	10000	EUR	436	64496625	64519080	22455
EUR_217	10000	EUR	436	68626746	68648432	21686
EUR_217	10000	EUR	436	69023918	69060887	36969
EUR_217	10000	EUR	436	72994673	73022663	27990
EUR_217	10000	EUR	436	73535852	73660589	124737
EUR_217	10000	EUR	436	73884457	73906350	21893
EUR_217	10000	EUR	436	74640712	74701524	60812
EUR_217	10000	EUR	436	75166047	75189189	23142
EUR_217	10000	EUR	436	85520555	85554711	34156
EUR_217	10000	EUR	436	86508335	86538713	30378
EUR_217	10000	EUR	436	88175028	88280712	105684
EUR_217	10000	EUR	436	88395997	88419767	23770
EUR_217	10000	EUR	436	88643878	88715203	71325
EUR_217	10000	EUR	436	88797692	88812922	15230
EUR_217	10000	EUR	436	91072171	91107582	35411
EUR_217	10000	EUR	436	93308720	93312065	3345
EUR_217	10000	EUR	436	94164542	94313443	148901
EUR_217	10000	EUR	436	96229638	96336399	106761
EUR_217	10000	EUR	436	99177558	99280798	103240
EUR_217	10000	EUR	437	2546510	2648737	102227
EUR_217	10000	EUR	437	5018475	5041230	22755
EUR_217	10000	EUR	437	9424985	9449917	24932
EUR_217	10000	EUR	437	11703759	11708397	4638
EUR_217	10000	EUR	437	16243211	16367500	124289
EUR_217	10000	EUR	437	18100331	18140078	39747
EUR_217	10000	EUR	437	18716646	18844474	127828
EUR_217	10000	EUR	437	21224963	21225412	449
EUR_217	10000	EUR	437	23176150	23184805	8655
EUR_217	10000	EUR	437	23648833	23651476	2643
EUR_217	10000	EUR	437	24087823	24166883	79060
EUR_217	10000	EUR	437	24456376	24581630	125254
EUR_217	10000	EUR	437	26477051	26562248	85197
EUR_217	10000	EUR	437	26946861	26991485	44624
EUR_217	10000	EUR	437	29273800	29279379	5579
EUR_217	10000	EUR	437	29444267	29483168	38901
EUR_217	10000	EUR	437	31233297	31314394	81097
EUR_217	10000	EUR	437	31478668	31502542	23874
EUR_217	10000	EUR	437	31527830	31674144	146314
EUR_217	10000	EUR	437	32824940	32871485	46545
EUR_217	10000	EUR	437	33126757	33166924	40167
EUR_217	10000	EUR	437	36744092	36864514	120422
EUR_217	10000	EUR	437	37727611	37750158	22547
EUR_217	10000	EUR	437	37763153	38081097	317944
EUR_217	10000	EUR	437	39664057	39692065	28008
EUR_217	10000	EUR	437	40861764	41134712	272948
EUR_217	10000	EUR	437	42473584	42545802	72218
EUR_217	10000	EUR	437	49714605	49741250	26645
EUR_217	10000	EUR	437	53821064	53842770	21706
EUR_217	10000	EUR	437	57136159	57253147	116988
EUR_217	10000	EUR	437	57264407	57291065	26658
EUR_217	10000	EUR	437	72961212	73122070	160858
EUR_217	10000	EUR	437	76139818	76143984	4166
EUR_217	10000	EUR	437	76558352	76592141	33789
EUR_217	10000	EUR	437	83370620	83377599	6979
EUR_217	10000	EUR	437	88152919	88153791	872
EUR_217	10000	EUR	437	88405406	88464514	59108
EUR_217	10000	EUR	437	88476761	88537179	60418
EUR_217	10000	EUR	437	88761110	88877947	116837
EUR_217	10000	EUR	437	90058636	90243516	184880
EUR_217	10000	EUR	437	91018779	91107582	88803
EUR_217	10000	EUR	437	93553045	93647010	93965
EUR_217	10000	EUR	437	93908281	93925519	17238
EUR_217	10000	EUR	437	94005320	94105458	100138
EUR_217	10000	EUR	437	94297447	94418018	120571
EUR_217	10000	EUR	437	94419260	94515224	95964
EUR_217	10000	EUR	437	96116814	96127414	10600
EUR_217	10000	EUR	437	96229638	96336399	106761
EUR_217	10000	EUR	437	96428301	96546756	118455
EUR_217	10000	EUR	437	96800979	96942045	141066
EUR_218	10000	EUR	438	1970243	2022517	52274
EUR_218	10000	EUR	438	9413335	9449917	36582
EUR_218	10000	EUR	438	16202082	16301874	99792
EUR_218	10000	EUR	438	21200799	21216283	15484
EUR_218	10000	EUR	438	22113151	22122249	9098
EUR_218	10000	EUR	438	25140534	25305885	165351
EUR_218	10000	EUR	438	25847649	25855304	7655
EUR_218	10000	EUR	438	26319359	26331325	11966
EUR_218	10000	EUR	438	28599684	28692721	93037
EUR_218	10000	EUR	438	29306591	29579668	273077
EUR_218	10000	EUR	438	30937577	31092945	155368
EUR_218	10000	EUR	438	34124908	34182116	57208
EUR_218	10000	EUR	438	35328645	35413680	85035
EUR_218	10000	EUR	438	37727611	37762850	35239
EUR_218	10000	EUR	438	41328462	41360462	32000
EUR_218	10000	EUR	438	49828382	49856342	27960
EUR_218	10000	EUR	438	49860683	49899094	38411
EUR_218	10000	EUR	438	54221599	54274676	53077
EUR_218	10000	EUR	438	54852305	54873159	20854
EUR_218	10000	EUR	438	56416785	56443771	26986
EUR_218	10000	EUR	438	68626746	68648432	21686
EUR_218	10000	EUR	438	69023918	69060887	36969
EUR_218	10000	EUR	438	72961212	73084050	122838
EUR_218	10000	EUR	438	73588449	73602054	13605
EUR_218	10000	EUR	438	80874989	81118702	243713
EUR_218	10000	EUR	438	88211398	88319207	107809
EUR_218	10000	EUR	438	88761110	88877947	116837
EUR_218	10000	EUR	438	91847626	91914299	66673
EUR_218	10000	EUR	438	94297447	94418018	120571
EUR_218	10000	EUR	438	94419260	94544971	125711
EUR_218	10000	EUR	438	96201761	96337375	135614
EUR_218	10000	EUR	439	1330157	1385444	55287
EUR_218	10000	EUR	439	2980758	3053070	72312
EUR_218	10000	EUR	439	4041054	4044195	3141
EUR_218	10000	EUR	439	11703759	11708397	4638
EUR_218	10000	EUR	439	13477125	13671934	194809
EUR_218	10000	EUR	439	16296297	16345906	49609
EUR_218	10000	EUR	439	18622886	18642972	20086
EUR_218	10000	EUR	439	23122511	23184805	62294
EUR_218	10000	EUR	439	24081636	24094707	13071
EUR_218	10000	EUR	439	24495851	24518649	22798
EUR_218	10000	EUR	439	25867195	25987107	119912
EUR_218	10000	EUR	439	32057270	32084128	26858
EUR_218	10000	EUR	439	32824940	32828620	3680
EUR_218	10000	EUR	439	32858056	32870350	12294
EUR_218	10000	EUR	439	35091612	35095643	4031
EUR_218	10000	EUR	439	39639062	39696725	57663
EUR_218	10000	EUR	439	40410992	40508892	97900
EUR_218	10000	EUR	439	49714605	49857301	142696
EUR_218	10000	EUR	439	53835895	53837891	1996
EUR_218	10000	EUR	439	54693132	54796245	103113
EUR_218	10000	EUR	439	64857298	64922329	65031
EUR_218	10000	EUR	439	72961212	72991779	30567
EUR_218	10000	EUR	439	73544769	73675439	130670
EUR_218	10000	EUR	439	74700049	74701524	1475
EUR_218	10000	EUR	439	74871541	74894548	23007
EUR_218	10000	EUR	439	75522893	75530886	7993
EUR_218	10000	EUR	439	80999290	81087964	88674
EUR_218	10000	EUR	439	83370620	83384810	14190
EUR_218	10000	EUR	439	87303392	87455574	152182
EUR_218	10000	EUR	439	88219640	88365426	145786
EUR_218	10000	EUR	439	92022074	92044148	22074
EUR_218	10000	EUR	439	94208817	94279511	70694
EUR_219	10000	EUR	440	1762556	1775693	13137
EUR_219	10000	EUR	440	2454787	2527168	72381
EUR_219	10000	EUR	440	3285306	3302065	16759
EUR_219	10000	EUR	440	5018475	5041230	22755
EUR_219	10000	EUR	440	12811479	12974092	162613
EUR_219	10000	EUR	440	17687142	17724903	37761
EUR_219	10000	EUR	440	21282367	21390474	108107
EUR_219	10000	EUR	440	22279659	22313169	33510
EUR_219	10000	EUR	440	23176150	23184805	8655
EUR_219	10000	EUR	440	23648833	23651476	2643
EUR_219	10000	EUR	440	23841523	23877108	35585
EUR_219	10000	EUR	440	24892444	24906091	13647
EUR_219	10000	EUR	440	26319359	26552409	233050
EUR_219	10000	EUR	440	27746608	27974945	228337
EUR_219	10000	EUR	440	32431231	32446630	15399
EUR_219	10000	EUR	440	32824940	32871485	46545
EUR_219	10000	EUR	440	35091612	35095643	4031
EUR_219	10000	EUR	440	40047500	40068128	20628
EUR_219	10000	EUR	440	54403505	54682031	278526
EUR_219	10000	EUR	440	68626746	68648432	21686
EUR_219	10000	EUR	440	69023918	69060887	36969
EUR_219	10000	EUR	440	80863277	80899276	35999
EUR_219	10000	EUR	440	83370620	83384810	14190
EUR_219	10000	EUR	440	87303392	87455574	152182
EUR_219	10000	EUR	440	88221167	88266237	45070
EUR_219	10000	EUR	440	89043274	89182292	139018
EUR_219	10000	EUR	440	91891040	91902611	11571
EUR_219	10000	EUR	440	93553045	93713967	160922
EUR_219	10000	EUR	440	94448274	94544971	96697
EUR_219	10000	EUR	440	94839916	95079442	239526
EUR_219	10000	EUR	440	96116814	96333512	216698
EUR_219	10000	EUR	441	9149188	9164904	15716
EUR_219	10000	EUR	441	14051019	14086388	35369
EUR_219	10000	EUR	441	18310807	18352711	41904
EUR_219	10000	EUR	441	24140903	24163756	22853
EUR_219	10000	EUR	441	24535579	24581630	46051
EUR_219	10000	EUR	441	25325282	25325345	63
EUR_219	10000	EUR	441	25343770	25501390	157620
EUR_219	10000	EUR	441	25978368	25987107	8739
EUR_219	10000	EUR	441	26403126	26429831	26705
EUR_219	10000	EUR	441	26886230	26971931	85701
EUR_219	10000	EUR	441	29444267	29483168	38901
EUR_219	10000	EUR	441	31087987	31131774	43787
EUR_219	10000	EUR	441	32694491	32759145	64654
EUR_219	10000	EUR	441	39639062	39696725	57663
EUR_219	10000	EUR	441	39838138	39895074	56936
EUR_219	10000	EUR	441	43359651	43515922	156271
EUR_219	10000	EUR	441	54711881	54714097	2216
EUR_219	10000	EUR	441	57149895	57291065	141170
EUR_219	10000	EUR	441	63714218	63766635	52417
EUR_219	10000	EUR	441	73039375	73160136	120761
EUR_219	10000	EUR	441	73488506	73493479	4973
EUR_219	10000	EUR	441	75527287	75632489	105202
EUR_219	10000	EUR	441	75912517	75915063	2546
EUR_219	10000	EUR	441	76468147	76594146	125999
EUR_219	10000	EUR	441	80135541	80139395	3854
EUR_219	10000	EUR	441	80852609	80890918	38309
EUR_219	10000	EUR	441	83370620	83384810	14190
EUR_219	10000	EUR	441	83955315	83957574	2259
EUR_219	10000	EUR	441	84235412	84245003	9591
EUR_219	10000	EUR	441	88764684	88952199	187515
EUR_219	10000	EUR	441	90972791	91089410	116619
EUR_219	10000	EUR	441	93553045	93655077	102032
EUR_219	10000	EUR	441	94280856	94317758	36902
EUR_219	10000	EUR	441	99165891	99231692	65801
EUR_220	10000	EUR	442	3963309	4029447	66138
EUR_220	10000	EUR	442	8662954	8714283	51329
EUR_220	10000	EUR	442	17889447	17902017	12570
EUR_220	10000	EUR	442	23752602	23856810	104208
EUR_220	10000	EUR	442	24045382	24166883	121501
EUR_220	10000	EUR	442	24372241	24384508	12267
EUR_220	10000	EUR	442	24535579	24581630	46051
EUR_220	10000	EUR	442	25867195	25904509	37314
EUR_220	10000	EUR	442	26477051	26562248	85197
EUR_220	10000	EUR	442	35887157	35892995	5838
EUR_220	10000	EUR	442	37776227	37890590	114363
EUR_220	10000	EUR	442	49714605	49899094	184489
EUR_220	10000	EUR	442	53821064	53842770	21706
EUR_220	10000	EUR	442	54570690	54612977	42287
EUR_220	10000	EUR	442	54885285	54904011	18726
EUR_220	10000	EUR	442	58093392	58136140	42748
EUR_220	10000	EUR	442	69023918	69060887	36969
EUR_220	10000	EUR	442	72326056	72371952	45896
EUR_220	10000	EUR	442	73884457	73906350	21893
EUR_220	10000	EUR	442	75263541	75282527	18986
EUR_220	10000	EUR	442	76022322	76048092	25770
EUR_220	10000	EUR	442	76456850	76594146	137296
EUR_220	10000	EUR	442	80520393	80530144	9751
EUR_220	10000	EUR	442	81077752	81084087	6335
EUR_220	10000	EUR	442	88077880	88113143	35263
EUR_220	10000	EUR	442	88761110	89038093	276983
EUR_220	10000	EUR	442	90058636	90243516	184880
EUR_220	10000	EUR	442	91011409	91097487	86078
EUR_220	10000	EUR	442	91891040	91902611	11571
EUR_220	10000	EUR	442	93585543	93713967	128424
EUR_220	10000	EUR	442	94477503	94512316	34813
EUR_220	10000	EUR	442	99266108	99279146	13038
EUR_220	10000	EUR	443	2519034	2648737	129703
EUR_220	10000	EUR	443	2984450	2997995	13545
EUR_220	10000	EUR	443	4091052	4126878	35826
EUR_220	10000	EUR	443	5018475	5041230	22755
EUR_220	10000	EUR	443	8712318	8714283	1965
EUR_220	10000	EUR	443	9413335	9449917	36582
EUR_220	10000	EUR	443	12764351	12780195	15844
EUR_220	10000	EUR	443	14051019	14112508	61489
EUR_220	10000	EUR	443	16202082	16301874	99792
EUR_220	10000	EUR	443	18716646	18844474	127828
EUR_220	10000	EUR	443	22279659	22313169	33510
EUR_220	10000	EUR	443	24621120	24737906	116786
EUR_220	10000	EUR	443	24809049	24866754	57705
EUR_220	10000	EUR	443	25323974	25357719	33745
EUR_220	10000	EUR	443	25847649	25855304	7655
EUR_220	10000	EUR	443	30976914	31127610	150696
EUR_220	10000	EUR	443	32262916	32267787	4871
EUR_220	10000	EUR	443	32855612	32870350	14738
EUR_220	10000	EUR	443	35091612	35095643	4031
EUR_220	10000	EUR	443	35887157	35892995	5838
EUR_220	10000	EUR	443	36350791	36460007	109216
EUR_220	10000	EUR	443	37727611	37762850	35239
EUR_220	10000	EUR	443	40410992	40508892	97900
EUR_220	10000	EUR	443	42493150	42574352	81202
EUR_220	10000	EUR	443	43359651	43453960	94309
EUR_220	10000	EUR	443	57149895	57291065	141170
EUR_220	10000	EUR	443	64338347	64502977	164630
EUR_220	10000	EUR	443	72288615	72398733	110118
EUR_220	10000	EUR	443	72961212	73040018	78806
EUR_220	10000	EUR	443	73536039	73670522	134483
EUR_220	10000	EUR	443	74871541	74894548	23007
EUR_220	10000	EUR	443	79901897	79936163	34266
EUR_220	10000	EUR	443	80161288	80278256	116968
EUR_220	10000	EUR	443	87369085	87455574	86489
EUR_220	10000	EUR	443	88452177	88464514	12337
EUR_220	10000	EUR	443	88476761	88537179	60418
EUR_220	10000	EUR	443	90833291	90969654	136363
EUR_220	10000	EUR	443	92062604	92171686	109082
EUR_220	10000	EUR	443	93553045	93567584	14539
EUR_220	10000	EUR	443	94208817	94313443	104626
EUR_221	10000	EUR	444	1330157	1385444	55287
EUR_221	10000	EUR	444	3963320	4031854	68534
EUR_221	10000	EUR	444	14051019	14094005	42986
EUR_221	10000	EUR	444	16202082	16301874	99792
EUR_221	10000	EUR	444	23648833	23651476	2643
EUR_221	10000	EUR	444	23841523	23877108	35585
EUR_221	10000	EUR	444	24892444	24906091	13647
EUR_221	10000	EUR	444	26319359	26552409	233050
EUR_221	10000	EUR	444	27746608	27974945	228337
EUR_221	10000	EUR	444	29347606	29396432	48826
EUR_221	10000	EUR	444	31535203	31636518	101315
EUR_221	10000	EUR	444	32667412	32696052	28640
EUR_221	10000	EUR	444	36663539	36678544	15005
EUR_221	10000	EUR	444	37973100	38097333	124233
EUR_221	10000	EUR	444	43359651	43515922	156271
EUR_221	10000	EUR	444	50053800	50077224	23424
EUR_221	10000	EUR	444	52224085	52440869	216784
EUR_221	10000	EUR	444	56447306	56448072	766
EUR_221	10000	EUR	444	57712252	57806900	94648
EUR_221	10000	EUR	444	59201091	59522281	321190
EUR_221	10000	EUR	444	59744029	59762964	18935
EUR_221	10000	EUR	444	69023918	69060887	36969
EUR_221	10000	EUR	444	71670386	71678663	8277
EUR_221	10000	EUR	444	73488506	73521539	33033
EUR_221	10000	EUR	444	74871541	74894548	23007
EUR_221	10000	EUR	444	75886611	75915063	28452
EUR_221	10000	EUR	444	76024488	76093521	69033
EUR_221	10000	EUR	444	76502715	76594146	91431
EUR_221	10000	EUR	444	83955315	83957574	2259
EUR_221	10000	EUR	444	87969149	87974099	4950
EUR_221	10000	EUR	444	88188808	88263005	74197
EUR_221	10000	EUR	444	88543868	88600577	56709
EUR_221	10000	EUR	444	91891040	91902611	11571
EUR_221	10000	EUR	444	92099834	92171686	71852
EUR_221	10000	EUR	444	94413363	94418018	4655
EUR_221	10000	EUR	444	94419260	94515224	95964
EUR_221	10000	EUR	444	95418231	95445533	27302
EUR_221	10000	EUR	444	96116814	96199691	82877
EUR_221	10000	EUR	445	2519034	2648737	129703
EUR_221	10000	EUR	445	16243211	16399613	156402
EUR_221	10000	EUR	445	18310807	18352711	41904
EUR_221	10000	EUR	445	21093849	21390474	296625
EUR_221	10000	EUR	445	23648833	23651476	2643
EUR_221	10000	EUR	445	24045382	24166883	121501
EUR_221	10000	EUR	445	25343770	25501390	157620
EUR_221	10000	EUR	445	25978368	25987107	8739
EUR_221	10000	EUR	445	26403126	26429831	26705
EUR_221	10000	EUR	445	26886230	26991485	105255
EUR_221	10000	EUR	445	27894016	27894364	348
EUR_221	10000	EUR	445	35091612	35095643	4031
EUR_221	10000	EUR	445	37705403	37817231	111828
EUR_221	10000	EUR	445	38062578	38097333	34755
EUR_221	10000	EUR	445	39639062	39696725	57663
EUR_221	10000	EUR	445	39821749	40145306	323557
EUR_221	10000	EUR	445	40410992	40602505	191513
EUR_221	10000	EUR	445	53960837	53993169	32332
EUR_221	10000	EUR	445	54210889	54362674	151785
EUR_221	10000	EUR	445	69023918	69060887	36969
EUR_221	10000	EUR	445	74055055	74094072	39017
EUR_221	10000	EUR	445	77733985	77735979	1994
EUR_221	10000	EUR	445	78846360	78865177	18817
EUR_221	10000	EUR	445	80520393	80530144	9751
EUR_221	10000	EUR	445	80941681	81087964	146283
EUR_221	10000	EUR	445	88221167	88266237	45070
EUR_221	10000	EUR	445	89043274	89182292	139018
EUR_221	10000	EUR	445	89989980	89998439	8459
EUR_221	10000	EUR	445	93553045	93607994	54949
EUR_221	10000	EUR	445	94793518	94950031	156513
EUR_221	10000	EUR	445	95774147	95784369	10222
EUR_222	10000	EUR	446	8651970	8677654	25684
EUR_222	10000	EUR	446	9431845	9449917	18072
EUR_222	10000	EUR	446	14107814	14108442	628
EUR_222	10000	EUR	446	18310807	18352711	41904
EUR_222	10000	EUR	446	21149491	21223896	74405
EUR_222	10000	EUR	446	23648833	23651476	2643
EUR_222	10000	EUR	446	24045382	24166883	121501
EUR_222	10000	EUR	446	24528522	24581630	53108
EUR_222	10000	EUR	446	29306591	29396432	89841
EUR_222	10000	EUR	446	30976914	31127610	150696
EUR_222	10000	EUR	446	31528053	31575105	47052
EUR_222	10000	EUR	446	32039879	32057645	17766
EUR_222	10000	EUR	446	32824940	32871485	46545
EUR_222	10000	EUR	446	33126706	33180725	54019
EUR_222	10000	EUR	446	33255315	33429152	173837
EUR_222	10000	EUR	446	35521107	35677592	156485
EUR_222	10000	EUR	446	35881405	35892995	11590
EUR_222	10000	EUR	446	37722669	37725313	2644
EUR_222	10000	EUR	446	38062578	38097333	34755
EUR_222	10000	EUR	446	40861764	41134712	272948
EUR_222	10000	EUR	446	42430229	42456760	26531
EUR_222	10000	EUR	446	43359651	43471816	112165
EUR_222	10000	EUR	446	49923584	50039522	115938
EUR_222	10000	EUR	446	53821064	53842770	21706
EUR_222	10000	EUR	446	54570690	54612977	42287
EUR_222	10000	EUR	446	54659849	54667387	7538
EUR_222	10000	EUR	446	57136159	57141457	5298
EUR_222	10000	EUR	446	57188385	57262845	74460
EUR_222	10000	EUR	446	58569405	58694180	124775
EUR_222	10000	EUR	446	59474219	59631623	157404
EUR_222	10000	EUR	446	64338347	64458245	119898
EUR_222	10000	EUR	446	75263541	75282527	18986
EUR_222	10000	EUR	446	75522893	75632489	109596
EUR_222	10000	EUR	446	79082049	79134588	52539
EUR_222	10000	EUR	446	80852609	80881534	28925
EUR_222	10000	EUR	446	88877686	88915947	38261
EUR_222	10000	EUR	446	89989980	89998439	8459
EUR_222	10000	EUR	446	91847626	91929323	81697
EUR_222	10000	EUR	446	91987726	92020761	33035
EUR_222	10000	EUR	446	93553045	93655077	102032
EUR_222	10000	EUR	446	94362487	94382190	19703
EUR_222	10000	EUR	446	95774147	95784369	10222
EUR_222	10000	EUR	446	96116814	96127414	10600
EUR_222	10000	EUR	446	96478106	96546756	68650
EUR_222	10000	EUR	447	1924080	2022517	98437
EUR_222	10000	EUR	447	3285306	3302065	16759
EUR_222	10000	EUR	447	8712318	8714283	1965
EUR_222	10000	EUR	447	9413335	9449917	36582
EUR_222	10000	EUR	447	16223994	16240882	16888
EUR_222	10000	EUR	447	16243211	16250084	6873
EUR_222	10000	EUR	447	16322068	16402432	80364
EUR_222	10000	EUR	447	21150173	21156082	5909
EUR_222	10000	EUR	447	21200799	21216283	15484
EUR_222	10000	EUR	447	22918884	22931104	12220
EUR_222	10000	EUR	447	23721919	23797839	75920
EUR_222	10000	EUR	447	24045382	24166883	121501
EUR_222	10000	EUR	447	25953989	25987107	33118
EUR_222	10000	EUR	447	27746608	27974945	228337
EUR_222	10000	EUR	447	28111916	28138518	26602
EUR_222	10000	EUR	447	29347606	29396432	48826
EUR_222	10000	EUR	447	32731788	32870350	138562
EUR_222	10000	EUR	447	36663539	36678544	15005
EUR_222	10000	EUR	447	37722669	37749485	26816
EUR_222	10000	EUR	447	37809118	37815963	6845
EUR_222	10000	EUR	447	39639062	39661579	22517
EUR_222	10000	EUR	447	40048459	40068128	19669
EUR_222	10000	EUR	447	53821064	54076786	255722
EUR_222	10000	EUR	447	58093392	58136140	42748
EUR_222	10000	EUR	447	64338347	64502977	164630
EUR_222	10000	EUR	447	72288615	72398733	110118
EUR_222	10000	EUR	447	72961212	73040018	78806
EUR_222	10000	EUR	447	73536039	73670522	134483
EUR_222	10000	EUR	447	74871541	74894548	23007
EUR_222	10000	EUR	447	79901897	79936163	34266
EUR_222	10000	EUR	447	80161288	80278256	116968
EUR_222	10000	EUR	447	88820129	88877947	57818
EUR_222	10000	EUR	447	90426720	90469639	42919
EUR_222	10000	EUR	447	90769120	90852419	83299
EUR_222	10000	EUR	447	93553045	93655077	102032
EUR_222	10000	EUR	447	94280856	94317758	36902
EUR_222	10000	EUR	447	96136238	96175807	39569
EUR_223	10000	EUR	448	2448471	2702115	253644
EUR_223	10000	EUR	448	2996253	2997995	1742
EUR_223	10000	EUR	448	7572302	7608821	36519
EUR_223	10000	EUR	448	8712318	8714283	1965
EUR_223	10000	EUR	448	9431845	9449917	18072
EUR_223	10000	EUR	448	14051019	14112508	61489
EUR_223	10000	EUR	448	18081536	18107085	25549
EUR_223	10000	EUR	448	24076703	24094707	18004
EUR_223	10000	EUR	448	24485266	24581630	96364
EUR_223	10000	EUR	448	24892444	24906091	13647
EUR_223	10000	EUR	448	25847649	25855304	7655
EUR_223	10000	EUR	448	29306591	29339651	33060
EUR_223	10000	EUR	448	29357693	29365834	8141
EUR_223	10000	EUR	448	31551025	31605832	54807
EUR_223	10000	EUR	448	32293660	32375631	81971
EUR_223	10000	EUR	448	35771774	35849669	77895
EUR_223	10000	EUR	448	37858951	38097333	238382
EUR_223	10000	EUR	448	40410992	40424856	13864
EUR_223	10000	EUR	448	63714218	63732455	18237
EUR_223	10000	EUR	448	69023918	69060887	36969
EUR_223	10000	EUR	448	72964182	73172795	208613
EUR_223	10000	EUR	448	74871541	74894548	23007
EUR_223	10000	EUR	448	75110846	75189189	78343
EUR_223	10000	EUR	448	78246564	78301884	55320
EUR_223	10000	EUR	448	79901897	79903521	1624
EUR_223	10000	EUR	448	80454885	80489589	34704
EUR_223	10000	EUR	448	85353810	85369863	16053
EUR_223	10000	EUR	448	85374474	85490844	116370
EUR_223	10000	EUR	448	87969149	87994899	25750
EUR_223	10000	EUR	448	88543868	88600577	56709
EUR_223	10000	EUR	448	89997508	90008065	10557
EUR_223	10000	EUR	448	90153261	90243516	90255
EUR_223	10000	EUR	448	90972791	91089410	116619
EUR_223	10000	EUR	448	91847626	91929323	81697
EUR_223	10000	EUR	448	92062604	92171686	109082
EUR_223	10000	EUR	448	94360002	94418018	58016
EUR_223	10000	EUR	448	94419260	94515321	96061
EUR_223	10000	EUR	448	95774147	95844558	70411
EUR_223	10000	EUR	449	1444128	1458138	14010
EUR_223	10000	EUR	449	13574314	13635433	61119
EUR_223	10000	EUR	449	13640984	13644276	3292
EUR_223	10000	EUR	449	14051019	14099119	48100
EUR_223	10000	EUR	449	16258452	16437214	178762
EUR_223	10000	EUR	449	21093849	21390474	296625
EUR_223	10000	EUR	449	24081636	24094707	13071
EUR_223	10000	EUR	449	24380643	24510921	130278
EUR_223	10000	EUR	449	24892444	24906091	13647
EUR_223	10000	EUR	449	25285126	25305885	20759
EUR_223	10000	EUR	449	25421392	25501390	79998
EUR_223	10000	EUR	449	29347606	29396432	48826
EUR_223	10000	EUR	449	30976914	31127610	150696
EUR_223	10000	EUR	449	32096820	32124528	27708
EUR_223	10000	EUR	449	32767431	32880042	112611
EUR_223	10000	EUR	449	39668407	39692065	23658
EUR_223	10000	EUR	449	43641906	43653793	11887
EUR_223	10000	EUR	449	59423469	59440361	16892
EUR_223	10000	EUR	449	59554189	59607931	53742
EUR_223	10000	EUR	449	68675332	68717300	41968
EUR_223	10000	EUR	449	72288615	72298050	9435
EUR_223	10000	EUR	449	72961212	73030087	68875
EUR_223	10000	EUR	449	76028662	76143984	115322
EUR_223	10000	EUR	449	81059267	81108910	49643
EUR_223	10000	EUR	449	83955315	83957574	2259
EUR_223	10000	EUR	449	84235412	84245003	9591
EUR_223	10000	EUR	449	87760040	87858554	98514
EUR_223	10000	EUR	449	88825376	89047979	222603
EUR_223	10000	EUR	449	89084957	89107132	22175
EUR_223	10000	EUR	449	91011409	91097487	86078
EUR_223	10000	EUR	449	93585543	93713967	128424
EUR_223	10000	EUR	449	94239181	94337048	97867
EUR_223	10000	EUR	449	94348955	94412962	64007
EUR_223	10000	EUR	449	94523809	94559172	35363
EUR_224	10000	EUR	450	1853096	1854996	1900
EUR_224	10000	EUR	450	5253381	5312534	59153
EUR_224	10000	EUR	450	9321331	9384265	62934
EUR_224	10000	EUR	450	16397154	16454511	57357
EUR_224	10000	EUR	450	17749730	17804155	54425
EUR_224	10000	EUR	450	18127775	18140078	12303
EUR_224	10000	EUR	450	18622886	18751123	128237
EUR_224	10000	EUR	450	21224963	21225412	449
EUR_224	10000	EUR	450	22113151	22206126	92975
EUR_224	10000	EUR	450	23721919	23725831	3912
EUR_224	10000	EUR	450	24485266	24581630	96364
EUR_224	10000	EUR	450	24892444	24906091	13647
EUR_224	10000	EUR	450	25867195	25938340	71145
EUR_224	10000	EUR	450	26819249	26911224	91975
EUR_224	10000	EUR	450	27746608	27974945	228337
EUR_224	10000	EUR	450	28111916	28138518	26602
EUR_224	10000	EUR	450	29291099	29311528	20429
EUR_224	10000	EUR	450	32128042	32141896	13854
EUR_224	10000	EUR	450	35771774	35849669	77895
EUR_224	10000	EUR	450	37885686	37943125	57439
EUR_224	10000	EUR	450	39683574	39692065	8491
EUR_224	10000	EUR	450	54659849	54667387	7538
EUR_224	10000	EUR	450	58093392	58136140	42748
EUR_224	10000	EUR	450	63714218	63732455	18237
EUR_224	10000	EUR	450	74055055	74094072	39017
EUR_224	10000	EUR	450	75110846	75189189	78343
EUR_224	10000	EUR	450	77751346	77795912	44566
EUR_224	10000	EUR	450	79860282	79933512	73230
EUR_224	10000	EUR	450	83370620	83384810	14190
EUR_224	10000	EUR	450	83955315	83957574	2259
EUR_224	10000	EUR	450	87969149	87994899	25750
EUR_224	10000	EUR	450	88077880	88319207	241327
EUR_224	10000	EUR	450	88761110	88877947	116837
EUR_224	10000	EUR	450	93553045	93607994	54949
EUR_224	10000	EUR	450	95831568	95869746	38178
EUR_224	10000	EUR	451	2519034	2648737	129703
EUR_224	10000	EUR	451	5018475	5041230	22755
EUR_224	10000	EUR	451	9414397	9449917	35520
EUR_224	10000	EUR	451	16234928	16286721	51793
EUR_224	10000	EUR	451	22496216	22533171	36955
EUR_224	10000	EUR	451	22992959	23018168	25209
EUR_224	10000	EUR	451	23122511	23184805	62294
EUR_224	10000	EUR	451	23863969	23877108	13139
EUR_224	10000	EUR	451	24084401	24166883	82482
EUR_224	10000	EUR	451	24621120	24737906	116786
EUR_224	10000	EUR	451	24809049	24866754	57705
EUR_224	10000	EUR	451	25868315	25896396	28081
EUR_224	10000	EUR	451	27746608	27800312	53704
EUR_224	10000	EUR	451	27834573	27974945	140372
EUR_224	10000	EUR	451	29347606	29396432	48826
EUR_224	10000	EUR	451	29465324	29478208	12884
EUR_224	10000	EUR	451	30904434	31092945	188511
EUR_224	10000	EUR	451	32421761	32431881	10120
EUR_224	10000	EUR	451	32526542	32537277	10735
EUR_224	10000	EUR	451	35084593	35087281	2688
EUR_224	10000	EUR	451	36663539	36678544	15005
EUR_224	10000	EUR	451	49828382	49856342	27960
EUR_224	10000	EUR	451	49860683	49868492	7809
EUR_224	10000	EUR	451	54042400	54076786	34386
EUR_224	10000	EUR	451	54693132	54767938	74806
EUR_224	10000	EUR	451	54893690	54904011	10321
EUR_224	10000	EUR	451	56378802	56448072	69270
EUR_224	10000	EUR	451	71670386	71678663	8277
EUR_224	10000	EUR	451	73498527	73660589	162062
EUR_224	10000	EUR	451	73884457	73906350	21893
EUR_224	10000	EUR	451	74871541	74894548	23007
EUR_224	10000	EUR	451	75110846	75189189	78343
EUR_224	10000	EUR	451	76365488	76370099	4611
EUR_224	10000	EUR	451	77865503	77881732	16229
EUR_224	10000	EUR	451	85377298	85405856	28558
EUR_224	10000	EUR	451	87369479	87389813	20334
EUR_224	10000	EUR	451	88307099	88333763	26664
EUR_224	10000	EUR	451	90426720	90469477	42757
EUR_224	10000	EUR	451	93499176	93647010	147834
EUR_224	10000	EUR	451	94290726	94412962	122236
EUR_224	10000	EUR	451	96116814	96159845	43031
EUR_224	10000	EUR	451	96537974	96636521	98547
EUR_225	10000	EUR	452	1361900	1385444	23544
EUR_225	10000	EUR	452	2984450	2997995	13545
EUR_225	10000	EUR	452	4020191	4044195	24004
EUR_225	10000	EUR	452	16397154	16454511	57357
EUR_225	10000	EUR	452	18100331	18140078	39747
EUR_225	10000	EUR	452	22519633	22533171	13538
EUR_225	10000	EUR	452	22992959	23099324	106365
EUR_225	10000	EUR	452	23156936	23184805	27869
EUR_225	10000	EUR	452	23863969	23877108	13139
EUR_225	10000	EUR	452	24045382	24120899	75517
EUR_225	10000	EUR	452	24372241	24384508	12267
EUR_225	10000	EUR	452	24535579	24581630	46051
EUR_225	10000	EUR	452	25325282	25325345	63
EUR_225	10000	EUR	452	25343770	25501390	157620
EUR_225	10000	EUR	452	25978368	25987107	8739
EUR_225	10000	EUR	452	26403126	26429831	26705
EUR_225	10000	EUR	452	26886230	26971931	85701
EUR_225	10000	EUR	452	29444267	29483168	38901
EUR_225	10000	EUR	452	31087987	31131774	43787
EUR_225	10000	EUR	452	32694491	32759145	64654
EUR_225	10000	EUR	452	39858032	40001122	143090
EUR_225	10000	EUR	452	43520906	43653793	132887
EUR_225	10000	EUR	452	53821064	54035252	214188
EUR_225	10000	EUR	452	59699786	59762964	63178
EUR_225	10000	EUR	452	69048774	69068474	19700
EUR_225	10000	EUR	452	71544591	71629966	85375
EUR_225	10000	EUR	452	73498527	73543209	44682
EUR_225	10000	EUR	452	73633815	73690740	56925
EUR_225	10000	EUR	452	73852581	73906350	53769
EUR_225	10000	EUR	452	76022322	76143984	121662
EUR_225	10000	EUR	452	76365488	76368751	3263
EUR_225	10000	EUR	452	86916801	86926886	10085
EUR_225	10000	EUR	452	87512858	87623148	110290
EUR_225	10000	EUR	452	88516467	88537179	20712
EUR_225	10000	EUR	452	88761110	88877947	116837
EUR_225	10000	EUR	452	88967678	88970455	2777
EUR_225	10000	EUR	452	89990045	89998439	8394
EUR_225	10000	EUR	452	90782132	90939817	157685
EUR_225	10000	EUR	452	91847626	91875197	27571
EUR_225	10000	EUR	452	92062604	92105471	42867
EUR_225	10000	EUR	452	93123848	93146996	23148
EUR_225	10000	EUR	452	93318121	93371609	53488
EUR_225	10000	EUR	452	93943380	94056780	113400
EUR_225	10000	EUR	452	94297447	94399538	102091
EUR_225	10000	EUR	452	95900274	95927099	26825
EUR_225	10000	EUR	453	1330157	1385444	55287
EUR_225	10000	EUR	453	2980758	3053070	72312
EUR_225	10000	EUR	453	13076756	13125585	48829
EUR_225	10000	EUR	453	16234928	16286721	51793
EUR_225	10000	EUR	453	23165262	23266699	101437
EUR_225	10000	EUR	453	24052207	24166883	114676
EUR_225	10000	EUR	453	24528522	24581630	53108
EUR_225	10000	EUR	453	26319359	26552409	233050
EUR_225	10000	EUR	453	27746608	27974945	228337
EUR_225	10000	EUR	453	28111916	28139866	27950
EUR_225	10000	EUR	453	29291099	29311528	20429
EUR_225	10000	EUR	453	32421761	32431881	10120
EUR_225	10000	EUR	453	32526542	32537277	10735
EUR_225	10000	EUR	453	32694491	32750640	56149
EUR_225	10000	EUR	453	33245767	33429152	183385
EUR_225	10000	EUR	453	37776227	37890590	114363
EUR_225	10000	EUR	453	42430229	42468277	38048
EUR_225	10000	EUR	453	43520906	43637201	116295
EUR_225	10000	EUR	453	50053800	50073818	20018
EUR_225	10000	EUR	453	53875418	53947462	72044
EUR_225	10000	EUR	453	54503155	54753618	250463
EUR_225	10000	EUR	453	56447306	56448072	766
EUR_225	10000	EUR	453	59744029	59762964	18935
EUR_225	10000	EUR	453	63714218	63732455	18237
EUR_225	10000	EUR	453	76022322	76143984	121662
EUR_225	10000	EUR	453	76456850	76594146	137296
EUR_225	10000	EUR	453	79860282	79933512	73230
EUR_225	10000	EUR	453	83533777	83550130	16353
EUR_225	10000	EUR	453	87653008	87835159	182151
EUR_225	10000	EUR	453	88077880	88113143	35263
EUR_225	10000	EUR	453	88761110	89038093	276983
EUR_225	10000	EUR	453	90058636	90173684	115048
EUR_225	10000	EUR	453	93553045	93713967	160922
EUR_225	10000	EUR	453	94239181	94337048	97867
EUR_225	10000	EUR	453	94348955	94412962	64007
EUR_225	10000	EUR	453	94523809	94557018	33209
EUR_225	10000	EUR	453	95774147	95801058	26911
EUR_225	10000	EUR	453	96116814	96140060	23246
EUR_225	10000	EUR	453	99177558	99280798	103240
EUR_226	10000	EUR	454	1924080	2002096	78016
EUR_226	10000	EUR	454	2546510	2648737	102227
EUR_226	10000	EUR	454	16258452	16437214	178762
EUR_226	10000	EUR	454	20981647	21202559	220912
EUR_226	10000	EUR	454	22447027	22465519	18492
EUR_226	10000	EUR	454	23551311	23651476	100165
EUR_226	10000	EUR	454	23721919	23797839	75920
EUR_226	10000	EUR	454	24809049	24866754	57705
EUR_226	10000	EUR	454	26371392	26522090	150698
EUR_226	10000	EUR	454	28111916	28139866	27950
EUR_226	10000	EUR	454	29347606	29396432	48826
EUR_226	10000	EUR	454	32824940	32871485	46545
EUR_226	10000	EUR	454	38008857	38097333	88476
EUR_226	10000	EUR	454	52650852	52662927	12075
EUR_226	10000	EUR	454	64402138	64494333	92195
EUR_226	10000	EUR	454	68626746	68635431	8685
EUR_226	10000	EUR	454	69023918	69060887	36969
EUR_226	10000	EUR	454	73209823	73223816	13993
EUR_226	10000	EUR	454	73498527	73536154	37627
EUR_226	10000	EUR	454	75110846	75189189	78343
EUR_226	10000	EUR	454	78246564	78301884	55320
EUR_226	10000	EUR	454	83886982	83901141	14159
EUR_226	10000	EUR	454	84235412	84254246	18834
EUR_226	10000	EUR	454	87369479	87389813	20334
EUR_226	10000	EUR	454	89989980	89998439	8459
EUR_226	10000	EUR	454	91018779	91089758	70979
EUR_226	10000	EUR	454	91891040	91902611	11571
EUR_226	10000	EUR	454	93553045	93713967	160922
EUR_226	10000	EUR	454	94290726	94412962	122236
EUR_226	10000	EUR	454	94473086	94544971	71885
EUR_226	10000	EUR	455	1322727	1329694	6967
EUR_226	10000	EUR	455	1762556	1830270	67714
EUR_226	10000	EUR	455	2942516	3053070	110554
EUR_226	10000	EUR	455	8348919	8386102	37183
EUR_226	10000	EUR	455	12804205	12847009	42804
EUR_226	10000	EUR	455	13574314	13635433	61119
EUR_226	10000	EUR	455	13640984	13678187	37203
EUR_226	10000	EUR	455	16202082	16325554	123472
EUR_226	10000	EUR	455	21061270	21202559	141289
EUR_226	10000	EUR	455	24045382	24155650	110268
EUR_226	10000	EUR	455	25323974	25378298	54324
EUR_226	10000	EUR	455	26322539	26437729	115190
EUR_226	10000	EUR	455	32057270	32084128	26858
EUR_226	10000	EUR	455	34124908	34181406	56498
EUR_226	10000	EUR	455	53821064	53842770	21706
EUR_226	10000	EUR	455	54570690	54612977	42287
EUR_226	10000	EUR	455	58569405	58694180	124775
EUR_226	10000	EUR	455	69023918	69051154	27236
EUR_226	10000	EUR	455	71544591	71559282	14691
EUR_226	10000	EUR	455	72354137	72398733	44596
EUR_226	10000	EUR	455	75886611	75915063	28452
EUR_226	10000	EUR	455	76024488	76093521	69033
EUR_226	10000	EUR	455	76502715	76594146	91431
EUR_226	10000	EUR	455	79860282	79933512	73230
EUR_226	10000	EUR	455	88789226	89001971	212745
EUR_226	10000	EUR	455	89189593	89235318	45725
EUR_226	10000	EUR	455	93800814	93869231	68417
EUR_226	10000	EUR	455	94350732	94375754	25022
EUR_226	10000	EUR	455	96116814	96220219	103405
EUR_227	10000	EUR	456	14051019	14086388	35369
EUR_227	10000	EUR	456	16243211	16363352	120141
EUR_227	10000	EUR	456	21150173	21156082	5909
EUR_227	10000	EUR	456	21200799	21216283	15484
EUR_227	10000	EUR	456	21411240	21429464	18224
EUR_227	10000	EUR	456	23176150	23183923	7773
EUR_227	10000	EUR	456	23487541	23495408	7867
EUR_227	10000	EUR	456	23752602	23856810	104208
EUR_227	10000	EUR	456	24045382	24166883	121501
EUR_227	10000	EUR	456	24528522	24581630	53108
EUR_227	10000	EUR	456	25162449	25162865	416
EUR_227	10000	EUR	456	25189085	25199362	10277
EUR_227	10000	EUR	456	26477051	26562248	85197
EUR_227	10000	EUR	456	26946861	26991485	44624
EUR_227	10000	EUR	456	31233297	31314394	81097
EUR_227	10000	EUR	456	31478668	31502542	23874
EUR_227	10000	EUR	456	32081977	32141896	59919
EUR_227	10000	EUR	456	37727611	38025102	297491
EUR_227	10000	EUR	456	39639062	39692065	53003
EUR_227	10000	EUR	456	40132875	40145306	12431
EUR_227	10000	EUR	456	54659849	54667387	7538
EUR_227	10000	EUR	456	57160756	57207163	46407
EUR_227	10000	EUR	456	64338347	64344522	6175
EUR_227	10000	EUR	456	72256813	72314514	57701
EUR_227	10000	EUR	456	74871541	74894548	23007
EUR_227	10000	EUR	456	80520393	80530144	9751
EUR_227	10000	EUR	456	80941681	81087964	146283
EUR_227	10000	EUR	456	88126552	88319207	192655
EUR_227	10000	EUR	456	88825376	89047979	222603
EUR_227	10000	EUR	456	89084957	89124034	39077
EUR_227	10000	EUR	456	90159786	90243516	83730
EUR_227	10000	EUR	456	93553045	93599633	46588
EUR_227	10000	EUR	456	93628871	93713967	85096
EUR_227	10000	EUR	456	94523809	94559172	35363
EUR_227	10000	EUR	456	95878015	95887608	9593
EUR_227	10000	EUR	457	340121	401572	61451
EUR_227	10000	EUR	457	3794084	3864030	69946
EUR_227	10000	EUR	457	4020191	4044195	24004
EUR_227	10000	EUR	457	11703759	11708397	4638
EUR_227	10000	EUR	457	17687142	17689297	2155
EUR_227	10000	EUR	457	21282367	21340468	58101
EUR_227	10000	EUR	457	21411240	21429464	18224
EUR_227	10000	EUR	457	22279659	22313169	33510
EUR_227	10000	EUR	457	23122511	23184805	62294
EUR_227	10000	EUR	457	23863969	23877108	13139
EUR_227	10000	EUR	457	24621120	24643764	22644
EUR_227	10000	EUR	457	24892444	24906091	13647
EUR_227	10000	EUR	457	25285126	25305885	20759
EUR_227	10000	EUR	457	25867195	25906725	39530
EUR_227	10000	EUR	457	26371392	26525365	153973
EUR_227	10000	EUR	457	26575524	26580898	5374
EUR_227	10000	EUR	457	31087987	31134684	46697
EUR_227	10000	EUR	457	32293660	32358015	64355
EUR_227	10000	EUR	457	32667412	32870350	202938
EUR_227	10000	EUR	457	37872045	37906769	34724
EUR_227	10000	EUR	457	42369514	42431902	62388
EUR_227	10000	EUR	457	53821064	53859932	38868
EUR_227	10000	EUR	457	69023918	69060887	36969
EUR_227	10000	EUR	457	72288615	72398733	110118
EUR_227	10000	EUR	457	74410856	74413281	2425
EUR_227	10000	EUR	457	75263541	75264425	884
EUR_227	10000	EUR	457	75587305	75641163	53858
EUR_227	10000	EUR	457	77839858	77848347	8489
EUR_227	10000	EUR	457	79901897	79936163	34266
EUR_227	10000	EUR	457	80161288	80278256	116968
EUR_227	10000	EUR	457	88951047	89050718	99671
EUR_227	10000	EUR	457	91891040	91902611	11571
EUR_227	10000	EUR	457	92153800	92171686	17886
EUR_227	10000	EUR	457	94260324	94317758	57434
EUR_228	10000	EUR	458	1924080	2022517	98437
EUR_228	10000	EUR	458	2852029	2886250	34221
EUR_228	10000	EUR	458	4098528	4126878	28350
EUR_228	10000	EUR	458	4129102	4130169	1067
EUR_228	10000	EUR	458	13621609	13626532	4923
EUR_228	10000	EUR	458	14051019	14108442	57423
EUR_228	10000	EUR	458	15907310	16047641	140331
EUR_228	10000	EUR	458	16202082	16208586	6504
EUR_228	10000	EUR	458	16243211	16367500	124289
EUR_228	10000	EUR	458	16441449	16454511	13062
EUR_228	10000	EUR	458	17749730	17822978	73248
EUR_228	10000	EUR	458	17946005	18041675	95670
EUR_228	10000	EUR	458	21093849	21390474	296625
EUR_228	10000	EUR	458	22447027	22462305	15278
EUR_228	10000	EUR	458	23122511	23184805	62294
EUR_228	10000	EUR	458	28111916	28139866	27950
EUR_228	10000	EUR	458	29291099	29311528	20429
EUR_228	10000	EUR	458	31235544	31314394	78850
EUR_228	10000	EUR	458	32081977	32141896	59919
EUR_228	10000	EUR	458	35664184	35693478	29294
EUR_228	10000	EUR	458	35699524	35892995	193471
EUR_228	10000	EUR	458	36050639	36089268	38629
EUR_228	10000	EUR	458	37809118	37815963	6845
EUR_228	10000	EUR	458	37989082	38097333	108251
EUR_228	10000	EUR	458	54210889	54362674	151785
EUR_228	10000	EUR	458	54765460	54904011	138551
EUR_228	10000	EUR	458	56378802	56448072	69270
EUR_228	10000	EUR	458	59674842	59696190	21348
EUR_228	10000	EUR	458	64857298	64922329	65031
EUR_228	10000	EUR	458	73209823	73223816	13993
EUR_228	10000	EUR	458	73519049	73632251	113202
EUR_228	10000	EUR	458	76137655	76143984	6329
EUR_228	10000	EUR	458	79082049	79134588	52539
EUR_228	10000	EUR	458	83533777	83550130	16353
EUR_228	10000	EUR	458	84755692	84760554	4862
EUR_228	10000	EUR	458	87369479	87389813	20334
EUR_228	10000	EUR	458	87650695	87656802	6107
EUR_228	10000	EUR	458	88527647	88619025	91378
EUR_228	10000	EUR	458	88844908	88969613	124705
EUR_228	10000	EUR	458	89189593	89235318	45725
EUR_228	10000	EUR	458	89387609	89465942	78333
EUR_228	10000	EUR	458	90115145	90243516	128371
EUR_228	10000	EUR	458	91074962	91107582	32620
EUR_228	10000	EUR	458	91891040	91902611	11571
EUR_228	10000	EUR	458	94447447	94522438	74991
EUR_228	10000	EUR	458	94532669	94544971	12302
EUR_228	10000	EUR	458	95807173	95814824	7651
EUR_228	10000	EUR	458	96136238	96175807	39569
EUR_228	10000	EUR	458	96854339	96912582	58243
EUR_228	10000	EUR	459	2845570	2875735	30165
EUR_228	10000	EUR	459	5121074	5123781	2707
EUR_228	10000	EUR	459	14107814	14108442	628
EUR_228	10000	EUR	459	16319606	16401162	81556
EUR_228	10000	EUR	459	17749730	17804155	54425
EUR_228	10000	EUR	459	18716646	18844474	127828
EUR_228	10000	EUR	459	22279659	22313169	33510
EUR_228	10000	EUR	459	23427310	23651476	224166
EUR_228	10000	EUR	459	23721919	23752615	30696
EUR_228	10000	EUR	459	24045382	24047133	1751
EUR_228	10000	EUR	459	24076703	24094707	18004
EUR_228	10000	EUR	459	24485266	24581630	96364
EUR_228	10000	EUR	459	24892444	24906091	13647
EUR_228	10000	EUR	459	25343770	25475185	131415
EUR_228	10000	EUR	459	26375604	26429831	54227
EUR_228	10000	EUR	459	29306591	29579668	273077
EUR_228	10000	EUR	459	30904434	30925177	20743
EUR_228	10000	EUR	459	31134272	31138800	4528
EUR_228	10000	EUR	459	32737046	32870350	133304
EUR_228	10000	EUR	459	37754246	38097333	343087
EUR_228	10000	EUR	459	40132875	40145306	12431
EUR_228	10000	EUR	459	40978192	40979135	943
EUR_228	10000	EUR	459	42430229	42468277	38048
EUR_228	10000	EUR	459	54653171	54730663	77492
EUR_228	10000	EUR	459	57136159	57141457	5298
EUR_228	10000	EUR	459	57188385	57259820	71435
EUR_228	10000	EUR	459	71722082	71764001	41919
EUR_228	10000	EUR	459	74640712	74691511	50799
EUR_228	10000	EUR	459	75110846	75189189	78343
EUR_228	10000	EUR	459	78846360	78865177	18817
EUR_228	10000	EUR	459	83370620	83382896	12276
EUR_228	10000	EUR	459	83886982	83921060	34078
EUR_228	10000	EUR	459	87504329	87507341	3012
EUR_228	10000	EUR	459	88504749	88553171	48422
EUR_228	10000	EUR	459	89035598	89038093	2495
EUR_228	10000	EUR	459	90058636	90243516	184880
EUR_228	10000	EUR	459	90769120	90852419	83299
EUR_228	10000	EUR	459	93553045	93607994	54949
EUR_228	10000	EUR	459	93630747	93713967	83220
EUR_228	10000	EUR	459	94595895	94698014	102119
EUR_228	10000	EUR	459	94915497	94930362	14865
EUR_228	10000	EUR	459	94962888	95011492	48604
EUR_229	10000	EUR	460	1330157	1336755	6598
EUR_229	10000	EUR	460	1762556	1793930	31374
EUR_229	10000	EUR	460	1951091	1959936	8845
EUR_229	10000	EUR	460	2984450	2997995	13545
EUR_229	10000	EUR	460	7601661	7608821	7160
EUR_229	10000	EUR	460	13792778	13805391	12613
EUR_229	10000	EUR	460	16670198	16681323	11125
EUR_229	10000	EUR	460	18716646	18844474	127828
EUR_229	10000	EUR	460	22519633	22533171	13538
EUR_229	10000	EUR	460	23432743	23538903	106160
EUR_229	10000	EUR	460	23648833	23651476	2643
EUR_229	10000	EUR	460	24485266	24581630	96364
EUR_229	10000	EUR	460	25343770	25501390	157620
EUR_229	10000	EUR	460	25978368	25987107	8739
EUR_229	10000	EUR	460	26403126	26429831	26705
EUR_229	10000	EUR	460	26886230	26991485	105255
EUR_229	10000	EUR	460	27746608	27974945	228337
EUR_229	10000	EUR	460	28111916	28138518	26602
EUR_229	10000	EUR	460	29291099	29311528	20429
EUR_229	10000	EUR	460	30904434	31092945	188511
EUR_229	10000	EUR	460	32431231	32446630	15399
EUR_229	10000	EUR	460	32858056	32870350	12294
EUR_229	10000	EUR	460	35084593	35087281	2688
EUR_229	10000	EUR	460	36663539	36678544	15005
EUR_229	10000	EUR	460	39639062	39696725	57663
EUR_229	10000	EUR	460	40410992	40508892	97900
EUR_229	10000	EUR	460	41319133	41360462	41329
EUR_229	10000	EUR	460	42542529	42544886	2357
EUR_229	10000	EUR	460	54113043	54177383	64340
EUR_229	10000	EUR	460	54300284	54362674	62390
EUR_229	10000	EUR	460	59423469	59522281	98812
EUR_229	10000	EUR	460	69023918	69060887	36969
EUR_229	10000	EUR	460	72383548	72408775	25227
EUR_229	10000	EUR	460	73488506	73493479	4973
EUR_229	10000	EUR	460	73900239	73906350	6111
EUR_229	10000	EUR	460	74410856	74438736	27880
EUR_229	10000	EUR	460	77751346	77795912	44566
EUR_229	10000	EUR	460	79901897	79903521	1624
EUR_229	10000	EUR	460	81034417	81108910	74493
EUR_229	10000	EUR	460	88211398	88319207	107809
EUR_229	10000	EUR	460	88761110	88877947	116837
EUR_229	10000	EUR	460	89463400	89508341	44941
EUR_229	10000	EUR	460	91011409	91097487	86078
EUR_229	10000	EUR	460	91622054	91644321	22267
EUR_229	10000	EUR	460	93680632	93680672	40
EUR_229	10000	EUR	460	94239181	94337048	97867
EUR_229	10000	EUR	460	94348955	94375754	26799
EUR_229	10000	EUR	460	94793518	95011492	217974
EUR_229	10000	EUR	461	2415974	2536319	120345
EUR_229	10000	EUR	461	3963309	4130169	166860
EUR_229	10000	EUR	461	5121074	5123781	2707
EUR_229	10000	EUR	461	8662954	8714283	51329
EUR_229	10000	EUR	461	18704683	18833631	128948
EUR_229	10000	EUR	461	23432743	23480035	47292
EUR_229	10000	EUR	461	24497190	24581630	84440
EUR_229	10000	EUR	461	24892444	24906091	13647
EUR_229	10000	EUR	461	25867195	25906960	39765
EUR_229	10000	EUR	461	29306591	29478208	171617
EUR_229	10000	EUR	461	31087987	31151086	63099
EUR_229	10000	EUR	461	39821749	39934253	112504
EUR_229	10000	EUR	461	43359651	43453960	94309
EUR_229	10000	EUR	461	54005322	54016981	11659
EUR_229	10000	EUR	461	54799832	54872046	72214
EUR_229	10000	EUR	461	57136159	57262845	126686
EUR_229	10000	EUR	461	58580135	58590760	10625
EUR_229	10000	EUR	461	74640712	74701524	60812
EUR_229	10000	EUR	461	76456850	76594146	137296
EUR_229	10000	EUR	461	79086226	79134588	48362
EUR_229	10000	EUR	461	83914085	83936571	22486
EUR_229	10000	EUR	461	84755692	84810053	54361
EUR_229	10000	EUR	461	86916801	86971491	54690
EUR_229	10000	EUR	461	89356470	89465942	109472
EUR_229	10000	EUR	461	90317162	90532466	215304
EUR_229	10000	EUR	461	90721077	90969654	248577
EUR_229	10000	EUR	461	93585543	93607994	22451
EUR_229	10000	EUR	461	94447447	94522438	74991
EUR_229	10000	EUR	461	94915497	94930362	14865
EUR_230	10000	EUR	462	3963309	4000297	36988
EUR_230	10000	EUR	462	7601661	7608821	7160
EUR_230	10000	EUR	462	9235548	9282969	47421
EUR_230	10000	EUR	462	9431845	9449917	18072
EUR_230	10000	EUR	462	11703759	11814111	110352
EUR_230	10000	EUR	462	13970992	14057978	86986
EUR_230	10000	EUR	462	17889447	17902017	12570
EUR_230	10000	EUR	462	23432743	23471650	38907
EUR_230	10000	EUR	462	24140903	24163756	22853
EUR_230	10000	EUR	462	24749954	24757234	7280
EUR_230	10000	EUR	462	24892444	24906091	13647
EUR_230	10000	EUR	462	25867195	25906960	39765
EUR_230	10000	EUR	462	29291099	29311528	20429
EUR_230	10000	EUR	462	32057270	32141896	84626
EUR_230	10000	EUR	462	32767431	32880042	112611
EUR_230	10000	EUR	462	34124908	34182116	57208
EUR_230	10000	EUR	462	37885686	37943125	57439
EUR_230	10000	EUR	462	54659849	54667387	7538
EUR_230	10000	EUR	462	56378802	56448072	69270
EUR_230	10000	EUR	462	59631177	59631623	446
EUR_230	10000	EUR	462	64321831	64519080	197249
EUR_230	10000	EUR	462	72961212	73122070	160858
EUR_230	10000	EUR	462	77733985	77735979	1994
EUR_230	10000	EUR	462	79901897	79936163	34266
EUR_230	10000	EUR	462	80161288	80278256	116968
EUR_230	10000	EUR	462	88087834	88146039	58205
EUR_230	10000	EUR	462	88221167	88300295	79128
EUR_230	10000	EUR	462	88761110	89081743	320633
EUR_230	10000	EUR	462	89356470	89465942	109472
EUR_230	10000	EUR	462	93553045	93655077	102032
EUR_230	10000	EUR	462	94362487	94382190	19703
EUR_230	10000	EUR	463	2415974	2702115	286141
EUR_230	10000	EUR	463	11703759	11708397	4638
EUR_230	10000	EUR	463	13626361	13626532	171
EUR_230	10000	EUR	463	17687142	17689297	2155
EUR_230	10000	EUR	463	24372241	24378713	6472
EUR_230	10000	EUR	463	24388547	24518649	130102
EUR_230	10000	EUR	463	25323974	25378298	54324
EUR_230	10000	EUR	463	25888011	25976664	88653
EUR_230	10000	EUR	463	26371392	26400185	28793
EUR_230	10000	EUR	463	26886230	26991485	105255
EUR_230	10000	EUR	463	27746608	27834359	87751
EUR_230	10000	EUR	463	32262916	32267787	4871
EUR_230	10000	EUR	463	32824940	32828620	3680
EUR_230	10000	EUR	463	32839913	32880042	40129
EUR_230	10000	EUR	463	37727611	37750158	22547
EUR_230	10000	EUR	463	37816575	37817231	656
EUR_230	10000	EUR	463	39639062	39696725	57663
EUR_230	10000	EUR	463	40047500	40068128	20628
EUR_230	10000	EUR	463	42493150	42574352	81202
EUR_230	10000	EUR	463	50053800	50097389	43589
EUR_230	10000	EUR	463	53821064	53859932	38868
EUR_230	10000	EUR	463	54123719	54150257	26538
EUR_230	10000	EUR	463	54403505	54431022	27517
EUR_230	10000	EUR	463	54686744	54688209	1465
EUR_230	10000	EUR	463	54714203	54904011	189808
EUR_230	10000	EUR	463	59208358	59245710	37352
EUR_230	10000	EUR	463	59674842	59696190	21348
EUR_230	10000	EUR	463	73884457	73906350	21893
EUR_230	10000	EUR	463	78846360	78865177	18817
EUR_230	10000	EUR	463	83370620	83384810	14190
EUR_230	10000	EUR	463	84755692	84810053	54361
EUR_230	10000	EUR	463	87665598	87721794	56196
EUR_230	10000	EUR	463	88405406	88464514	59108
EUR_230	10000	EUR	463	88476761	88537179	60418
EUR_230	10000	EUR	463	88761110	88877947	116837
EUR_230	10000	EUR	463	90058636	90243516	184880
EUR_230	10000	EUR	463	90769120	90852419	83299
EUR_230	10000	EUR	463	91891040	91902611	11571
EUR_230	10000	EUR	463	93908281	93925519	17238
EUR_230	10000	EUR	463	96116814	96159845	43031
EUR_230	10000	EUR	463	96988153	96992855	4702
EUR_231	10000	EUR	464	3963320	4031854	68534
EUR_231	10000	EUR	464	12764351	12847009	82658
EUR_231	10000	EUR	464	21150173	21156082	5909
EUR_231	10000	EUR	464	21200799	21216283	15484
EUR_231	10000	EUR	464	22320042	22417821	97779
EUR_231	10000	EUR	464	22454245	22608307	154062
EUR_231	10000	EUR	464	22890136	23113974	223838
EUR_231	10000	EUR	464	23176150	23184805	8655
EUR_231	10000	EUR	464	23752602	23877108	124506
EUR_231	10000	EUR	464	24419285	24446494	27209
EUR_231	10000	EUR	464	24692381	24732696	40315
EUR_231	10000	EUR	464	24892444	24906091	13647
EUR_231	10000	EUR	464	29347606	29396432	48826
EUR_231	10000	EUR	464	30937577	31092945	155368
EUR_231	10000	EUR	464	32694491	32759145	64654
EUR_231	10000	EUR	464	32788803	32880042	91239
EUR_231	10000	EUR	464	34124908	34182116	57208
EUR_231	10000	EUR	464	40410992	40475640	64648
EUR_231	10000	EUR	464	40555384	40602505	47121
EUR_231	10000	EUR	464	42430229	42456760	26531
EUR_231	10000	EUR	464	43359651	43471816	112165
EUR_231	10000	EUR	464	54659849	54667387	7538
EUR_231	10000	EUR	464	57160756	57207163	46407
EUR_231	10000	EUR	464	58093392	58136140	42748
EUR_231	10000	EUR	464	64338347	64344522	6175
EUR_231	10000	EUR	464	69023918	69060887	36969
EUR_231	10000	EUR	464	74871541	74894548	23007
EUR_231	10000	EUR	464	75121914	75189189	67275
EUR_231	10000	EUR	464	79860282	79933512	73230
EUR_231	10000	EUR	464	80941681	81087964	146283
EUR_231	10000	EUR	464	83370620	83384810	14190
EUR_231	10000	EUR	464	88452177	88464514	12337
EUR_231	10000	EUR	464	88476761	88537179	60418
EUR_231	10000	EUR	464	91848327	91929323	80996
EUR_231	10000	EUR	464	91987726	92020761	33035
EUR_231	10000	EUR	464	93943380	94056780	113400
EUR_231	10000	EUR	464	94205094	94222927	17833
EUR_231	10000	EUR	464	94447447	94522438	74991
EUR_231	10000	EUR	464	94915497	94930362	14865
EUR_231	10000	EUR	465	1330157	1336755	6598
EUR_231	10000	EUR	465	1762556	1793930	31374
EUR_231	10000	EUR	465	1951091	1959936	8845
EUR_231	10000	EUR	465	9279789	9308590	28801
EUR_231	10000	EUR	465	18100331	18140078	39747
EUR_231	10000	EUR	465	18622886	18751123	128237
EUR_231	10000	EUR	465	21093849	21174648	80799
EUR_231	10000	EUR	465	23176150	23184805	8655
EUR_231	10000	EUR	465	23564194	23594899	30705
EUR_231	10000	EUR	465	23752602	23818582	65980
EUR_231	10000	EUR	465	24084401	24166883	82482
EUR_231	10000	EUR	465	24621120	24737906	116786
EUR_231	10000	EUR	465	24809049	24866754	57705
EUR_231	10000	EUR	465	25980461	25987107	6646
EUR_231	10000	EUR	465	26319359	26525365	206006
EUR_231	10000	EUR	465	26575524	26580898	5374
EUR_231	10000	EUR	465	29306591	29347390	40799
EUR_231	10000	EUR	465	29347606	29396432	48826
EUR_231	10000	EUR	465	32694491	32759145	64654
EUR_231	10000	EUR	465	34136759	34138136	1377
EUR_231	10000	EUR	465	35887157	35892995	5838
EUR_231	10000	EUR	465	37776227	37890590	114363
EUR_231	10000	EUR	465	49714605	49741250	26645
EUR_231	10000	EUR	465	54221599	54407949	186350
EUR_231	10000	EUR	465	57136159	57136196	37
EUR_231	10000	EUR	465	58093392	58136140	42748
EUR_231	10000	EUR	465	59686990	59737678	50688
EUR_231	10000	EUR	465	73577181	73632251	55070
EUR_231	10000	EUR	465	75110846	75189189	78343
EUR_231	10000	EUR	465	83886982	83943271	56289
EUR_231	10000	EUR	465	88452177	88464514	12337
EUR_231	10000	EUR	465	88476761	88537179	60418
EUR_231	10000	EUR	465	88594833	88762816	167983
EUR_231	10000	EUR	465	91847626	91875197	27571
EUR_231	10000	EUR	465	92062604	92171686	109082
EUR_231	10000	EUR	465	93553045	93713967	160922
EUR_231	10000	EUR	465	94362487	94382190	19703
EUR_231	10000	EUR	465	94432170	94525176	93006
EUR_231	10000	EUR	465	95356313	95424095	67782
EUR_231	10000	EUR	465	95774147	95844558	70411
EUR_231	10000	EUR	465	96229638	96241778	12140
EUR_232	10000	EUR	466	2546510	2648737	102227
EUR_232	10000	EUR	466	16202082	16325554	123472
EUR_232	10000	EUR	466	22454245	22540410	86165
EUR_232	10000	EUR	466	22890136	23095439	205303
EUR_232	10000	EUR	466	23721919	23797839	75920
EUR_232	10000	EUR	466	24892444	24906091	13647
EUR_232	10000	EUR	466	25285126	25305885	20759
EUR_232	10000	EUR	466	25867195	25923415	56220
EUR_232	10000	EUR	466	26798389	26801347	2958
EUR_232	10000	EUR	466	29306591	29365834	59243
EUR_232	10000	EUR	466	31055149	31127610	72461
EUR_232	10000	EUR	466	32135867	32171621	35754
EUR_232	10000	EUR	466	32667412	32830147	162735
EUR_232	10000	EUR	466	40861764	41134712	272948
EUR_232	10000	EUR	466	43359651	43515922	156271
EUR_232	10000	EUR	466	49923584	50039522	115938
EUR_232	10000	EUR	466	54005322	54016981	11659
EUR_232	10000	EUR	466	54799832	54872046	72214
EUR_232	10000	EUR	466	57712252	57806900	94648
EUR_232	10000	EUR	466	59064557	59289101	224544
EUR_232	10000	EUR	466	59686990	59727601	40611
EUR_232	10000	EUR	466	63714218	63732455	18237
EUR_232	10000	EUR	466	68626746	68648432	21686
EUR_232	10000	EUR	466	69023918	69060887	36969
EUR_232	10000	EUR	466	72288615	72298050	9435
EUR_232	10000	EUR	466	72961212	73030087	68875
EUR_232	10000	EUR	466	77733985	77735979	1994
EUR_232	10000	EUR	466	88221167	88266237	45070
EUR_232	10000	EUR	466	89438427	89465942	27515
EUR_232	10000	EUR	466	91645289	91678723	33434
EUR_232	10000	EUR	466	92022074	92044148	22074
EUR_232	10000	EUR	466	93553045	93713967	160922
EUR_232	10000	EUR	466	93876597	93887313	10716
EUR_232	10000	EUR	466	93943380	94031719	88339
EUR_232	10000	EUR	466	96191244	96199691	8447
EUR_232	10000	EUR	467	3763591	3801794	38203
EUR_232	10000	EUR	467	11703759	11814111	110352
EUR_232	10000	EUR	467	16202082	16325554	123472
EUR_232	10000	EUR	467	22519633	22533171	13538
EUR_232	10000	EUR	467	22992959	23099324	106365
EUR_232	10000	EUR	467	23156936	23184805	27869
EUR_232	10000	EUR	467	23863969	23877108	13139
EUR_232	10000	EUR	467	24045382	24166883	121501
EUR_232	10000	EUR	467	24528522	24581630	53108
EUR_232	10000	EUR	467	25868315	25896396	28081
EUR_232	10000	EUR	467	26319359	26525365	206006
EUR_232	10000	EUR	467	26575524	26580898	5374
EUR_232	10000	EUR	467	29306591	29347390	40799
EUR_232	10000	EUR	467	29347606	29396432	48826
EUR_232	10000	EUR	467	32421761	32431881	10120
EUR_232	10000	EUR	467	32730583	32759145	28562
EUR_232	10000	EUR	467	35091612	35095643	4031
EUR_232	10000	EUR	467	40410992	40440150	29158
EUR_232	10000	EUR	467	40555384	40602505	47121
EUR_232	10000	EUR	467	40861764	40985765	124001
EUR_232	10000	EUR	467	42430229	42456760	26531
EUR_232	10000	EUR	467	42792406	42811364	18958
EUR_232	10000	EUR	467	43359651	43377135	17484
EUR_232	10000	EUR	467	43635671	43653793	18122
EUR_232	10000	EUR	467	57181563	57202471	20908
EUR_232	10000	EUR	467	59631177	59631623	446
EUR_232	10000	EUR	467	73588449	73602054	13605
EUR_232	10000	EUR	467	74889460	74894548	5088
EUR_232	10000	EUR	467	75263541	75282527	18986
EUR_232	10000	EUR	467	76365488	76399941	34453
EUR_232	10000	EUR	467	87369479	87389813	20334
EUR_232	10000	EUR	467	87504329	87507341	3012
EUR_232	10000	EUR	467	88224553	88317076	92523
EUR_232	10000	EUR	467	88448752	88464514	15762
EUR_232	10000	EUR	467	88476761	88537179	60418
EUR_232	10000	EUR	467	88761110	88877947	116837
EUR_232	10000	EUR	467	89189593	89235318	45725
EUR_232	10000	EUR	467	93130067	93146996	16929
EUR_232	10000	EUR	467	93877236	93921319	44083
EUR_232	10000	EUR	467	95774147	95880389	106242
EUR_233	10000	EUR	468	1853096	1854996	1900
EUR_233	10000	EUR	468	5018475	5041230	22755
EUR_233	10000	EUR	468	8348919	8386102	37183
EUR_233	10000	EUR	468	14051019	14086388	35369
EUR_233	10000	EUR	468	17918899	18041675	122776
EUR_233	10000	EUR	468	18310807	18368143	57336
EUR_233	10000	EUR	468	21224963	21225412	449
EUR_233	10000	EUR	468	22519633	22533171	13538
EUR_233	10000	EUR	468	23752602	23877108	124506
EUR_233	10000	EUR	468	24663977	24737906	73929
EUR_233	10000	EUR	468	25817587	25851359	33772
EUR_233	10000	EUR	468	26477051	26562248	85197
EUR_233	10000	EUR	468	26946861	26991485	44624
EUR_233	10000	EUR	468	29306591	29579668	273077
EUR_233	10000	EUR	468	34124908	34182116	57208
EUR_233	10000	EUR	468	43520906	43653793	132887
EUR_233	10000	EUR	468	53828533	54076786	248253
EUR_233	10000	EUR	468	56393850	56448072	54222
EUR_233	10000	EUR	468	57136159	57141457	5298
EUR_233	10000	EUR	468	57188385	57259820	71435
EUR_233	10000	EUR	468	64500471	64519080	18609
EUR_233	10000	EUR	468	68624378	68713281	88903
EUR_233	10000	EUR	468	72359726	72373817	14091
EUR_233	10000	EUR	468	74410856	74438736	27880
EUR_233	10000	EUR	468	75522893	75597255	74362
EUR_233	10000	EUR	468	75851931	75915063	63132
EUR_233	10000	EUR	468	77752299	77795912	43613
EUR_233	10000	EUR	468	81113251	81140731	27480
EUR_233	10000	EUR	468	86916801	86926886	10085
EUR_233	10000	EUR	468	88221167	88266237	45070
EUR_233	10000	EUR	468	89043274	89182292	139018
EUR_233	10000	EUR	468	89989980	89998439	8459
EUR_233	10000	EUR	468	91026914	91107582	80668
EUR_233	10000	EUR	468	93312291	93411339	99048
EUR_233	10000	EUR	468	93553045	93713967	160922
EUR_233	10000	EUR	468	94239181	94337048	97867
EUR_233	10000	EUR	468	94348955	94375754	26799
EUR_233	10000	EUR	468	95386240	95445533	59293
EUR_233	10000	EUR	468	96116814	96220219	103405
EUR_233	10000	EUR	469	2415974	2702115	286141
EUR_233	10000	EUR	469	3963309	4029447	66138
EUR_233	10000	EUR	469	9235548	9282969	47421
EUR_233	10000	EUR	469	9431845	9449917	18072
EUR_233	10000	EUR	469	13574314	13635433	61119
EUR_233	10000	EUR	469	13640984	13678187	37203
EUR_233	10000	EUR	469	14051019	14112508	61489
EUR_233	10000	EUR	469	16223994	16240882	16888
EUR_233	10000	EUR	469	16243211	16437214	194003
EUR_233	10000	EUR	469	17333821	17369300	35479
EUR_233	10000	EUR	469	17900500	17927386	26886
EUR_233	10000	EUR	469	24372241	24394548	22307
EUR_233	10000	EUR	469	25140534	25305885	165351
EUR_233	10000	EUR	469	25847649	25855304	7655
EUR_233	10000	EUR	469	26048379	26195455	147076
EUR_233	10000	EUR	469	27796339	27860977	64638
EUR_233	10000	EUR	469	29306591	29341169	34578
EUR_233	10000	EUR	469	31087987	31134684	46697
EUR_233	10000	EUR	469	32262916	32267787	4871
EUR_233	10000	EUR	469	32824940	32828620	3680
EUR_233	10000	EUR	469	32839913	32880042	40129
EUR_233	10000	EUR	469	35084593	35087281	2688
EUR_233	10000	EUR	469	39639062	39692065	53003
EUR_233	10000	EUR	469	39838138	39891202	53064
EUR_233	10000	EUR	469	40132875	40145306	12431
EUR_233	10000	EUR	469	40572310	40602505	30195
EUR_233	10000	EUR	469	40861764	41134712	272948
EUR_233	10000	EUR	469	57136159	57141457	5298
EUR_233	10000	EUR	469	57188385	57262845	74460
EUR_233	10000	EUR	469	59064557	59214930	150373
EUR_233	10000	EUR	469	69023918	69060887	36969
EUR_233	10000	EUR	469	73488506	73521539	33033
EUR_233	10000	EUR	469	74640712	74701524	60812
EUR_233	10000	EUR	469	76022322	76143984	121662
EUR_233	10000	EUR	469	78697685	78785374	87689
EUR_233	10000	EUR	469	79860282	79933512	73230
EUR_233	10000	EUR	469	80874989	80899585	24596
EUR_233	10000	EUR	469	81107841	81229503	121662
EUR_233	10000	EUR	469	85683081	85705213	22132
EUR_233	10000	EUR	469	88779868	88877947	98079
EUR_233	10000	EUR	469	89989980	89998439	8459
EUR_233	10000	EUR	469	90153261	90243516	90255
EUR_233	10000	EUR	469	91018779	91107582	88803
EUR_233	10000	EUR	469	93553045	93713967	160922
EUR_233	10000	EUR	469	94208817	94279511	70694
EUR_233	10000	EUR	469	96116814	96159845	43031
EUR_233	10000	EUR	469	96537974	96636521	98547
EUR_234	10000	EUR	470	340121	401572	61451
EUR_234	10000	EUR	470	9149188	9164904	15716
EUR_234	10000	EUR	470	9413335	9449917	36582
EUR_234	10000	EUR	470	14051019	14112508	61489
EUR_234	10000	EUR	470	17889447	17927386	37939
EUR_234	10000	EUR	470	18081536	18107085	25549
EUR_234	10000	EUR	470	21150173	21156082	5909
EUR_234	10000	EUR	470	21200799	21216283	15484
EUR_234	10000	EUR	470	23165262	23266699	101437
EUR_234	10000	EUR	470	24081639	24166883	85244
EUR_234	10000	EUR	470	25817587	25896396	78809
EUR_234	10000	EUR	470	29510693	29579668	68975
EUR_234	10000	EUR	470	31087987	31151086	63099
EUR_234	10000	EUR	470	32824940	32828620	3680
EUR_234	10000	EUR	470	32858056	32870350	12294
EUR_234	10000	EUR	470	36744092	36864514	120422
EUR_234	10000	EUR	470	37809118	37815963	6845
EUR_234	10000	EUR	470	39681230	39692065	10835
EUR_234	10000	EUR	470	43359651	43471816	112165
EUR_234	10000	EUR	470	49828382	49856342	27960
EUR_234	10000	EUR	470	49860683	49899094	38411
EUR_234	10000	EUR	470	53821620	53873347	51727
EUR_234	10000	EUR	470	57136159	57253147	116988
EUR_234	10000	EUR	470	57264407	57291065	26658
EUR_234	10000	EUR	470	59474219	59557929	83710
EUR_234	10000	EUR	470	63714218	63732455	18237
EUR_234	10000	EUR	470	77733985	77735979	1994
EUR_234	10000	EUR	470	79860282	79933512	73230
EUR_234	10000	EUR	470	83886982	83921060	34078
EUR_234	10000	EUR	470	87829130	87903841	74711
EUR_234	10000	EUR	470	88224553	88317076	92523
EUR_234	10000	EUR	470	88453841	88762816	308975
EUR_234	10000	EUR	470	90426720	90469639	42919
EUR_234	10000	EUR	470	91891040	91902611	11571
EUR_234	10000	EUR	470	94241722	94325814	84092
EUR_234	10000	EUR	470	94347548	94418018	70470
EUR_234	10000	EUR	470	94419260	94510654	91394
EUR_234	10000	EUR	471	1322727	1329694	6967
EUR_234	10000	EUR	471	2984450	2997995	13545
EUR_234	10000	EUR	471	8651970	8677654	25684
EUR_234	10000	EUR	471	13076756	13125585	48829
EUR_234	10000	EUR	471	16243211	16367500	124289
EUR_234	10000	EUR	471	17333821	17369300	35479
EUR_234	10000	EUR	471	17918899	18041675	122776
EUR_234	10000	EUR	471	21150173	21156082	5909
EUR_234	10000	EUR	471	21200799	21216283	15484
EUR_234	10000	EUR	471	22320042	22417821	97779
EUR_234	10000	EUR	471	22454245	22608307	154062
EUR_234	10000	EUR	471	22890136	23113974	223838
EUR_234	10000	EUR	471	23176150	23184805	8655
EUR_234	10000	EUR	471	23752602	23877108	124506
EUR_234	10000	EUR	471	24045382	24089668	44286
EUR_234	10000	EUR	471	24372241	24424495	52254
EUR_234	10000	EUR	471	24516931	24581630	64699
EUR_234	10000	EUR	471	25179048	25305885	126837
EUR_234	10000	EUR	471	26375604	26436121	60517
EUR_234	10000	EUR	471	30976914	31022341	45427
EUR_234	10000	EUR	471	40410992	40602505	191513
EUR_234	10000	EUR	471	42369514	42431902	62388
EUR_234	10000	EUR	471	43520906	43576329	55423
EUR_234	10000	EUR	471	71700744	71723801	23057
EUR_234	10000	EUR	471	76545803	76606551	60748
EUR_234	10000	EUR	471	76759679	76826035	66356
EUR_234	10000	EUR	471	79901658	79933512	31854
EUR_234	10000	EUR	471	80874989	81118702	243713
EUR_234	10000	EUR	471	84755692	84810053	54361
EUR_234	10000	EUR	471	87369479	87389813	20334
EUR_234	10000	EUR	471	87650695	87656802	6107
EUR_234	10000	EUR	471	88258345	88319207	60862
EUR_234	10000	EUR	471	88527647	88679238	151591
EUR_234	10000	EUR	471	88761110	88856646	95536
EUR_234	10000	EUR	471	89076084	89081743	5659
EUR_234	10000	EUR	471	91552179	91637603	85424
EUR_234	10000	EUR	471	91891040	91902611	11571
EUR_234	10000	EUR	471	92130544	92171686	41142
EUR_234	10000	EUR	471	93553045	93713967	160922
EUR_234	10000	EUR	471	94290726	94412962	122236
EUR_235	10000	EUR	472	4020191	4044195	24004
EUR_235	10000	EUR	472	9413335	9449917	36582
EUR_235	10000	EUR	472	11650811	11814111	163300
EUR_235	10000	EUR	472	13432461	13805391	372930
EUR_235	10000	EUR	472	17918899	18041675	122776
EUR_235	10000	EUR	472	22519633	22533171	13538
EUR_235	10000	EUR	472	24892444	24894460	2016
EUR_235	10000	EUR	472	26319359	26327062	7703
EUR_235	10000	EUR	472	26477051	26562248	85197
EUR_235	10000	EUR	472	34124908	34182116	57208
EUR_235	10000	EUR	472	35281602	35413025	131423
EUR_235	10000	EUR	472	35450233	35627884	177651
EUR_235	10000	EUR	472	54403505	54682031	278526
EUR_235	10000	EUR	472	59631177	59631623	446
EUR_235	10000	EUR	472	75587305	75641163	53858
EUR_235	10000	EUR	472	80520393	80530144	9751
EUR_235	10000	EUR	472	80941681	80985131	43450
EUR_235	10000	EUR	472	83955315	83957574	2259
EUR_235	10000	EUR	472	88087834	88146039	58205
EUR_235	10000	EUR	472	88221167	88300295	79128
EUR_235	10000	EUR	472	88324698	88371433	46735
EUR_235	10000	EUR	472	91060676	91107582	46906
EUR_235	10000	EUR	472	93657043	93713967	56924
EUR_235	10000	EUR	472	94290726	94412962	122236
EUR_235	10000	EUR	472	95069761	95112420	42659
EUR_235	10000	EUR	472	96116814	96161396	44582
EUR_235	10000	EUR	472	96631161	96667445	36284
EUR_235	10000	EUR	473	1330157	1385444	55287
EUR_235	10000	EUR	473	2984450	2997995	13545
EUR_235	10000	EUR	473	5253381	5312534	59153
EUR_235	10000	EUR	473	9413335	9449917	36582
EUR_235	10000	EUR	473	14107814	14108442	628
EUR_235	10000	EUR	473	21150173	21156082	5909
EUR_235	10000	EUR	473	21200799	21216283	15484
EUR_235	10000	EUR	473	22365602	22393602	28000
EUR_235	10000	EUR	473	23122511	23184805	62294
EUR_235	10000	EUR	473	24380643	24581630	200987
EUR_235	10000	EUR	473	24892444	24906091	13647
EUR_235	10000	EUR	473	25216205	25231618	15413
EUR_235	10000	EUR	473	25867195	25906960	39765
EUR_235	10000	EUR	473	26477051	26562248	85197
EUR_235	10000	EUR	473	26860657	26889089	28432
EUR_235	10000	EUR	473	29273800	29279379	5579
EUR_235	10000	EUR	473	31235544	31280214	44670
EUR_235	10000	EUR	473	32039879	32057645	17766
EUR_235	10000	EUR	473	32851725	32880042	28317
EUR_235	10000	EUR	473	33245767	33429152	183385
EUR_235	10000	EUR	473	34887214	34926785	39571
EUR_235	10000	EUR	473	35696522	35720956	24434
EUR_235	10000	EUR	473	53875418	53947462	72044
EUR_235	10000	EUR	473	54582582	54612977	30395
EUR_235	10000	EUR	473	59423469	59505572	82103
EUR_235	10000	EUR	473	64857298	64922329	65031
EUR_235	10000	EUR	473	69023918	69060887	36969
EUR_235	10000	EUR	473	72961212	72970689	9477
EUR_235	10000	EUR	473	75263541	75282527	18986
EUR_235	10000	EUR	473	81107841	81229503	121662
EUR_235	10000	EUR	473	83370620	83384810	14190
EUR_235	10000	EUR	473	87512858	87623148	110290
EUR_235	10000	EUR	473	87725818	87858554	132736
EUR_235	10000	EUR	473	89078906	89081743	2837
EUR_235	10000	EUR	473	89347941	89397613	49672
EUR_235	10000	EUR	473	90769120	90852419	83299
EUR_235	10000	EUR	473	91847626	91929323	81697
EUR_235	10000	EUR	473	93553045	93607994	54949
EUR_235	10000	EUR	473	94447447	94522438	74991
EUR_235	10000	EUR	473	94915497	94930362	14865
EUR_235	10000	EUR	473	96772814	96894209	121395
EUR_236	10000	EUR	474	1762556	1814476	51920
EUR_236	10000	EUR	474	2984450	2997995	13545
EUR_236	10000	EUR	474	8651970	8714283	62313
EUR_236	10000	EUR	474	16362032	16402432	40400
EUR_236	10000	EUR	474	18081536	18088512	6976
EUR_236	10000	EUR	474	18100331	18140078	39747
EUR_236	10000	EUR	474	21282367	21390474	108107
EUR_236	10000	EUR	474	23427310	23651476	224166
EUR_236	10000	EUR	474	23721919	23797839	75920
EUR_236	10000	EUR	474	24372241	24375016	2775
EUR_236	10000	EUR	474	24892444	24906091	13647
EUR_236	10000	EUR	474	25847649	25855304	7655
EUR_236	10000	EUR	474	29306591	29347390	40799
EUR_236	10000	EUR	474	29347606	29396432	48826
EUR_236	10000	EUR	474	32039879	32057645	17766
EUR_236	10000	EUR	474	32848174	32893781	45607
EUR_236	10000	EUR	474	40460363	40602505	142142
EUR_236	10000	EUR	474	41319133	41347409	28276
EUR_236	10000	EUR	474	43359651	43471816	112165
EUR_236	10000	EUR	474	50097264	50097389	125
EUR_236	10000	EUR	474	53875418	53927676	52258
EUR_236	10000	EUR	474	54005322	54016981	11659
EUR_236	10000	EUR	474	54632404	54794755	162351
EUR_236	10000	EUR	474	63714218	63732455	18237
EUR_236	10000	EUR	474	64372692	64406792	34100
EUR_236	10000	EUR	474	68626746	68648432	21686
EUR_236	10000	EUR	474	73498527	73536154	37627
EUR_236	10000	EUR	474	76022322	76093521	71199
EUR_236	10000	EUR	474	76780192	76855179	74987
EUR_236	10000	EUR	474	78697685	78785374	87689
EUR_236	10000	EUR	474	84235412	84245003	9591
EUR_236	10000	EUR	474	87760040	87858554	98514
EUR_236	10000	EUR	474	88825376	88915947	90571
EUR_236	10000	EUR	474	91891040	91902611	11571
EUR_236	10000	EUR	474	93800814	93869231	68417
EUR_236	10000	EUR	474	94350732	94375754	25022
EUR_236	10000	EUR	475	16202082	16217477	15395
EUR_236	10000	EUR	475	21150173	21156082	5909
EUR_236	10000	EUR	475	21200799	21216283	15484
EUR_236	10000	EUR	475	23721919	23797839	75920
EUR_236	10000	EUR	475	24045382	24166883	121501
EUR_236	10000	EUR	475	24621120	24737906	116786
EUR_236	10000	EUR	475	24809049	24866754	57705
EUR_236	10000	EUR	475	25868315	25885217	16902
EUR_236	10000	EUR	475	27746608	27786428	39820
EUR_236	10000	EUR	475	29306780	29311528	4748
EUR_236	10000	EUR	475	31440500	31468997	28497
EUR_236	10000	EUR	475	31477650	31602170	124520
EUR_236	10000	EUR	475	32667412	32714597	47185
EUR_236	10000	EUR	475	35887157	35892995	5838
EUR_236	10000	EUR	475	36350791	36376380	25589
EUR_236	10000	EUR	475	36663539	36678544	15005
EUR_236	10000	EUR	475	49923584	50039522	115938
EUR_236	10000	EUR	475	54302008	54362674	60666
EUR_236	10000	EUR	475	57289191	57291065	1874
EUR_236	10000	EUR	475	69023918	69060887	36969
EUR_236	10000	EUR	475	76137655	76143984	6329
EUR_236	10000	EUR	475	79901897	79936163	34266
EUR_236	10000	EUR	475	80161288	80278256	116968
EUR_236	10000	EUR	475	80852609	80881534	28925
EUR_236	10000	EUR	475	83886982	83921060	34078
EUR_236	10000	EUR	475	87107547	87120548	13001
EUR_236	10000	EUR	475	87175208	87389813	214605
EUR_236	10000	EUR	475	87888369	87888944	575
EUR_236	10000	EUR	475	88211398	88319207	107809
EUR_236	10000	EUR	475	88594414	88600577	6163
EUR_236	10000	EUR	475	88985240	89081743	96503
EUR_236	10000	EUR	475	89180086	89230378	50292
EUR_236	10000	EUR	475	93553045	93713967	160922
EUR_236	10000	EUR	475	94290726	94412962	122236
EUR_236	10000	EUR	475	95774147	95814824	40677
EUR_236	10000	EUR	475	96136238	96175807	39569
EUR_237	10000	EUR	476	1322727	1329694	6967
EUR_237	10000	EUR	476	1762556	1830270	67714
EUR_237	10000	EUR	476	2942516	3053070	110554
EUR_237	10000	EUR	476	8348919	8386102	37183
EUR_237	10000	EUR	476	11703759	11708397	4638
EUR_237	10000	EUR	476	14107814	14108442	628
EUR_237	10000	EUR	476	17687142	17689297	2155
EUR_237	10000	EUR	476	21093849	21174648	80799
EUR_237	10000	EUR	476	23165262	23265050	99788
EUR_237	10000	EUR	476	26319359	26331325	11966
EUR_237	10000	EUR	476	26886230	26972181	85951
EUR_237	10000	EUR	476	28645700	28663032	17332
EUR_237	10000	EUR	476	33126706	33180725	54019
EUR_237	10000	EUR	476	35328645	35413680	85035
EUR_237	10000	EUR	476	38065368	38097333	31965
EUR_237	10000	EUR	476	40142894	40145306	2412
EUR_237	10000	EUR	476	40410992	40498219	87227
EUR_237	10000	EUR	476	40861764	40975939	114175
EUR_237	10000	EUR	476	41336542	41360462	23920
EUR_237	10000	EUR	476	42430229	42468277	38048
EUR_237	10000	EUR	476	57181563	57202471	20908
EUR_237	10000	EUR	476	59631177	59631623	446
EUR_237	10000	EUR	476	68624378	68713281	88903
EUR_237	10000	EUR	476	71722082	71732410	10328
EUR_237	10000	EUR	476	74410856	74438736	27880
EUR_237	10000	EUR	476	75587305	75641163	53858
EUR_237	10000	EUR	476	80999290	81087964	88674
EUR_237	10000	EUR	476	84755692	84760554	4862
EUR_237	10000	EUR	476	88077880	88113143	35263
EUR_237	10000	EUR	476	88761110	89038093	276983
EUR_237	10000	EUR	476	89229001	89235318	6317
EUR_237	10000	EUR	476	89989980	89998439	8459
EUR_237	10000	EUR	476	90426720	90486618	59898
EUR_237	10000	EUR	476	92065436	92171686	106250
EUR_237	10000	EUR	476	93123848	93146996	23148
EUR_237	10000	EUR	476	94515346	94522438	7092
EUR_237	10000	EUR	476	96379020	96546756	167736
EUR_237	10000	EUR	476	96665448	96921990	256542
EUR_237	10000	EUR	477	2454787	2510498	55711
EUR_237	10000	EUR	477	2847136	2963147	116011
EUR_237	10000	EUR	477	16243211	16293593	50382
EUR_237	10000	EUR	477	17896991	17902017	5026
EUR_237	10000	EUR	477	18271487	18296696	25209
EUR_237	10000	EUR	477	23771474	23781644	10170
EUR_237	10000	EUR	477	25323974	25378298	54324
EUR_237	10000	EUR	477	26319359	26327062	7703
EUR_237	10000	EUR	477	26477051	26562248	85197
EUR_237	10000	EUR	477	32694491	32701120	6629
EUR_237	10000	EUR	477	32824940	32871485	46545
EUR_237	10000	EUR	477	33167789	33180948	13159
EUR_237	10000	EUR	477	35578593	35634901	56308
EUR_237	10000	EUR	477	36454307	36460007	5700
EUR_237	10000	EUR	477	37997041	38008166	11125
EUR_237	10000	EUR	477	39858032	40001122	143090
EUR_237	10000	EUR	477	40410992	40440150	29158
EUR_237	10000	EUR	477	40555384	40602505	47121
EUR_237	10000	EUR	477	54611074	54612977	1903
EUR_237	10000	EUR	477	56378802	56448072	69270
EUR_237	10000	EUR	477	59423469	59522281	98812
EUR_237	10000	EUR	477	68626746	68648432	21686
EUR_237	10000	EUR	477	69023918	69060887	36969
EUR_237	10000	EUR	477	72961212	73040018	78806
EUR_237	10000	EUR	477	73488506	73491846	3340
EUR_237	10000	EUR	477	73498527	73660589	162062
EUR_237	10000	EUR	477	74032464	74067213	34749
EUR_237	10000	EUR	477	75110846	75189189	78343
EUR_237	10000	EUR	477	76502715	76594146	91431
EUR_237	10000	EUR	477	80135541	80139395	3854
EUR_237	10000	EUR	477	80852609	80890918	38309
EUR_237	10000	EUR	477	85353810	85405856	52046
EUR_237	10000	EUR	477	88761110	88877947	116837
EUR_237	10000	EUR	477	91049817	91107582	57765
EUR_237	10000	EUR	477	91891040	91902611	11571
EUR_237	10000	EUR	477	94208817	94279511	70694
EUR_238	10000	EUR	478	2570528	2648737	78209
EUR_238	10000	EUR	478	3794084	3864030	69946
EUR_238	10000	EUR	478	4020191	4044195	24004
EUR_238	10000	EUR	478	16646358	16681323	34965
EUR_238	10000	EUR	478	23165262	23266699	101437
EUR_238	10000	EUR	478	25323974	25378298	54324
EUR_238	10000	EUR	478	25950286	25987107	36821
EUR_238	10000	EUR	478	26048379	26195455	147076
EUR_238	10000	EUR	478	27746608	27883567	136959
EUR_238	10000	EUR	478	31440500	31636518	196018
EUR_238	10000	EUR	478	32848174	32893781	45607
EUR_238	10000	EUR	478	35486962	35693478	206516
EUR_238	10000	EUR	478	35887157	35892995	5838
EUR_238	10000	EUR	478	37748178	37895954	147776
EUR_238	10000	EUR	478	39639062	39696725	57663
EUR_238	10000	EUR	478	40410992	40508892	97900
EUR_238	10000	EUR	478	49773026	49777492	4466
EUR_238	10000	EUR	478	53875418	53947462	72044
EUR_238	10000	EUR	478	54503155	54753618	250463
EUR_238	10000	EUR	478	56447306	56448072	766
EUR_238	10000	EUR	478	58988044	59122460	134416
EUR_238	10000	EUR	478	69023918	69060887	36969
EUR_238	10000	EUR	478	74871541	74894548	23007
EUR_238	10000	EUR	478	75851931	75915063	63132
EUR_238	10000	EUR	478	79862860	79933512	70652
EUR_238	10000	EUR	478	87580327	87631398	51071
EUR_238	10000	EUR	478	88796237	88830687	34450
EUR_238	10000	EUR	478	88896065	88927095	31030
EUR_238	10000	EUR	478	89356470	89389110	32640
EUR_238	10000	EUR	478	90769120	90852419	83299
EUR_238	10000	EUR	478	93553045	93655077	102032
EUR_238	10000	EUR	478	94595895	94701010	105115
EUR_238	10000	EUR	478	96116814	96220219	103405
EUR_238	10000	EUR	479	3963309	4029447	66138
EUR_238	10000	EUR	479	13076756	13099450	22694
EUR_238	10000	EUR	479	16243211	16363352	120141
EUR_238	10000	EUR	479	22447027	22462305	15278
EUR_238	10000	EUR	479	23752602	23856810	104208
EUR_238	10000	EUR	479	24081639	24166883	85244
EUR_238	10000	EUR	479	24734599	24737906	3307
EUR_238	10000	EUR	479	26477051	26507298	30247
EUR_238	10000	EUR	479	29306591	29339651	33060
EUR_238	10000	EUR	479	29357693	29365834	8141
EUR_238	10000	EUR	479	30976914	31005739	28825
EUR_238	10000	EUR	479	36056184	36089268	33084
EUR_238	10000	EUR	479	36663539	36678544	15005
EUR_238	10000	EUR	479	40410992	40508892	97900
EUR_238	10000	EUR	479	41319133	41360462	41329
EUR_238	10000	EUR	479	42542529	42550782	8253
EUR_238	10000	EUR	479	49923584	50039522	115938
EUR_238	10000	EUR	479	53821064	53842770	21706
EUR_238	10000	EUR	479	54570690	54612977	42287
EUR_238	10000	EUR	479	54659849	54667387	7538
EUR_238	10000	EUR	479	57136159	57141457	5298
EUR_238	10000	EUR	479	57188385	57262845	74460
EUR_238	10000	EUR	479	59064557	59289101	224544
EUR_238	10000	EUR	479	59686990	59727601	40611
EUR_238	10000	EUR	479	64321831	64519080	197249
EUR_238	10000	EUR	479	73498527	73660589	162062
EUR_238	10000	EUR	479	76022322	76143984	121662
EUR_238	10000	EUR	479	76456850	76594146	137296
EUR_238	10000	EUR	479	78816419	78881412	64993
EUR_238	10000	EUR	479	80999290	81087964	88674
EUR_238	10000	EUR	479	88077880	88113143	35263
EUR_238	10000	EUR	479	88439163	88762816	323653
EUR_238	10000	EUR	479	94413363	94418018	4655
EUR_238	10000	EUR	479	94419260	94515224	95964
EUR_238	10000	EUR	479	95418231	95445533	27302
EUR_238	10000	EUR	479	95831568	95927099	95531
EUR_238	10000	EUR	479	96136238	96175807	39569
EUR_238	10000	EUR	479	96264202	96304320	40118
EUR_238	10000	EUR	479	96478106	96546756	68650
EUR_239	10000	EUR	480	2415974	2612037	196063
EUR_239	10000	EUR	480	2996253	2997995	1742
EUR_239	10000	EUR	480	3963309	4130169	166860
EUR_239	10000	EUR	480	5020424	5034623	14199
EUR_239	10000	EUR	480	7572302	7608821	36519
EUR_239	10000	EUR	480	8348919	8386102	37183
EUR_239	10000	EUR	480	25867195	25904509	37314
EUR_239	10000	EUR	480	27894016	27894364	348
EUR_239	10000	EUR	480	31087987	31151086	63099
EUR_239	10000	EUR	480	32855612	32870350	14738
EUR_239	10000	EUR	480	33245767	33429152	183385
EUR_239	10000	EUR	480	33456444	33479750	23306
EUR_239	10000	EUR	480	35084593	35087281	2688
EUR_239	10000	EUR	480	37722669	37749485	26816
EUR_239	10000	EUR	480	37809118	37815963	6845
EUR_239	10000	EUR	480	40083840	40094721	10881
EUR_239	10000	EUR	480	53821064	53859932	38868
EUR_239	10000	EUR	480	53966468	54020486	54018
EUR_239	10000	EUR	480	56442176	56448072	5896
EUR_239	10000	EUR	480	57136159	57141457	5298
EUR_239	10000	EUR	480	57188385	57259820	71435
EUR_239	10000	EUR	480	57712252	57806900	94648
EUR_239	10000	EUR	480	59143487	59214930	71443
EUR_239	10000	EUR	480	69023918	69052189	28271
EUR_239	10000	EUR	480	71670386	71678663	8277
EUR_239	10000	EUR	480	74631633	74699907	68274
EUR_239	10000	EUR	480	76022322	76048092	25770
EUR_239	10000	EUR	480	76456850	76594146	137296
EUR_239	10000	EUR	480	80999290	81087964	88674
EUR_239	10000	EUR	480	83370620	83384810	14190
EUR_239	10000	EUR	480	88211398	88319207	107809
EUR_239	10000	EUR	480	88761110	88877947	116837
EUR_239	10000	EUR	480	89463400	89508341	44941
EUR_239	10000	EUR	480	91011409	91097487	86078
EUR_239	10000	EUR	480	91622054	91644321	22267
EUR_239	10000	EUR	480	93680632	93680672	40
EUR_239	10000	EUR	480	94239181	94337048	97867
EUR_239	10000	EUR	480	94348955	94375754	26799
EUR_239	10000	EUR	480	94793518	95011492	217974
EUR_239	10000	EUR	481	2546510	2648737	102227
EUR_239	10000	EUR	481	16243211	16293593	50382
EUR_239	10000	EUR	481	23551311	23651476	100165
EUR_239	10000	EUR	481	23721919	23797839	75920
EUR_239	10000	EUR	481	24892444	24906091	13647
EUR_239	10000	EUR	481	29273800	29300000	26200
EUR_239	10000	EUR	481	37754246	37771813	17567
EUR_239	10000	EUR	481	37972445	38097333	124888
EUR_239	10000	EUR	481	43359651	43377986	18335
EUR_239	10000	EUR	481	54411291	54904011	492720
EUR_239	10000	EUR	481	59553546	59700527	146981
EUR_239	10000	EUR	481	73498527	73660589	162062
EUR_239	10000	EUR	481	79082049	79134588	52539
EUR_239	10000	EUR	481	83933477	83957574	24097
EUR_239	10000	EUR	481	87969149	87994899	25750
EUR_239	10000	EUR	481	88077880	88319207	241327
EUR_239	10000	EUR	481	88796237	88959807	163570
EUR_239	10000	EUR	481	89180086	89228099	48013
EUR_239	10000	EUR	481	89989980	89998439	8459
EUR_239	10000	EUR	481	91060676	91107582	46906
EUR_239	10000	EUR	481	93172929	93217584	44655
EUR_239	10000	EUR	481	93800814	93948818	148004
EUR_239	10000	EUR	481	94793518	94871839	78321
EUR_239	10000	EUR	481	96557343	96946117	388774
EUR_240	10000	EUR	482	340121	401572	61451
EUR_240	10000	EUR	482	5018475	5041230	22755
EUR_240	10000	EUR	482	13574314	13635433	61119
EUR_240	10000	EUR	482	13640984	13678187	37203
EUR_240	10000	EUR	482	16582116	16622814	40698
EUR_240	10000	EUR	482	16670198	16681323	11125
EUR_240	10000	EUR	482	21150173	21156082	5909
EUR_240	10000	EUR	482	21224963	21225412	449
EUR_240	10000	EUR	482	23648833	23651476	2643
EUR_240	10000	EUR	482	25066876	25088413	21537
EUR_240	10000	EUR	482	25189085	25231618	42533
EUR_240	10000	EUR	482	26473666	26491352	17686
EUR_240	10000	EUR	482	29357693	29365834	8141
EUR_240	10000	EUR	482	33410702	33429152	18450
EUR_240	10000	EUR	482	35691557	35693478	1921
EUR_240	10000	EUR	482	36284487	36316786	32299
EUR_240	10000	EUR	482	37722669	37749485	26816
EUR_240	10000	EUR	482	37809118	37815963	6845
EUR_240	10000	EUR	482	40410992	40495016	84024
EUR_240	10000	EUR	482	40861764	40985765	124001
EUR_240	10000	EUR	482	43520906	43624720	103814
EUR_240	10000	EUR	482	50097264	50097389	125
EUR_240	10000	EUR	482	58580135	58694180	114045
EUR_240	10000	EUR	482	59464397	59522281	57884
EUR_240	10000	EUR	482	69023918	69060887	36969
EUR_240	10000	EUR	482	72160732	72205102	44370
EUR_240	10000	EUR	482	75522893	75632489	109596
EUR_240	10000	EUR	482	78846360	78865177	18817
EUR_240	10000	EUR	482	79901897	79936163	34266
EUR_240	10000	EUR	482	80999290	81087964	88674
EUR_240	10000	EUR	482	87369479	87389813	20334
EUR_240	10000	EUR	482	88307099	88333763	26664
EUR_240	10000	EUR	482	88405406	88464514	59108
EUR_240	10000	EUR	482	88476761	88537179	60418
EUR_240	10000	EUR	482	88908199	88915947	7748
EUR_240	10000	EUR	482	89189593	89235318	45725
EUR_240	10000	EUR	482	93680632	93680672	40
EUR_240	10000	EUR	482	94872197	95011492	139295
EUR_240	10000	EUR	482	95774147	95844558	70411
EUR_240	10000	EUR	483	1945682	1959936	14254
EUR_240	10000	EUR	483	2984450	2997995	13545
EUR_240	10000	EUR	483	5018475	5041230	22755
EUR_240	10000	EUR	483	8708501	8714283	5782
EUR_240	10000	EUR	483	9149188	9164904	15716
EUR_240	10000	EUR	483	11703759	11708397	4638
EUR_240	10000	EUR	483	16397154	16454511	57357
EUR_240	10000	EUR	483	17749730	17804155	54425
EUR_240	10000	EUR	483	18127775	18140078	12303
EUR_240	10000	EUR	483	18622886	18751123	128237
EUR_240	10000	EUR	483	21224963	21225412	449
EUR_240	10000	EUR	483	24081636	24094707	13071
EUR_240	10000	EUR	483	24380643	24581630	200987
EUR_240	10000	EUR	483	24892444	24906091	13647
EUR_240	10000	EUR	483	25343770	25501390	157620
EUR_240	10000	EUR	483	29306591	29365834	59243
EUR_240	10000	EUR	483	32834929	32870350	35421
EUR_240	10000	EUR	483	34887214	34926785	39571
EUR_240	10000	EUR	483	37809118	37815963	6845
EUR_240	10000	EUR	483	37989082	38097333	108251
EUR_240	10000	EUR	483	40410992	40424856	13864
EUR_240	10000	EUR	483	42493150	42574352	81202
EUR_240	10000	EUR	483	43359651	43471816	112165
EUR_240	10000	EUR	483	54659849	54667387	7538
EUR_240	10000	EUR	483	64338347	64458245	119898
EUR_240	10000	EUR	483	72388504	72398733	10229
EUR_240	10000	EUR	483	74650608	74699907	49299
EUR_240	10000	EUR	483	79901897	79903521	1624
EUR_240	10000	EUR	483	81059267	81079629	20362
EUR_240	10000	EUR	483	81107841	81123128	15287
EUR_240	10000	EUR	483	86916801	86926886	10085
EUR_240	10000	EUR	483	87512858	87546866	34008
EUR_240	10000	EUR	483	89989980	89998439	8459
EUR_240	10000	EUR	483	90153261	90211457	58196
EUR_240	10000	EUR	483	90699420	90939817	240397
EUR_240	10000	EUR	483	95418231	95445533	27302
EUR_240	10000	EUR	483	95831568	95927099	95531
EUR_240	10000	EUR	483	99266108	99279146	13038
EUR_241	10000	EUR	484	8348919	8386102	37183
EUR_241	10000	EUR	484	18622886	18655585	32699
EUR_241	10000	EUR	484	20981647	20982609	962
EUR_241	10000	EUR	484	22279659	22313169	33510
EUR_241	10000	EUR	484	24892444	24906091	13647
EUR_241	10000	EUR	484	26319359	26331325	11966
EUR_241	10000	EUR	484	32855612	32870350	14738
EUR_241	10000	EUR	484	35771774	35849669	77895
EUR_241	10000	EUR	484	40410992	40495016	84024
EUR_241	10000	EUR	484	40861764	40889660	27896
EUR_241	10000	EUR	484	43520906	43624720	103814
EUR_241	10000	EUR	484	52224085	52356806	132721
EUR_241	10000	EUR	484	56467720	56480618	12898
EUR_241	10000	EUR	484	73577181	73632251	55070
EUR_241	10000	EUR	484	74640712	74701524	60812
EUR_241	10000	EUR	484	76022322	76093521	71199
EUR_241	10000	EUR	484	77733985	77735979	1994
EUR_241	10000	EUR	484	79901658	79933512	31854
EUR_241	10000	EUR	484	81031954	81036282	4328
EUR_241	10000	EUR	484	84863773	84919115	55342
EUR_241	10000	EUR	484	88810221	88899568	89347
EUR_241	10000	EUR	484	91847626	91875197	27571
EUR_241	10000	EUR	484	92062604	92171686	109082
EUR_241	10000	EUR	484	93172929	93217584	44655
EUR_241	10000	EUR	484	93553045	93713967	160922
EUR_241	10000	EUR	484	94239181	94242718	3537
EUR_241	10000	EUR	484	95829965	95887608	57643
EUR_241	10000	EUR	484	96191244	96199691	8447
EUR_241	10000	EUR	485	8783056	8799713	16657
EUR_241	10000	EUR	485	9428449	9449917	21468
EUR_241	10000	EUR	485	16234928	16286721	51793
EUR_241	10000	EUR	485	18081536	18107085	25549
EUR_241	10000	EUR	485	18125473	18140078	14605
EUR_241	10000	EUR	485	20981647	21202559	220912
EUR_241	10000	EUR	485	24076703	24094707	18004
EUR_241	10000	EUR	485	24485266	24581630	96364
EUR_241	10000	EUR	485	25817896	25839696	21800
EUR_241	10000	EUR	485	26048379	26195455	147076
EUR_241	10000	EUR	485	30804231	31151086	346855
EUR_241	10000	EUR	485	32855612	32870350	14738
EUR_241	10000	EUR	485	35091612	35095643	4031
EUR_241	10000	EUR	485	35887157	35892995	5838
EUR_241	10000	EUR	485	36350791	36460007	109216
EUR_241	10000	EUR	485	40083840	40089817	5977
EUR_241	10000	EUR	485	40861764	41087414	225650
EUR_241	10000	EUR	485	43359651	43414552	54901
EUR_241	10000	EUR	485	43556834	43624720	67886
EUR_241	10000	EUR	485	54210889	54362674	151785
EUR_241	10000	EUR	485	56378802	56448072	69270
EUR_241	10000	EUR	485	59744029	59762964	18935
EUR_241	10000	EUR	485	63714218	63732455	18237
EUR_241	10000	EUR	485	69023918	69060887	36969
EUR_241	10000	EUR	485	72160732	72205102	44370
EUR_241	10000	EUR	485	72388504	72398733	10229
EUR_241	10000	EUR	485	72961212	73040018	78806
EUR_241	10000	EUR	485	74712068	74738891	26823
EUR_241	10000	EUR	485	75263541	75282527	18986
EUR_241	10000	EUR	485	75522893	75632489	109596
EUR_241	10000	EUR	485	77865503	77881732	16229
EUR_241	10000	EUR	485	79086226	79134588	48362
EUR_241	10000	EUR	485	80258835	80278256	19421
EUR_241	10000	EUR	485	88126552	88319207	192655
EUR_241	10000	EUR	485	91847626	91852929	5303
EUR_241	10000	EUR	485	91891040	91902611	11571
EUR_241	10000	EUR	485	93943380	94056780	113400
EUR_241	10000	EUR	485	94297447	94437055	139608
EUR_241	10000	EUR	485	95878015	95887608	9593
EUR_241	10000	EUR	485	99230141	99279146	49005
EUR_242	10000	EUR	486	1762556	1775693	13137
EUR_242	10000	EUR	486	9414397	9449917	35520
EUR_242	10000	EUR	486	16243211	16397990	154779
EUR_242	10000	EUR	486	21195166	21282925	87759
EUR_242	10000	EUR	486	23427310	23651476	224166
EUR_242	10000	EUR	486	23721919	23797839	75920
EUR_242	10000	EUR	486	24456376	24581630	125254
EUR_242	10000	EUR	486	25325282	25351680	26398
EUR_242	10000	EUR	486	25867195	25987107	119912
EUR_242	10000	EUR	486	29306591	29396432	89841
EUR_242	10000	EUR	486	30872888	30886133	13245
EUR_242	10000	EUR	486	32824940	32828620	3680
EUR_242	10000	EUR	486	32858056	32870350	12294
EUR_242	10000	EUR	486	35691557	35693478	1921
EUR_242	10000	EUR	486	36350791	36460007	109216
EUR_242	10000	EUR	486	37809118	37815963	6845
EUR_242	10000	EUR	486	37989082	38011051	21969
EUR_242	10000	EUR	486	40919189	41024466	105277
EUR_242	10000	EUR	486	54611074	54612977	1903
EUR_242	10000	EUR	486	56378802	56448072	69270
EUR_242	10000	EUR	486	59474219	59631623	157404
EUR_242	10000	EUR	486	64496625	64519080	22455
EUR_242	10000	EUR	486	72256813	72314514	57701
EUR_242	10000	EUR	486	72393936	72408032	14096
EUR_242	10000	EUR	486	72961212	73172795	211583
EUR_242	10000	EUR	486	76022322	76143984	121662
EUR_242	10000	EUR	486	77751346	77795912	44566
EUR_242	10000	EUR	486	78846360	78865177	18817
EUR_242	10000	EUR	486	88211398	88319207	107809
EUR_242	10000	EUR	486	88761110	88877947	116837
EUR_242	10000	EUR	486	89463400	89508341	44941
EUR_242	10000	EUR	486	91011409	91097487	86078
EUR_242	10000	EUR	486	91847626	91929323	81697
EUR_242	10000	EUR	486	91987726	92020761	33035
EUR_242	10000	EUR	486	93553045	93655077	102032
EUR_242	10000	EUR	486	94362487	94382190	19703
EUR_242	10000	EUR	486	94432170	94525176	93006
EUR_242	10000	EUR	486	95356313	95424095	67782
EUR_242	10000	EUR	486	95774147	95844558	70411
EUR_242	10000	EUR	486	96229638	96241778	12140
EUR_242	10000	EUR	486	96418148	96423850	5702
EUR_242	10000	EUR	487	1945682	1964815	19133
EUR_242	10000	EUR	487	4020191	4044195	24004
EUR_242	10000	EUR	487	13772349	13805391	33042
EUR_242	10000	EUR	487	16202082	16248490	46408
EUR_242	10000	EUR	487	17749730	17804155	54425
EUR_242	10000	EUR	487	21150173	21156082	5909
EUR_242	10000	EUR	487	21200799	21216283	15484
EUR_242	10000	EUR	487	22462287	22608307	146020
EUR_242	10000	EUR	487	22890136	23113974	223838
EUR_242	10000	EUR	487	23176150	23184805	8655
EUR_242	10000	EUR	487	24892444	24906091	13647
EUR_242	10000	EUR	487	25356497	25501390	144893
EUR_242	10000	EUR	487	28111916	28139866	27950
EUR_242	10000	EUR	487	30956411	31040753	84342
EUR_242	10000	EUR	487	31528053	31593163	65110
EUR_242	10000	EUR	487	32767431	32880042	112611
EUR_242	10000	EUR	487	35771774	35892995	121221
EUR_242	10000	EUR	487	37727611	37779396	51785
EUR_242	10000	EUR	487	39683574	39692065	8491
EUR_242	10000	EUR	487	42164278	42208086	43808
EUR_242	10000	EUR	487	59423469	59498676	75207
EUR_242	10000	EUR	487	72359726	72373817	14091
EUR_242	10000	EUR	487	74889460	74894548	5088
EUR_242	10000	EUR	487	76022322	76143984	121662
EUR_242	10000	EUR	487	80135541	80139395	3854
EUR_242	10000	EUR	487	80852609	80854395	1786
EUR_242	10000	EUR	487	81031954	81036282	4328
EUR_242	10000	EUR	487	88452177	88464514	12337
EUR_242	10000	EUR	487	88476761	88537179	60418
EUR_242	10000	EUR	487	93680632	93680672	40
EUR_242	10000	EUR	487	94872197	95011492	139295
EUR_242	10000	EUR	487	95774147	95844558	70411
EUR_243	10000	EUR	488	2570528	2593626	23098
EUR_243	10000	EUR	488	5018475	5041230	22755
EUR_243	10000	EUR	488	13432461	13805391	372930
EUR_243	10000	EUR	488	16243211	16367500	124289
EUR_243	10000	EUR	488	18704683	18833631	128948
EUR_243	10000	EUR	488	22992959	23024189	31230
EUR_243	10000	EUR	488	24485266	24581630	96364
EUR_243	10000	EUR	488	25140534	25305885	165351
EUR_243	10000	EUR	488	25847649	25855304	7655
EUR_243	10000	EUR	488	31113073	31114919	1846
EUR_243	10000	EUR	488	31573220	31636518	63298
EUR_243	10000	EUR	488	37777055	37779396	2341
EUR_243	10000	EUR	488	38062578	38097333	34755
EUR_243	10000	EUR	488	40047500	40068128	20628
EUR_243	10000	EUR	488	51948707	52007205	58498
EUR_243	10000	EUR	488	54570690	54612977	42287
EUR_243	10000	EUR	488	54659849	54667387	7538
EUR_243	10000	EUR	488	57136159	57141457	5298
EUR_243	10000	EUR	488	57188385	57262845	74460
EUR_243	10000	EUR	488	59064557	59214930	150373
EUR_243	10000	EUR	488	73157660	73172795	15135
EUR_243	10000	EUR	488	73511182	73543209	32027
EUR_243	10000	EUR	488	73633815	73690740	56925
EUR_243	10000	EUR	488	73852581	73866492	13911
EUR_243	10000	EUR	488	75110846	75189189	78343
EUR_243	10000	EUR	488	77839858	77848347	8489
EUR_243	10000	EUR	488	84898186	84919115	20929
EUR_243	10000	EUR	488	85395604	85405856	10252
EUR_243	10000	EUR	488	88219640	88363592	143952
EUR_243	10000	EUR	488	89356470	89465942	109472
EUR_243	10000	EUR	488	91026914	91097487	70573
EUR_243	10000	EUR	488	91847626	91929323	81697
EUR_243	10000	EUR	488	91987726	92014623	26897
EUR_243	10000	EUR	488	93680632	93680672	40
EUR_243	10000	EUR	488	94290726	94412962	122236
EUR_243	10000	EUR	488	95774147	95844558	70411
EUR_243	10000	EUR	488	96116814	96220219	103405
EUR_243	10000	EUR	488	99273154	99280798	7644
EUR_243	10000	EUR	489	2615770	2640275	24505
EUR_243	10000	EUR	489	4020191	4044195	24004
EUR_243	10000	EUR	489	8651970	8714283	62313
EUR_243	10000	EUR	489	16234928	16286721	51793
EUR_243	10000	EUR	489	18310807	18352711	41904
EUR_243	10000	EUR	489	21093849	21390474	296625
EUR_243	10000	EUR	489	23648833	23651476	2643
EUR_243	10000	EUR	489	24045382	24166883	121501
EUR_243	10000	EUR	489	26849817	26889089	39272
EUR_243	10000	EUR	489	29306591	29365834	59243
EUR_243	10000	EUR	489	29394605	29478208	83603
EUR_243	10000	EUR	489	31235544	31314394	78850
EUR_243	10000	EUR	489	34845302	34926785	81483
EUR_243	10000	EUR	489	37722669	38097333	374664
EUR_243	10000	EUR	489	56447306	56448072	766
EUR_243	10000	EUR	489	57181563	57202526	20963
EUR_243	10000	EUR	489	59423469	59440361	16892
EUR_243	10000	EUR	489	59554189	59607931	53742
EUR_243	10000	EUR	489	64338347	64519080	180733
EUR_243	10000	EUR	489	73498527	73660589	162062
EUR_243	10000	EUR	489	76137655	76143984	6329
EUR_243	10000	EUR	489	77839858	77848347	8489
EUR_243	10000	EUR	489	78697685	78785374	87689
EUR_243	10000	EUR	489	83533777	83550130	16353
EUR_243	10000	EUR	489	83955315	83957574	2259
EUR_243	10000	EUR	489	87533821	87546866	13045
EUR_243	10000	EUR	489	88527647	88551173	23526
EUR_243	10000	EUR	489	88609381	88748679	139298
EUR_243	10000	EUR	489	88789226	88961976	172750
EUR_243	10000	EUR	489	91011409	91097487	86078
EUR_243	10000	EUR	489	96136238	96175807	39569
EUR_243	10000	EUR	489	96246565	96333512	86947
EUR_244	10000	EUR	490	13076756	13125585	48829
EUR_244	10000	EUR	490	16296297	16345906	49609
EUR_244	10000	EUR	490	21246127	21282925	36798
EUR_244	10000	EUR	490	22519633	22533171	13538
EUR_244	10000	EUR	490	24456376	24548282	91906
EUR_244	10000	EUR	490	26477051	26562248	85197
EUR_244	10000	EUR	490	27746608	27894364	147756
EUR_244	10000	EUR	490	28619504	28692721	73217
EUR_244	10000	EUR	490	29273800	29279379	5579
EUR_244	10000	EUR	490	34880550	34926785	46235
EUR_244	10000	EUR	490	40861764	41134712	272948
EUR_244	10000	EUR	490	43359651	43515922	156271
EUR_244	10000	EUR	490	49860683	49899094	38411
EUR_244	10000	EUR	490	53821064	54035252	214188
EUR_244	10000	EUR	490	59423469	59440361	16892
EUR_244	10000	EUR	490	59554189	59607931	53742
EUR_244	10000	EUR	490	68675332	68717300	41968
EUR_244	10000	EUR	490	73498527	73660589	162062
EUR_244	10000	EUR	490	76456850	76594146	137296
EUR_244	10000	EUR	490	77735282	77735979	697
EUR_244	10000	EUR	490	81135206	81229503	94297
EUR_244	10000	EUR	490	83370620	83384810	14190
EUR_244	10000	EUR	490	83955315	83957574	2259
EUR_244	10000	EUR	490	87504329	87507341	3012
EUR_244	10000	EUR	490	88219640	88319207	99567
EUR_244	10000	EUR	490	88527647	88679238	151591
EUR_244	10000	EUR	490	88761110	89038093	276983
EUR_244	10000	EUR	490	90058636	90243516	184880
EUR_244	10000	EUR	490	90769120	90852419	83299
EUR_244	10000	EUR	490	93553045	93655077	102032
EUR_244	10000	EUR	490	94297447	94418018	120571
EUR_244	10000	EUR	490	94419260	94544971	125711
EUR_244	10000	EUR	490	96201761	96337375	135614
EUR_244	10000	EUR	491	1229602	1329694	100092
EUR_244	10000	EUR	491	1924080	2022517	98437
EUR_244	10000	EUR	491	2546510	2643426	96916
EUR_244	10000	EUR	491	2813723	3048937	235214
EUR_244	10000	EUR	491	18536950	18538440	1490
EUR_244	10000	EUR	491	21150173	21156082	5909
EUR_244	10000	EUR	491	21200799	21216283	15484
EUR_244	10000	EUR	491	22320042	22417821	97779
EUR_244	10000	EUR	491	22454245	22608307	154062
EUR_244	10000	EUR	491	22890136	22976843	86707
EUR_244	10000	EUR	491	23773171	23797839	24668
EUR_244	10000	EUR	491	25066876	25088413	21537
EUR_244	10000	EUR	491	25189085	25231618	42533
EUR_244	10000	EUR	491	25867195	25906960	39765
EUR_244	10000	EUR	491	26886230	26972181	85951
EUR_244	10000	EUR	491	31573220	31636518	63298
EUR_244	10000	EUR	491	32767431	32880042	112611
EUR_244	10000	EUR	491	35437965	35584975	147010
EUR_244	10000	EUR	491	35696522	35892995	196473
EUR_244	10000	EUR	491	36050639	36089268	38629
EUR_244	10000	EUR	491	37899302	38097333	198031
EUR_244	10000	EUR	491	42430229	42456760	26531
EUR_244	10000	EUR	491	42792406	42823699	31293
EUR_244	10000	EUR	491	54113043	54177383	64340
EUR_244	10000	EUR	491	54300284	54362674	62390
EUR_244	10000	EUR	491	70541408	70544348	2940
EUR_244	10000	EUR	491	74055055	74094072	39017
EUR_244	10000	EUR	491	76022322	76143984	121662
EUR_244	10000	EUR	491	77751346	77795912	44566
EUR_244	10000	EUR	491	79901897	79936163	34266
EUR_244	10000	EUR	491	83955315	83957574	2259
EUR_244	10000	EUR	491	88525333	88542894	17561
EUR_244	10000	EUR	491	88761110	88805716	44606
EUR_244	10000	EUR	491	91026914	91107582	80668
EUR_244	10000	EUR	491	93123848	93146996	23148
EUR_244	10000	EUR	491	93680632	93680672	40
EUR_244	10000	EUR	491	94239181	94276840	37659
EUR_244	10000	EUR	491	94362487	94382190	19703
EUR_244	10000	EUR	491	96537974	96638901	100927
EUR_245	10000	EUR	492	9413335	9449917	36582
EUR_245	10000	EUR	492	13432461	13443783	11322
EUR_245	10000	EUR	492	16582116	16622814	40698
EUR_245	10000	EUR	492	16670198	16681323	11125
EUR_245	10000	EUR	492	17889447	17902017	12570
EUR_245	10000	EUR	492	21150173	21156082	5909
EUR_245	10000	EUR	492	21200799	21216283	15484
EUR_245	10000	EUR	492	22465042	22608307	143265
EUR_245	10000	EUR	492	22890136	23081784	191648
EUR_245	10000	EUR	492	23721919	23797839	75920
EUR_245	10000	EUR	492	24621120	24737906	116786
EUR_245	10000	EUR	492	24809049	24866754	57705
EUR_245	10000	EUR	492	25323974	25357719	33745
EUR_245	10000	EUR	492	25847649	25855304	7655
EUR_245	10000	EUR	492	30976914	31127610	150696
EUR_245	10000	EUR	492	32262916	32267787	4871
EUR_245	10000	EUR	492	32855612	32870350	14738
EUR_245	10000	EUR	492	35091612	35095643	4031
EUR_245	10000	EUR	492	35887157	35892995	5838
EUR_245	10000	EUR	492	36350791	36460007	109216
EUR_245	10000	EUR	492	37727611	37762850	35239
EUR_245	10000	EUR	492	40861764	41087414	225650
EUR_245	10000	EUR	492	53825129	54035252	210123
EUR_245	10000	EUR	492	54403505	54414436	10931
EUR_245	10000	EUR	492	54570690	54612977	42287
EUR_245	10000	EUR	492	57136159	57147487	11328
EUR_245	10000	EUR	492	59064557	59065543	986
EUR_245	10000	EUR	492	59474219	59631623	157404
EUR_245	10000	EUR	492	64496625	64519080	22455
EUR_245	10000	EUR	492	74581736	74738891	157155
EUR_245	10000	EUR	492	74889460	74894548	5088
EUR_245	10000	EUR	492	76365488	76370460	4972
EUR_245	10000	EUR	492	77733985	77735979	1994
EUR_245	10000	EUR	492	79901897	79936163	34266
EUR_245	10000	EUR	492	80863277	80899276	35999
EUR_245	10000	EUR	492	80946931	81032996	86065
EUR_245	10000	EUR	492	84755692	84810053	54361
EUR_245	10000	EUR	492	88761110	88877947	116837
EUR_245	10000	EUR	492	93172929	93217584	44655
EUR_245	10000	EUR	492	93680632	93680672	40
EUR_245	10000	EUR	492	94523809	94559172	35363
EUR_245	10000	EUR	493	1330157	1336755	6598
EUR_245	10000	EUR	493	1762556	1793930	31374
EUR_245	10000	EUR	493	1951091	1959936	8845
EUR_245	10000	EUR	493	2984450	2997995	13545
EUR_245	10000	EUR	493	4020191	4044195	24004
EUR_245	10000	EUR	493	8651970	8677654	25684
EUR_245	10000	EUR	493	11532006	11542173	10167
EUR_245	10000	EUR	493	13574314	13635433	61119
EUR_245	10000	EUR	493	13640984	13678187	37203
EUR_245	10000	EUR	493	14051019	14112508	61489
EUR_245	10000	EUR	493	16243211	16367500	124289
EUR_245	10000	EUR	493	18716646	18844474	127828
EUR_245	10000	EUR	493	23752602	23856810	104208
EUR_245	10000	EUR	493	24045382	24166883	121501
EUR_245	10000	EUR	493	24372241	24384508	12267
EUR_245	10000	EUR	493	24535579	24581630	46051
EUR_245	10000	EUR	493	25867195	25881047	13852
EUR_245	10000	EUR	493	26415865	26436121	20256
EUR_245	10000	EUR	493	26886230	26991485	105255
EUR_245	10000	EUR	493	29306591	29579668	273077
EUR_245	10000	EUR	493	30937577	31092945	155368
EUR_245	10000	EUR	493	32855612	32870350	14738
EUR_245	10000	EUR	493	34136759	34182116	45357
EUR_245	10000	EUR	493	39681230	39692065	10835
EUR_245	10000	EUR	493	43359651	43471816	112165
EUR_245	10000	EUR	493	49828382	49856342	27960
EUR_245	10000	EUR	493	49860683	49899094	38411
EUR_245	10000	EUR	493	53821620	53873347	51727
EUR_245	10000	EUR	493	57136159	57253147	116988
EUR_245	10000	EUR	493	57264407	57291065	26658
EUR_245	10000	EUR	493	59474219	59557929	83710
EUR_245	10000	EUR	493	63714218	63732455	18237
EUR_245	10000	EUR	493	68624378	68713281	88903
EUR_245	10000	EUR	493	76567582	76572244	4662
EUR_245	10000	EUR	493	78816419	78823786	7367
EUR_245	10000	EUR	493	81107841	81229503	121662
EUR_245	10000	EUR	493	84235412	84254246	18834
EUR_245	10000	EUR	493	85353810	85405856	52046
EUR_245	10000	EUR	493	87969149	87974244	5095
EUR_245	10000	EUR	493	88219640	88382260	162620
EUR_245	10000	EUR	493	88873292	89001971	128679
EUR_245	10000	EUR	493	89069223	89081743	12520
EUR_245	10000	EUR	493	89462950	89475532	12582
EUR_245	10000	EUR	493	92022074	92044148	22074
EUR_245	10000	EUR	493	94208817	94279511	70694
EUR_246	10000	EUR	494	1924080	2022517	98437
EUR_246	10000	EUR	494	3285306	3302065	16759
EUR_246	10000	EUR	494	9431845	9449917	18072
EUR_246	10000	EUR	494	12804205	12847009	42804
EUR_246	10000	EUR	494	16234928	16286721	51793
EUR_246	10000	EUR	494	18787414	18806641	19227
EUR_246	10000	EUR	494	21150173	21156082	5909
EUR_246	10000	EUR	494	21224963	21225412	449
EUR_246	10000	EUR	494	22365602	22393602	28000
EUR_246	10000	EUR	494	23176150	23184805	8655
EUR_246	10000	EUR	494	23432743	23471650	38907
EUR_246	10000	EUR	494	24140903	24163756	22853
EUR_246	10000	EUR	494	24749954	24757234	7280
EUR_246	10000	EUR	494	24892444	24906091	13647
EUR_246	10000	EUR	494	25867195	25906960	39765
EUR_246	10000	EUR	494	29306591	29396432	89841
EUR_246	10000	EUR	494	30904434	31040753	136319
EUR_246	10000	EUR	494	31235544	31314394	78850
EUR_246	10000	EUR	494	32262916	32267787	4871
EUR_246	10000	EUR	494	32667412	32696052	28640
EUR_246	10000	EUR	494	35091612	35095643	4031
EUR_246	10000	EUR	494	40410992	40602505	191513
EUR_246	10000	EUR	494	42369514	42431902	62388
EUR_246	10000	EUR	494	50186705	50246703	59998
EUR_246	10000	EUR	494	54302008	54362674	60666
EUR_246	10000	EUR	494	54718859	54904011	185152
EUR_246	10000	EUR	494	72961212	73172795	211583
EUR_246	10000	EUR	494	73498527	73564505	65978
EUR_246	10000	EUR	494	75110846	75189189	78343
EUR_246	10000	EUR	494	76137655	76143984	6329
EUR_246	10000	EUR	494	77880564	77881732	1168
EUR_246	10000	EUR	494	81113251	81229503	116252
EUR_246	10000	EUR	494	87969149	87974244	5095
EUR_246	10000	EUR	494	88219640	88382260	162620
EUR_246	10000	EUR	494	89404942	89508341	103399
EUR_246	10000	EUR	494	91847626	91929323	81697
EUR_246	10000	EUR	494	91987726	92020761	33035
EUR_246	10000	EUR	494	93943380	94056780	113400
EUR_246	10000	EUR	494	94205094	94222927	17833
EUR_246	10000	EUR	494	94447447	94522438	74991
EUR_246	10000	EUR	494	94915497	94930362	14865
EUR_246	10000	EUR	495	2415974	2536319	120345
EUR_246	10000	EUR	495	11703759	11708397	4638
EUR_246	10000	EUR	495	12764351	12845452	81101
EUR_246	10000	EUR	495	13621609	13626532	4923
EUR_246	10000	EUR	495	14053026	14108442	55416
EUR_246	10000	EUR	495	16397154	16454511	57357
EUR_246	10000	EUR	495	17889447	17927386	37939
EUR_246	10000	EUR	495	17969647	18029197	59550
EUR_246	10000	EUR	495	22519633	22533171	13538
EUR_246	10000	EUR	495	24045382	24155650	110268
EUR_246	10000	EUR	495	24892444	24906091	13647
EUR_246	10000	EUR	495	25867195	25930232	63037
EUR_246	10000	EUR	495	26477051	26562248	85197
EUR_246	10000	EUR	495	26798389	26801347	2958
EUR_246	10000	EUR	495	29291099	29291137	38
EUR_246	10000	EUR	495	29306591	29326680	20089
EUR_246	10000	EUR	495	31235544	31314394	78850
EUR_246	10000	EUR	495	32824940	32871485	46545
EUR_246	10000	EUR	495	38008857	38097333	88476
EUR_246	10000	EUR	495	50097264	50097389	125
EUR_246	10000	EUR	495	56442176	56448072	5896
EUR_246	10000	EUR	495	57136159	57141457	5298
EUR_246	10000	EUR	495	57188385	57259820	71435
EUR_246	10000	EUR	495	57712252	57806900	94648
EUR_246	10000	EUR	495	58569405	58694180	124775
EUR_246	10000	EUR	495	59474219	59631623	157404
EUR_246	10000	EUR	495	63714218	63766635	52417
EUR_246	10000	EUR	495	72288615	72398733	110118
EUR_246	10000	EUR	495	77733985	77735979	1994
EUR_246	10000	EUR	495	80863277	80899276	35999
EUR_246	10000	EUR	495	80946931	81032996	86065
EUR_246	10000	EUR	495	85683081	85705213	22132
EUR_246	10000	EUR	495	88779868	88877947	98079
EUR_246	10000	EUR	495	89989980	89998439	8459
EUR_246	10000	EUR	495	90153261	90243516	90255
EUR_246	10000	EUR	495	93837016	93869231	32215
EUR_246	10000	EUR	495	94905957	95011492	105535
EUR_246	10000	EUR	495	96772814	96894209	121395
EUR_247	10000	EUR	496	9413335	9449917	36582
EUR_247	10000	EUR	496	11480169	11492904	12735
EUR_247	10000	EUR	496	18081536	18107085	25549
EUR_247	10000	EUR	496	22365602	22393602	28000
EUR_247	10000	EUR	496	23122511	23154758	32247
EUR_247	10000	EUR	496	23559444	23651476	92032
EUR_247	10000	EUR	496	23721919	23797839	75920
EUR_247	10000	EUR	496	24456376	24581630	125254
EUR_247	10000	EUR	496	25343770	25501390	157620
EUR_247	10000	EUR	496	25978368	25987107	8739
EUR_247	10000	EUR	496	26403126	26429831	26705
EUR_247	10000	EUR	496	29347606	29396432	48826
EUR_247	10000	EUR	496	32731788	32870350	138562
EUR_247	10000	EUR	496	37885686	37890032	4346
EUR_247	10000	EUR	496	40132875	40145306	12431
EUR_247	10000	EUR	496	49714605	49899094	184489
EUR_247	10000	EUR	496	57181563	57291065	109502
EUR_247	10000	EUR	496	59464397	59522281	57884
EUR_247	10000	EUR	496	69023918	69060887	36969
EUR_247	10000	EUR	496	71722082	71764001	41919
EUR_247	10000	EUR	496	75522893	75632489	109596
EUR_247	10000	EUR	496	76139818	76143984	4166
EUR_247	10000	EUR	496	76365488	76397099	31611
EUR_247	10000	EUR	496	79082049	79134588	52539
EUR_247	10000	EUR	496	79901897	79936163	34266
EUR_247	10000	EUR	496	80161288	80278256	116968
EUR_247	10000	EUR	496	80874989	80917694	42705
EUR_247	10000	EUR	496	87760040	87858554	98514
EUR_247	10000	EUR	496	88789226	88961976	172750
EUR_247	10000	EUR	496	91025410	91107582	82172
EUR_247	10000	EUR	496	91552179	91688404	136225
EUR_247	10000	EUR	496	93553045	93655077	102032
EUR_247	10000	EUR	496	94280856	94317758	36902
EUR_247	10000	EUR	496	94793518	94930362	136844
EUR_247	10000	EUR	496	99239197	99280798	41601
EUR_247	10000	EUR	497	4020191	4044195	24004
EUR_247	10000	EUR	497	5018475	5041230	22755
EUR_247	10000	EUR	497	9414397	9449917	35520
EUR_247	10000	EUR	497	17333821	17369300	35479
EUR_247	10000	EUR	497	25285126	25293981	8855
EUR_247	10000	EUR	497	26377213	26429623	52410
EUR_247	10000	EUR	497	29291099	29311528	20429
EUR_247	10000	EUR	497	31087987	31151086	63099
EUR_247	10000	EUR	497	31431938	31446638	14700
EUR_247	10000	EUR	497	32731788	32870350	138562
EUR_247	10000	EUR	497	35521107	35677592	156485
EUR_247	10000	EUR	497	35881405	35892995	11590
EUR_247	10000	EUR	497	39639062	39696725	57663
EUR_247	10000	EUR	497	39838138	39891202	53064
EUR_247	10000	EUR	497	40132875	40145306	12431
EUR_247	10000	EUR	497	40410992	40601251	190259
EUR_247	10000	EUR	497	43359651	43471816	112165
EUR_247	10000	EUR	497	49923584	49953714	30130
EUR_247	10000	EUR	497	59686990	59737678	50688
EUR_247	10000	EUR	497	73039375	73160136	120761
EUR_247	10000	EUR	497	73488506	73493479	4973
EUR_247	10000	EUR	497	73633815	73702901	69086
EUR_247	10000	EUR	497	74019705	74094072	74367
EUR_247	10000	EUR	497	80852609	80890918	38309
EUR_247	10000	EUR	497	87695631	87888622	192991
EUR_247	10000	EUR	497	89037352	89047979	10627
EUR_247	10000	EUR	497	89229001	89235318	6317
EUR_247	10000	EUR	497	93553045	93713967	160922
EUR_247	10000	EUR	497	94239181	94242718	3537
EUR_247	10000	EUR	497	95829965	95887608	57643
EUR_248	10000	EUR	498	16202082	16205164	3082
EUR_248	10000	EUR	498	16322068	16402432	80364
EUR_248	10000	EUR	498	17889447	17902017	12570
EUR_248	10000	EUR	498	22918884	22931104	12220
EUR_248	10000	EUR	498	23721919	23797839	75920
EUR_248	10000	EUR	498	26469758	26525365	55607
EUR_248	10000	EUR	498	26575524	26580898	5374
EUR_248	10000	EUR	498	27746608	27919633	173025
EUR_248	10000	EUR	498	28111916	28139866	27950
EUR_248	10000	EUR	498	31087987	31131774	43787
EUR_248	10000	EUR	498	33245767	33429152	183385
EUR_248	10000	EUR	498	35299331	35413025	113694
EUR_248	10000	EUR	498	35450233	35569595	119362
EUR_248	10000	EUR	498	37727611	37762850	35239
EUR_248	10000	EUR	498	39639062	39692065	53003
EUR_248	10000	EUR	498	40410992	40495016	84024
EUR_248	10000	EUR	498	49714605	49899094	184489
EUR_248	10000	EUR	498	53821064	53887824	66760
EUR_248	10000	EUR	498	54711881	54714097	2216
EUR_248	10000	EUR	498	57204714	57291065	86351
EUR_248	10000	EUR	498	63714218	63732455	18237
EUR_248	10000	EUR	498	73136973	73172795	35822
EUR_248	10000	EUR	498	74871541	74894548	23007
EUR_248	10000	EUR	498	75121914	75189189	67275
EUR_248	10000	EUR	498	75851931	75915063	63132
EUR_248	10000	EUR	498	77751346	77795912	44566
EUR_248	10000	EUR	498	79901897	79903521	1624
EUR_248	10000	EUR	498	79921893	79936163	14270
EUR_248	10000	EUR	498	80454885	80489589	34704
EUR_248	10000	EUR	498	80863277	80868676	5399
EUR_248	10000	EUR	498	86508335	86539843	31508
EUR_248	10000	EUR	498	88077880	88319207	241327
EUR_248	10000	EUR	498	88527647	88679238	151591
EUR_248	10000	EUR	498	88761110	89050718	289608
EUR_248	10000	EUR	498	90195857	90275500	79643
EUR_248	10000	EUR	498	91891040	91902611	11571
EUR_248	10000	EUR	498	93312291	93411339	99048
EUR_248	10000	EUR	498	94241722	94325814	84092
EUR_248	10000	EUR	498	99165891	99231692	65801
EUR_248	10000	EUR	499	11703759	11708397	4638
EUR_248	10000	EUR	499	13076756	13134002	57246
EUR_248	10000	EUR	499	13432461	13780870	348409
EUR_248	10000	EUR	499	16243211	16397990	154779
EUR_248	10000	EUR	499	18100331	18140078	39747
EUR_248	10000	EUR	499	21224963	21225412	449
EUR_248	10000	EUR	499	23120612	23120638	26
EUR_248	10000	EUR	499	23427310	23651476	224166
EUR_248	10000	EUR	499	23721919	23752615	30696
EUR_248	10000	EUR	499	24045382	24166883	121501
EUR_248	10000	EUR	499	24892444	24906091	13647
EUR_248	10000	EUR	499	25343770	25501390	157620
EUR_248	10000	EUR	499	25978368	25987107	8739
EUR_248	10000	EUR	499	26403126	26429831	26705
EUR_248	10000	EUR	499	26886230	26991485	105255
EUR_248	10000	EUR	499	27894016	27894364	348
EUR_248	10000	EUR	499	29306591	29339651	33060
EUR_248	10000	EUR	499	29357693	29365834	8141
EUR_248	10000	EUR	499	31087987	31138800	50813
EUR_248	10000	EUR	499	31573220	31636518	63298
EUR_248	10000	EUR	499	32767431	32880042	112611
EUR_248	10000	EUR	499	35887157	35892995	5838
EUR_248	10000	EUR	499	36350791	36376380	25589
EUR_248	10000	EUR	499	36663539	36678544	15005
EUR_248	10000	EUR	499	43406693	43471816	65123
EUR_248	10000	EUR	499	54799832	54872046	72214
EUR_248	10000	EUR	499	59650996	59762964	111968
EUR_248	10000	EUR	499	64338347	64344522	6175
EUR_248	10000	EUR	499	69023918	69060887	36969
EUR_248	10000	EUR	499	72994673	73022663	27990
EUR_248	10000	EUR	499	77733985	77735979	1994
EUR_248	10000	EUR	499	79860282	79909102	48820
EUR_248	10000	EUR	499	81031954	81036282	4328
EUR_248	10000	EUR	499	87512858	87522237	9379
EUR_248	10000	EUR	499	88077880	88172209	94329
EUR_248	10000	EUR	499	88212981	88333763	120782
EUR_248	10000	EUR	499	88405406	88464514	59108
EUR_248	10000	EUR	499	88476761	88537179	60418
EUR_248	10000	EUR	499	88761110	88877947	116837
EUR_248	10000	EUR	499	93800814	93869231	68417
EUR_248	10000	EUR	499	94208817	94279511	70694
EUR_248	10000	EUR	499	96116814	96333512	216698
EUR_249	10000	EUR	500	8348919	8386102	37183
EUR_249	10000	EUR	500	16202082	16325554	123472
EUR_249	10000	EUR	500	25066876	25088413	21537
EUR_249	10000	EUR	500	25847649	25855304	7655
EUR_249	10000	EUR	500	29347606	29396432	48826
EUR_249	10000	EUR	500	32057270	32084128	26858
EUR_249	10000	EUR	500	32824940	32828620	3680
EUR_249	10000	EUR	500	32858056	32870350	12294
EUR_249	10000	EUR	500	35691557	35693478	1921
EUR_249	10000	EUR	500	37722669	37749485	26816
EUR_249	10000	EUR	500	37809118	37815963	6845
EUR_249	10000	EUR	500	40410992	40602505	191513
EUR_249	10000	EUR	500	41319133	41360462	41329
EUR_249	10000	EUR	500	43520906	43653793	132887
EUR_249	10000	EUR	500	53821064	53931126	110062
EUR_249	10000	EUR	500	54678447	54794755	116308
EUR_249	10000	EUR	500	80520393	80530144	9751
EUR_249	10000	EUR	500	87369479	87385434	15955
EUR_249	10000	EUR	500	87512858	87546866	34008
EUR_249	10000	EUR	500	88980156	89052072	71916
EUR_249	10000	EUR	500	90699420	90969654	270234
EUR_249	10000	EUR	500	93585543	93607994	22451
EUR_249	10000	EUR	500	94447447	94522438	74991
EUR_249	10000	EUR	500	94915497	94930362	14865
EUR_249	10000	EUR	501	2984450	2997995	13545
EUR_249	10000	EUR	501	8651970	8714283	62313
EUR_249	10000	EUR	501	16397154	16454511	57357
EUR_249	10000	EUR	501	21061270	21202559	141289
EUR_249	10000	EUR	501	23648833	23651476	2643
EUR_249	10000	EUR	501	24073606	24089668	16062
EUR_249	10000	EUR	501	24892444	24906091	13647
EUR_249	10000	EUR	501	34136759	34182116	45357
EUR_249	10000	EUR	501	35771774	35892995	121221
EUR_249	10000	EUR	501	37727611	37779396	51785
EUR_249	10000	EUR	501	38062578	38097333	34755
EUR_249	10000	EUR	501	42430229	42456760	26531
EUR_249	10000	EUR	501	42792406	42823699	31293
EUR_249	10000	EUR	501	54302008	54362674	60666
EUR_249	10000	EUR	501	58863206	58863428	222
EUR_249	10000	EUR	501	59631177	59631623	446
EUR_249	10000	EUR	501	73588449	73602054	13605
EUR_249	10000	EUR	501	75139724	75189189	49465
EUR_249	10000	EUR	501	77733985	77735979	1994
EUR_249	10000	EUR	501	80135541	80139395	3854
EUR_249	10000	EUR	501	81059267	81108910	49643
EUR_249	10000	EUR	501	83370620	83384810	14190
EUR_249	10000	EUR	501	83955315	83957574	2259
EUR_249	10000	EUR	501	84235412	84245003	9591
EUR_249	10000	EUR	501	87369479	87389813	20334
EUR_249	10000	EUR	501	87829130	87903841	74711
EUR_249	10000	EUR	501	88224553	88317076	92523
EUR_249	10000	EUR	501	88453841	88762816	308975
EUR_249	10000	EUR	501	89157386	89235318	77932
EUR_249	10000	EUR	501	89989980	89998439	8459
EUR_249	10000	EUR	501	91025410	91107582	82172
EUR_249	10000	EUR	501	91687464	91688404	940
EUR_249	10000	EUR	501	93685366	93713967	28601
EUR_249	10000	EUR	501	95774147	95784369	10222
EUR_249	10000	EUR	501	96116814	96127414	10600
EUR_249	10000	EUR	501	96478106	96546756	68650
EUR_250	10000	EUR	502	9413335	9449917	36582
EUR_250	10000	EUR	502	11480169	11492904	12735
EUR_250	10000	EUR	502	16397154	16454511	57357
EUR_250	10000	EUR	502	17918899	18041675	122776
EUR_250	10000	EUR	502	21149491	21223896	74405
EUR_250	10000	EUR	502	23176150	23184805	8655
EUR_250	10000	EUR	502	24045382	24155650	110268
EUR_250	10000	EUR	502	24734599	24737906	3307
EUR_250	10000	EUR	502	25867195	25987107	119912
EUR_250	10000	EUR	502	29317413	29396432	79019
EUR_250	10000	EUR	502	33245767	33429152	183385
EUR_250	10000	EUR	502	34136759	34182116	45357
EUR_250	10000	EUR	502	35887157	35892995	5838
EUR_250	10000	EUR	502	37899302	38097333	198031
EUR_250	10000	EUR	502	40410992	40424856	13864
EUR_250	10000	EUR	502	43359651	43515922	156271
EUR_250	10000	EUR	502	57136159	57147487	11328
EUR_250	10000	EUR	502	72177371	72205102	27731
EUR_250	10000	EUR	502	72388504	72398733	10229
EUR_250	10000	EUR	502	72961212	73040018	78806
EUR_250	10000	EUR	502	74640712	74701524	60812
EUR_250	10000	EUR	502	76022322	76093521	71199
EUR_250	10000	EUR	502	83370620	83384810	14190
EUR_250	10000	EUR	502	83955315	83957574	2259
EUR_250	10000	EUR	502	87504329	87507341	3012
EUR_250	10000	EUR	502	88262228	88319207	56979
EUR_250	10000	EUR	502	89011064	89081586	70522
EUR_250	10000	EUR	502	89989980	89998439	8459
EUR_250	10000	EUR	502	91847626	91875197	27571
EUR_250	10000	EUR	502	93470832	93547941	77109
EUR_250	10000	EUR	502	93553045	93685892	132847
EUR_250	10000	EUR	502	96116814	96333512	216698
EUR_250	10000	EUR	503	2454787	2510498	55711
EUR_250	10000	EUR	503	22519633	22521160	1527
EUR_250	10000	EUR	503	23721919	23797839	75920
EUR_250	10000	EUR	503	24580740	24581630	890
EUR_250	10000	EUR	503	25140534	25202362	61828
EUR_250	10000	EUR	503	26445132	26525365	80233
EUR_250	10000	EUR	503	26575524	26580898	5374
EUR_250	10000	EUR	503	27746608	27974945	228337
EUR_250	10000	EUR	503	29444267	29483168	38901
EUR_250	10000	EUR	503	30904434	31092945	188511
EUR_250	10000	EUR	503	32039879	32057645	17766
EUR_250	10000	EUR	503	32170839	32187563	16724
EUR_250	10000	EUR	503	32667412	32870350	202938
EUR_250	10000	EUR	503	35771774	35892995	121221
EUR_250	10000	EUR	503	41359664	41360462	798
EUR_250	10000	EUR	503	42369514	42431902	62388
EUR_250	10000	EUR	503	54210889	54362674	151785
EUR_250	10000	EUR	503	54765460	54904011	138551
EUR_250	10000	EUR	503	57136159	57141457	5298
EUR_250	10000	EUR	503	57188385	57259820	71435
EUR_250	10000	EUR	503	57712252	57806900	94648
EUR_250	10000	EUR	503	58569405	58694180	124775
EUR_250	10000	EUR	503	74055055	74094072	39017
EUR_250	10000	EUR	503	74581736	74738891	157155
EUR_250	10000	EUR	503	77733985	77735979	1994
EUR_250	10000	EUR	503	88221167	88300295	79128
EUR_250	10000	EUR	503	88324698	88412977	88279
EUR_250	10000	EUR	503	88908199	88915947	7748
EUR_250	10000	EUR	503	89189593	89235318	45725
EUR_250	10000	EUR	503	91891040	91902611	11571
EUR_250	10000	EUR	503	94348955	94363395	14440
EUR_250	10000	EUR	503	94793518	94950031	156513
EUR_250	10000	EUR	503	96539592	96546756	7164
EUR_250	10000	EUR	503	96800979	96942045	141066
EUR_251	0	EUR	704	1820511	1830270	9759
EUR_251	0	EUR	704	11778115	11795837	17722
EUR_251	0	EUR	704	14051019	14112508	61489
EUR_251	0	EUR	704	16323977	16397990	74013
EUR_251	0	EUR	704	17749730	17804155	54425
EUR_251	0	EUR	704	18676403	18751123	74720
EUR_251	0	EUR	704	21246127	21282925	36798
EUR_251	0	EUR	704	22365602	22393602	28000
EUR_251	0	EUR	704	23138000	23184805	46805
EUR_251	0	EUR	704	25867195	25904509	37314
EUR_251	0	EUR	704	29321833	29348593	26760
EUR_251	0	EUR	704	29569955	29579668	9713
EUR_251	0	EUR	704	32081977	32141896	59919
EUR_251	0	EUR	704	32667412	32830147	162735
EUR_251	0	EUR	704	33316683	33429152	112469
EUR_251	0	EUR	704	35771774	35849669	77895
EUR_251	0	EUR	704	38062578	38097333	34755
EUR_251	0	EUR	704	49714605	49719684	5079
EUR_251	0	EUR	704	49888473	49899094	10621
EUR_251	0	EUR	704	53821064	54020486	199422
EUR_251	0	EUR	704	54403505	54431022	27517
EUR_251	0	EUR	704	57857678	57861351	3673
EUR_251	0	EUR	704	59744029	59762964	18935
EUR_251	0	EUR	704	69023918	69052189	28271
EUR_251	0	EUR	704	71670386	71678663	8277
EUR_251	0	EUR	704	73008725	73031970	23245
EUR_251	0	EUR	704	73500653	73660589	159936
EUR_251	0	EUR	704	74092456	74139119	46663
EUR_251	0	EUR	704	75110846	75133281	22435
EUR_251	0	EUR	704	76133814	76143984	10170
EUR_251	0	EUR	704	78246564	78301884	55320
EUR_251	0	EUR	704	79082049	79134588	52539
EUR_251	0	EUR	704	79883818	79933512	49694
EUR_251	0	EUR	704	81113251	81140731	27480
EUR_251	0	EUR	704	83886982	83921060	34078
EUR_251	0	EUR	704	88796237	88824736	28499
EUR_251	0	EUR	704	90846588	90969654	123066
EUR_251	0	EUR	704	91018779	91107582	88803
EUR_251	0	EUR	704	93553045	93655077	102032
EUR_251	0	EUR	704	94319740	94399538	79798
EUR_251	0	EUR	704	96201761	96216126	14365
EUR_251	0	EUR	704	99230141	99250616	20475
EUR_251	0	EUR	705	4004742	4069279	64537
EUR_251	0	EUR	705	5121074	5123781	2707
EUR_251	0	EUR	705	9414397	9449917	35520
EUR_251	0	EUR	705	13432461	13515051	82590
EUR_251	0	EUR	705	13621609	13626532	4923
EUR_251	0	EUR	705	14053026	14108442	55416
EUR_251	0	EUR	705	16234928	16286721	51793
EUR_251	0	EUR	705	18787414	18806641	19227
EUR_251	0	EUR	705	21153243	21156082	2839
EUR_251	0	EUR	705	21200799	21216283	15484
EUR_251	0	EUR	705	22403197	22417821	14624
EUR_251	0	EUR	705	22454245	22572758	118513
EUR_251	0	EUR	705	23648833	23651476	2643
EUR_251	0	EUR	705	24045382	24166883	121501
EUR_251	0	EUR	705	25264173	25276538	12365
EUR_251	0	EUR	705	26473666	26489805	16139
EUR_251	0	EUR	705	26860657	26889089	28432
EUR_251	0	EUR	705	26942658	26976654	33996
EUR_251	0	EUR	705	27894016	27894364	348
EUR_251	0	EUR	705	28087103	28110553	23450
EUR_251	0	EUR	705	36293685	36357016	63331
EUR_251	0	EUR	705	40132875	40145306	12431
EUR_251	0	EUR	705	40861764	41118281	256517
EUR_251	0	EUR	705	42369514	42431902	62388
EUR_251	0	EUR	705	43359651	43398080	38429
EUR_251	0	EUR	705	43520906	43624720	103814
EUR_251	0	EUR	705	53821064	53848133	27069
EUR_251	0	EUR	705	53966468	54020486	54018
EUR_251	0	EUR	705	59744029	59762964	18935
EUR_251	0	EUR	705	74889460	74894548	5088
EUR_251	0	EUR	705	75886611	75915063	28452
EUR_251	0	EUR	705	76024488	76093521	69033
EUR_251	0	EUR	705	76502715	76594146	91431
EUR_251	0	EUR	705	83533777	83550130	16353
EUR_251	0	EUR	705	83554127	83592822	38695
EUR_251	0	EUR	705	86916801	86926886	10085
EUR_251	0	EUR	705	88527647	88679238	151591
EUR_251	0	EUR	705	88781528	88842770	61242
EUR_251	0	EUR	705	91891040	91902611	11571
EUR_251	0	EUR	705	94239181	94337048	97867
EUR_251	0	EUR	705	94348955	94351994	3039
EUR_251	0	EUR	705	95878015	95887608	9593
EUR_251	0	EUR	705	96317132	96337375	20243
EUR_252	0	EUR	706	1330157	1365161	35004
EUR_252	0	EUR	706	4026962	4029447	2485
EUR_252	0	EUR	706	11778115	11795837	17722
EUR_252	0	EUR	706	12804205	12847009	42804
EUR_252	0	EUR	706	16362032	16402432	40400
EUR_252	0	EUR	706	17889447	17902017	12570
EUR_252	0	EUR	706	18622886	18678327	55441
EUR_252	0	EUR	706	22320042	22417821	97779
EUR_252	0	EUR	706	22454245	22559756	105511
EUR_252	0	EUR	706	23432743	23480035	47292
EUR_252	0	EUR	706	23648833	23651476	2643
EUR_252	0	EUR	706	23841523	23859762	18239
EUR_252	0	EUR	706	24485266	24581630	96364
EUR_252	0	EUR	706	24892444	24906091	13647
EUR_252	0	EUR	706	25554348	25609073	54725
EUR_252	0	EUR	706	26473666	26489805	16139
EUR_252	0	EUR	706	26860657	26889089	28432
EUR_252	0	EUR	706	29510693	29579668	68975
EUR_252	0	EUR	706	31087987	31109532	21545
EUR_252	0	EUR	706	32767431	32880042	112611
EUR_252	0	EUR	706	37727611	37779396	51785
EUR_252	0	EUR	706	40410992	40424856	13864
EUR_252	0	EUR	706	53821064	53848133	27069
EUR_252	0	EUR	706	53966468	54020486	54018
EUR_252	0	EUR	706	56378802	56448072	69270
EUR_252	0	EUR	706	58863206	58863428	222
EUR_252	0	EUR	706	59481017	59515940	34923
EUR_252	0	EUR	706	64430635	64447663	17028
EUR_252	0	EUR	706	64496625	64519080	22455
EUR_252	0	EUR	706	69023918	69060887	36969
EUR_252	0	EUR	706	74669262	74699907	30645
EUR_252	0	EUR	706	76031608	76124545	92937
EUR_252	0	EUR	706	76365488	76397099	31611
EUR_252	0	EUR	706	80238643	80278256	39613
EUR_252	0	EUR	706	80941681	81055112	113431
EUR_252	0	EUR	706	81107841	81229503	121662
EUR_252	0	EUR	706	87760040	87779883	19843
EUR_252	0	EUR	706	88077880	88107284	29404
EUR_252	0	EUR	706	91026914	91107582	80668
EUR_252	0	EUR	706	91847626	91929323	81697
EUR_252	0	EUR	706	94239181	94275395	36214
EUR_252	0	EUR	706	94793518	94886369	92851
EUR_252	0	EUR	707	5312402	5312534	132
EUR_252	0	EUR	707	9413335	9449917	36582
EUR_252	0	EUR	707	13432461	13591601	159140
EUR_252	0	EUR	707	18717757	18844474	126717
EUR_252	0	EUR	707	21200799	21216283	15484
EUR_252	0	EUR	707	23648833	23651476	2643
EUR_252	0	EUR	707	23752602	23850442	97840
EUR_252	0	EUR	707	23863969	23877108	13139
EUR_252	0	EUR	707	24045382	24166883	121501
EUR_252	0	EUR	707	24892444	24906091	13647
EUR_252	0	EUR	707	25741256	25777999	36743
EUR_252	0	EUR	707	26375604	26436121	60517
EUR_252	0	EUR	707	26524728	26562248	37520
EUR_252	0	EUR	707	26860657	26889089	28432
EUR_252	0	EUR	707	31613742	31636518	22776
EUR_252	0	EUR	707	34136759	34182116	45357
EUR_252	0	EUR	707	37722669	37749485	26816
EUR_252	0	EUR	707	37809118	37815963	6845
EUR_252	0	EUR	707	37855802	37890590	34788
EUR_252	0	EUR	707	50053800	50077224	23424
EUR_252	0	EUR	707	53821064	53995783	174719
EUR_252	0	EUR	707	54005322	54016981	11659
EUR_252	0	EUR	707	54588697	54612977	24280
EUR_252	0	EUR	707	57718984	57806028	87044
EUR_252	0	EUR	707	59674842	59696190	21348
EUR_252	0	EUR	707	63714218	63732455	18237
EUR_252	0	EUR	707	64410265	64519080	108815
EUR_252	0	EUR	707	74410856	74438736	27880
EUR_252	0	EUR	707	75263541	75282527	18986
EUR_252	0	EUR	707	76456850	76524019	67169
EUR_252	0	EUR	707	76825105	76869710	44605
EUR_252	0	EUR	707	79901897	79936163	34266
EUR_252	0	EUR	707	87760040	87858554	98514
EUR_252	0	EUR	707	88269547	88300295	30748
EUR_252	0	EUR	707	88324698	88334654	9956
EUR_252	0	EUR	707	88527647	88551173	23526
EUR_252	0	EUR	707	88609381	88739555	130174
EUR_252	0	EUR	707	88761110	89081743	320633
EUR_252	0	EUR	707	90153261	90192049	38788
EUR_252	0	EUR	707	91026914	91097487	70573
EUR_252	0	EUR	707	93628871	93669773	40902
EUR_252	0	EUR	707	94239181	94337048	97867
EUR_252	0	EUR	707	94348955	94389386	40431
EUR_252	0	EUR	707	96116814	96217388	100574
EUR_253	0	EUR	708	2898490	2998355	99865
EUR_253	0	EUR	708	14051019	14112508	61489
EUR_253	0	EUR	708	16202082	16325554	123472
EUR_253	0	EUR	708	17749730	17785756	36026
EUR_253	0	EUR	708	17918899	17978033	59134
EUR_253	0	EUR	708	18704683	18833631	128948
EUR_253	0	EUR	708	22279659	22313169	33510
EUR_253	0	EUR	708	22456611	22462305	5694
EUR_253	0	EUR	708	23752602	23789573	36971
EUR_253	0	EUR	708	24372241	24424495	52254
EUR_253	0	EUR	708	24516931	24581630	64699
EUR_253	0	EUR	708	25953989	25987107	33118
EUR_253	0	EUR	708	26319359	26320890	1531
EUR_253	0	EUR	708	26473666	26491352	17686
EUR_253	0	EUR	708	27837565	27974945	137380
EUR_253	0	EUR	708	29306591	29365834	59243
EUR_253	0	EUR	708	29444267	29483168	38901
EUR_253	0	EUR	708	31087987	31151086	63099
EUR_253	0	EUR	708	37809118	37815963	6845
EUR_253	0	EUR	708	53876467	53931126	54659
EUR_253	0	EUR	708	64372692	64406792	34100
EUR_253	0	EUR	708	72388504	72398733	10229
EUR_253	0	EUR	708	73488506	73491846	3340
EUR_253	0	EUR	708	73498527	73655419	156892
EUR_253	0	EUR	708	74649621	74670272	20651
EUR_253	0	EUR	708	74871541	74894548	23007
EUR_253	0	EUR	708	75522893	75624226	101333
EUR_253	0	EUR	708	75886611	75915063	28452
EUR_253	0	EUR	708	76024488	76093521	69033
EUR_253	0	EUR	708	76502715	76594146	91431
EUR_253	0	EUR	708	81031954	81036282	4328
EUR_253	0	EUR	708	81113251	81229503	116252
EUR_253	0	EUR	708	86916801	86926886	10085
EUR_253	0	EUR	708	88077880	88113320	35440
EUR_253	0	EUR	708	88203712	88319207	115495
EUR_253	0	EUR	708	88452177	88464514	12337
EUR_253	0	EUR	708	88476761	88537179	60418
EUR_253	0	EUR	708	88761110	88877947	116837
EUR_253	0	EUR	708	89989980	89998439	8459
EUR_253	0	EUR	708	91891040	91902611	11571
EUR_253	0	EUR	709	2415974	2536319	120345
EUR_253	0	EUR	709	11532006	11542173	10167
EUR_253	0	EUR	709	11710648	11814111	103463
EUR_253	0	EUR	709	16243211	16253124	9913
EUR_253	0	EUR	709	16339184	16357793	18609
EUR_253	0	EUR	709	18100331	18140078	39747
EUR_253	0	EUR	709	18676403	18751123	74720
EUR_253	0	EUR	709	21246127	21282925	36798
EUR_253	0	EUR	709	22365602	22393602	28000
EUR_253	0	EUR	709	23138000	23184805	46805
EUR_253	0	EUR	709	23752602	23856810	104208
EUR_253	0	EUR	709	24045382	24089668	44286
EUR_253	0	EUR	709	24892444	24906091	13647
EUR_253	0	EUR	709	27894016	27894364	348
EUR_253	0	EUR	709	29273800	29279379	5579
EUR_253	0	EUR	709	29444267	29480892	36625
EUR_253	0	EUR	709	30904434	30907607	3173
EUR_253	0	EUR	709	31255290	31314394	59104
EUR_253	0	EUR	709	32767431	32880042	112611
EUR_253	0	EUR	709	33273306	33310162	36856
EUR_253	0	EUR	709	37727611	37779396	51785
EUR_253	0	EUR	709	40132875	40145306	12431
EUR_253	0	EUR	709	40429940	40602505	172565
EUR_253	0	EUR	709	41359664	41360462	798
EUR_253	0	EUR	709	43359651	43443877	84226
EUR_253	0	EUR	709	43444654	43453960	9306
EUR_253	0	EUR	709	49888473	49899094	10621
EUR_253	0	EUR	709	52286725	52304744	18019
EUR_253	0	EUR	709	53847831	53859932	12101
EUR_253	0	EUR	709	53876467	54035252	158785
EUR_253	0	EUR	709	54686744	54688209	1465
EUR_253	0	EUR	709	54714203	54904011	189808
EUR_253	0	EUR	709	57136159	57251726	115567
EUR_253	0	EUR	709	58863206	58863428	222
EUR_253	0	EUR	709	64338347	64458245	119898
EUR_253	0	EUR	709	71670386	71678663	8277
EUR_253	0	EUR	709	74596535	74738891	142356
EUR_253	0	EUR	709	74871541	74894548	23007
EUR_253	0	EUR	709	75110846	75156481	45635
EUR_253	0	EUR	709	76022322	76032875	10553
EUR_253	0	EUR	709	78831605	78886366	54761
EUR_253	0	EUR	709	79921893	79932889	10996
EUR_253	0	EUR	709	81035034	81087964	52930
EUR_253	0	EUR	709	81088612	81129827	41215
EUR_253	0	EUR	709	83533777	83550130	16353
EUR_253	0	EUR	709	83554127	83592822	38695
EUR_253	0	EUR	709	85385813	85450957	65144
EUR_253	0	EUR	709	88224553	88317076	92523
EUR_253	0	EUR	709	88448752	88464514	15762
EUR_253	0	EUR	709	88476761	88537179	60418
EUR_253	0	EUR	709	88908199	88915947	7748
EUR_253	0	EUR	709	91891040	91902611	11571
EUR_253	0	EUR	709	94347548	94418018	70470
EUR_253	0	EUR	709	94419260	94503617	84357
EUR_254	0	EUR	710	1330157	1336755	6598
EUR_254	0	EUR	710	2947381	3001361	53980
EUR_254	0	EUR	710	5018475	5041230	22755
EUR_254	0	EUR	710	9321331	9384265	62934
EUR_254	0	EUR	710	9431845	9449917	18072
EUR_254	0	EUR	710	11532006	11542173	10167
EUR_254	0	EUR	710	12804205	12847009	42804
EUR_254	0	EUR	710	13492976	13655815	162839
EUR_254	0	EUR	710	13656673	13678187	21514
EUR_254	0	EUR	710	17889447	17902017	12570
EUR_254	0	EUR	710	18622886	18636940	14054
EUR_254	0	EUR	710	20981647	20982609	962
EUR_254	0	EUR	710	21246127	21282925	36798
EUR_254	0	EUR	710	23432743	23480035	47292
EUR_254	0	EUR	710	23648833	23651476	2643
EUR_254	0	EUR	710	23841523	23859762	18239
EUR_254	0	EUR	710	24892444	24894673	2229
EUR_254	0	EUR	710	25741256	25777999	36743
EUR_254	0	EUR	710	26523308	26562248	38940
EUR_254	0	EUR	710	26946861	26991485	44624
EUR_254	0	EUR	710	27746608	27974945	228337
EUR_254	0	EUR	710	28111916	28138518	26602
EUR_254	0	EUR	710	29278047	29300000	21953
EUR_254	0	EUR	710	31235544	31314394	78850
EUR_254	0	EUR	710	32824940	32871485	46545
EUR_254	0	EUR	710	38075148	38097333	22185
EUR_254	0	EUR	710	40410992	40508892	97900
EUR_254	0	EUR	710	41359664	41360462	798
EUR_254	0	EUR	710	49714605	49741250	26645
EUR_254	0	EUR	710	52286725	52294766	8041
EUR_254	0	EUR	710	56378802	56448072	69270
EUR_254	0	EUR	710	57765480	57806900	41420
EUR_254	0	EUR	710	59464397	59522281	57884
EUR_254	0	EUR	710	64439000	64519080	80080
EUR_254	0	EUR	710	72994673	73022663	27990
EUR_254	0	EUR	710	74595799	74699907	104108
EUR_254	0	EUR	710	79082049	79134588	52539
EUR_254	0	EUR	710	87596442	87619926	23484
EUR_254	0	EUR	710	88357338	88363592	6254
EUR_254	0	EUR	710	88527647	88551173	23526
EUR_254	0	EUR	710	88609381	88682270	72889
EUR_254	0	EUR	710	89037057	89081743	44686
EUR_254	0	EUR	710	90467547	90486618	19071
EUR_254	0	EUR	710	91087654	91100598	12944
EUR_254	0	EUR	710	94915497	94930362	14865
EUR_254	0	EUR	711	2987403	2997995	10592
EUR_254	0	EUR	711	4020191	4044195	24004
EUR_254	0	EUR	711	8348919	8386102	37183
EUR_254	0	EUR	711	9149188	9161447	12259
EUR_254	0	EUR	711	11703759	11814111	110352
EUR_254	0	EUR	711	13626867	13635433	8566
EUR_254	0	EUR	711	13640984	13647479	6495
EUR_254	0	EUR	711	16319606	16401162	81556
EUR_254	0	EUR	711	16676133	16681323	5190
EUR_254	0	EUR	711	17749730	17804155	54425
EUR_254	0	EUR	711	18622886	18636940	14054
EUR_254	0	EUR	711	21150173	21156082	5909
EUR_254	0	EUR	711	21200799	21216283	15484
EUR_254	0	EUR	711	22555020	22558220	3200
EUR_254	0	EUR	711	23176150	23184805	8655
EUR_254	0	EUR	711	24081636	24094707	13071
EUR_254	0	EUR	711	25867195	25904509	37314
EUR_254	0	EUR	711	26473666	26489805	16139
EUR_254	0	EUR	711	26860657	26889089	28432
EUR_254	0	EUR	711	29444267	29483168	38901
EUR_254	0	EUR	711	31528053	31593163	65110
EUR_254	0	EUR	711	32039879	32057645	17766
EUR_254	0	EUR	711	36050639	36089268	38629
EUR_254	0	EUR	711	36350791	36460007	109216
EUR_254	0	EUR	711	39639062	39696725	57663
EUR_254	0	EUR	711	39821749	39971335	149586
EUR_254	0	EUR	711	40572310	40602505	30195
EUR_254	0	EUR	711	49720942	49741250	20308
EUR_254	0	EUR	711	49923584	49953714	30130
EUR_254	0	EUR	711	53875418	53947462	72044
EUR_254	0	EUR	711	69023918	69060887	36969
EUR_254	0	EUR	711	72160732	72205102	44370
EUR_254	0	EUR	711	73039375	73160136	120761
EUR_254	0	EUR	711	73488506	73493479	4973
EUR_254	0	EUR	711	74595799	74738891	143092
EUR_254	0	EUR	711	74889460	74894548	5088
EUR_254	0	EUR	711	75914388	75915063	675
EUR_254	0	EUR	711	76533751	76541439	7688
EUR_254	0	EUR	711	79082049	79134588	52539
EUR_254	0	EUR	711	83533777	83550130	16353
EUR_254	0	EUR	711	83554127	83592822	38695
EUR_254	0	EUR	711	87369479	87389813	20334
EUR_254	0	EUR	711	87504329	87507341	3012
EUR_254	0	EUR	711	88405406	88464514	59108
EUR_254	0	EUR	711	92022074	92026726	4652
EUR_254	0	EUR	711	93499176	93647010	147834
EUR_254	0	EUR	711	93908281	93925519	17238
EUR_254	0	EUR	711	94005320	94105458	100138
EUR_254	0	EUR	711	94290726	94412962	122236
EUR_255	0	EUR	712	1330157	1385444	55287
EUR_255	0	EUR	712	2454787	2527168	72381
EUR_255	0	EUR	712	5023771	5041230	17459
EUR_255	0	EUR	712	16323977	16397990	74013
EUR_255	0	EUR	712	18622886	18636940	14054
EUR_255	0	EUR	712	21224963	21225412	449
EUR_255	0	EUR	712	22403197	22417821	14624
EUR_255	0	EUR	712	22454245	22474040	19795
EUR_255	0	EUR	712	23721919	23725831	3912
EUR_255	0	EUR	712	24621120	24737906	116786
EUR_255	0	EUR	712	24809049	24866754	57705
EUR_255	0	EUR	712	25343770	25501390	157620
EUR_255	0	EUR	712	26946861	26991485	44624
EUR_255	0	EUR	712	27971554	27974945	3391
EUR_255	0	EUR	712	29510693	29579668	68975
EUR_255	0	EUR	712	31528053	31542757	14704
EUR_255	0	EUR	712	32262916	32267787	4871
EUR_255	0	EUR	712	32824940	32828620	3680
EUR_255	0	EUR	712	32858056	32870350	12294
EUR_255	0	EUR	712	36454307	36460007	5700
EUR_255	0	EUR	712	36663539	36678544	15005
EUR_255	0	EUR	712	39681230	39692065	10835
EUR_255	0	EUR	712	40061143	40068128	6985
EUR_255	0	EUR	712	42421923	42431902	9979
EUR_255	0	EUR	712	43520906	43549351	28445
EUR_255	0	EUR	712	49951520	49953714	2194
EUR_255	0	EUR	712	54113043	54177383	64340
EUR_255	0	EUR	712	57712252	57806028	93776
EUR_255	0	EUR	712	59481900	59522281	40381
EUR_255	0	EUR	712	59525840	59631623	105783
EUR_255	0	EUR	712	69023918	69060887	36969
EUR_255	0	EUR	712	74410856	74438736	27880
EUR_255	0	EUR	712	74871541	74894548	23007
EUR_255	0	EUR	712	75110846	75189189	78343
EUR_255	0	EUR	712	76365488	76397099	31611
EUR_255	0	EUR	712	77880564	77881732	1168
EUR_255	0	EUR	712	80238643	80278256	39613
EUR_255	0	EUR	712	80941681	81055112	113431
EUR_255	0	EUR	712	81107841	81229503	121662
EUR_255	0	EUR	712	87533821	87546866	13045
EUR_255	0	EUR	712	88077880	88172209	94329
EUR_255	0	EUR	712	88212981	88333763	120782
EUR_255	0	EUR	712	88405406	88464514	59108
EUR_255	0	EUR	712	88476761	88537179	60418
EUR_255	0	EUR	712	88761110	88877947	116837
EUR_255	0	EUR	712	91087654	91097487	9833
EUR_255	0	EUR	712	93202740	93217584	14844
EUR_255	0	EUR	712	93553045	93713967	160922
EUR_255	0	EUR	712	94273104	94325814	52710
EUR_255	0	EUR	712	94347548	94347894	346
EUR_255	0	EUR	712	94362487	94382190	19703
EUR_255	0	EUR	712	94595895	94701010	105115
EUR_255	0	EUR	712	96116814	96140060	23246
EUR_255	0	EUR	713	7572302	7698176	125874
EUR_255	0	EUR	713	9149188	9164904	15716
EUR_255	0	EUR	713	11703759	11814111	110352
EUR_255	0	EUR	713	12764351	12845452	81101
EUR_255	0	EUR	713	13621609	13626532	4923
EUR_255	0	EUR	713	16234928	16286721	51793
EUR_255	0	EUR	713	16670198	16681323	11125
EUR_255	0	EUR	713	20981647	20982609	962
EUR_255	0	EUR	713	21150173	21156082	5909
EUR_255	0	EUR	713	21200799	21216283	15484
EUR_255	0	EUR	713	23721919	23725831	3912
EUR_255	0	EUR	713	24456376	24581630	125254
EUR_255	0	EUR	713	25847649	25855304	7655
EUR_255	0	EUR	713	26886230	26972181	85951
EUR_255	0	EUR	713	28645700	28663032	17332
EUR_255	0	EUR	713	29444267	29483168	38901
EUR_255	0	EUR	713	32081977	32141896	59919
EUR_255	0	EUR	713	32667412	32717462	50050
EUR_255	0	EUR	713	32731788	32870350	138562
EUR_255	0	EUR	713	33316683	33429152	112469
EUR_255	0	EUR	713	37722669	37749485	26816
EUR_255	0	EUR	713	37809118	37815963	6845
EUR_255	0	EUR	713	37855802	37890590	34788
EUR_255	0	EUR	713	39683574	39692065	8491
EUR_255	0	EUR	713	41359664	41360462	798
EUR_255	0	EUR	713	42805387	42823699	18312
EUR_255	0	EUR	713	54631953	54720980	89027
EUR_255	0	EUR	713	57181563	57259146	77583
EUR_255	0	EUR	713	58097270	58136140	38870
EUR_255	0	EUR	713	58863206	58863428	222
EUR_255	0	EUR	713	63714218	63784151	69933
EUR_255	0	EUR	713	64338347	64344522	6175
EUR_255	0	EUR	713	73115427	73116153	726
EUR_255	0	EUR	713	74889460	74894548	5088
EUR_255	0	EUR	713	78255010	78301884	46874
EUR_255	0	EUR	713	87971258	87990554	19296
EUR_255	0	EUR	713	88150251	88172209	21958
EUR_255	0	EUR	713	88212981	88333763	120782
EUR_255	0	EUR	713	88405406	88464514	59108
EUR_255	0	EUR	713	88476761	88537179	60418
EUR_255	0	EUR	713	88761110	88877947	116837
EUR_255	0	EUR	713	89189593	89211291	21698
EUR_255	0	EUR	713	91026914	91107582	80668
EUR_255	0	EUR	713	91847626	91929323	81697
EUR_255	0	EUR	713	94239181	94275395	36214
EUR_255	0	EUR	713	94793518	94886369	92851
EUR_255	0	EUR	713	99242924	99279146	36222
EUR_256	0	EUR	714	1989998	2022517	32519
EUR_256	0	EUR	714	2415974	2536319	120345
EUR_256	0	EUR	714	12764351	12785371	21020
EUR_256	0	EUR	714	16262338	16367500	105162
EUR_256	0	EUR	714	17749730	17804155	54425
EUR_256	0	EUR	714	20981647	21202559	220912
EUR_256	0	EUR	714	22519633	22533171	13538
EUR_256	0	EUR	714	23122511	23173550	51039
EUR_256	0	EUR	714	25847649	25855304	7655
EUR_256	0	EUR	714	26346740	26364945	18205
EUR_256	0	EUR	714	26375604	26436121	60517
EUR_256	0	EUR	714	29444267	29483168	38901
EUR_256	0	EUR	714	31087987	31109532	21545
EUR_256	0	EUR	714	35771774	35849669	77895
EUR_256	0	EUR	714	39681230	39686489	5259
EUR_256	0	EUR	714	40919189	41024466	105277
EUR_256	0	EUR	714	57289191	57291065	1874
EUR_256	0	EUR	714	57712252	57806028	93776
EUR_256	0	EUR	714	59409355	59522281	112926
EUR_256	0	EUR	714	59744029	59762964	18935
EUR_256	0	EUR	714	63714218	63732455	18237
EUR_256	0	EUR	714	64333373	64476517	143144
EUR_256	0	EUR	714	69023918	69060887	36969
EUR_256	0	EUR	714	74871541	74894548	23007
EUR_256	0	EUR	714	75263541	75282527	18986
EUR_256	0	EUR	714	75522893	75529067	6174
EUR_256	0	EUR	714	76365488	76395555	30067
EUR_256	0	EUR	714	80852609	80854395	1786
EUR_256	0	EUR	714	88221167	88242054	20887
EUR_256	0	EUR	714	88275443	88319207	43764
EUR_256	0	EUR	714	88449900	88464514	14614
EUR_256	0	EUR	714	88527647	88551173	23526
EUR_256	0	EUR	714	88609381	88682270	72889
EUR_256	0	EUR	714	89037057	89081743	44686
EUR_256	0	EUR	714	90916970	90939817	22847
EUR_256	0	EUR	714	91987726	91991624	3898
EUR_256	0	EUR	714	93361912	93411339	49427
EUR_256	0	EUR	714	94395991	94412962	16971
EUR_256	0	EUR	714	94473086	94544971	71885
EUR_256	0	EUR	714	95807117	95809028	1911
EUR_256	0	EUR	714	96537974	96552159	14185
EUR_256	0	EUR	715	2996253	2997995	1742
EUR_256	0	EUR	715	3963320	4017634	54314
EUR_256	0	EUR	715	5121074	5123781	2707
EUR_256	0	EUR	715	9149188	9161447	12259
EUR_256	0	EUR	715	11703759	11814111	110352
EUR_256	0	EUR	715	12764351	12845452	81101
EUR_256	0	EUR	715	17889447	17902017	12570
EUR_256	0	EUR	715	21150173	21156082	5909
EUR_256	0	EUR	715	21200799	21216283	15484
EUR_256	0	EUR	715	23503031	23651476	148445
EUR_256	0	EUR	715	23721919	23797839	75920
EUR_256	0	EUR	715	24059801	24166883	107082
EUR_256	0	EUR	715	25264173	25276538	12365
EUR_256	0	EUR	715	25978368	25987107	8739
EUR_256	0	EUR	715	26415865	26436121	20256
EUR_256	0	EUR	715	26886230	26991485	105255
EUR_256	0	EUR	715	27894016	27894364	348
EUR_256	0	EUR	715	28087103	28110553	23450
EUR_256	0	EUR	715	31233297	31314394	81097
EUR_256	0	EUR	715	31478668	31486281	7613
EUR_256	0	EUR	715	32667412	32865130	197718
EUR_256	0	EUR	715	32868978	32870350	1372
EUR_256	0	EUR	715	35771774	35849669	77895
EUR_256	0	EUR	715	40555384	40602505	47121
EUR_256	0	EUR	715	42369514	42431902	62388
EUR_256	0	EUR	715	54686744	54688209	1465
EUR_256	0	EUR	715	54714203	54882439	168236
EUR_256	0	EUR	715	64338347	64382745	44398
EUR_256	0	EUR	715	71722082	71732410	10328
EUR_256	0	EUR	715	73488506	73493479	4973
EUR_256	0	EUR	715	73588449	73602054	13605
EUR_256	0	EUR	715	74871541	74894548	23007
EUR_256	0	EUR	715	75110846	75189189	78343
EUR_256	0	EUR	715	76022322	76055308	32986
EUR_256	0	EUR	715	83886982	83921060	34078
EUR_256	0	EUR	715	87533821	87546866	13045
EUR_256	0	EUR	715	88077880	88172209	94329
EUR_256	0	EUR	715	88212981	88333763	120782
EUR_256	0	EUR	715	88405406	88464514	59108
EUR_256	0	EUR	715	88476761	88537179	60418
EUR_256	0	EUR	715	88761110	88877947	116837
EUR_256	0	EUR	715	93130067	93146996	16929
EUR_256	0	EUR	715	93877236	93921319	44083
EUR_256	0	EUR	715	95323015	95353984	30969
EUR_256	0	EUR	715	95774147	95778109	3962
EUR_256	0	EUR	715	96116814	96216785	99971
EUR_256	0	EUR	715	99256882	99280798	23916
EUR_257	0	EUR	716	399889	401572	1683
EUR_257	0	EUR	716	12764351	12845452	81101
EUR_257	0	EUR	716	13621609	13626532	4923
EUR_257	0	EUR	716	16202082	16325554	123472
EUR_257	0	EUR	716	17824353	17897317	72964
EUR_257	0	EUR	716	18100331	18140078	39747
EUR_257	0	EUR	716	21150173	21156082	5909
EUR_257	0	EUR	716	21200799	21216283	15484
EUR_257	0	EUR	716	22520695	22533171	12476
EUR_257	0	EUR	716	22992959	23024189	31230
EUR_257	0	EUR	716	23752602	23856810	104208
EUR_257	0	EUR	716	24892444	24906091	13647
EUR_257	0	EUR	716	25419759	25501390	81631
EUR_257	0	EUR	716	25867195	25904509	37314
EUR_257	0	EUR	716	29278643	29279379	736
EUR_257	0	EUR	716	29306591	29478208	171617
EUR_257	0	EUR	716	31090441	31109532	19091
EUR_257	0	EUR	716	33126757	33166924	40167
EUR_257	0	EUR	716	37885686	37943125	57439
EUR_257	0	EUR	716	39639062	39696725	57663
EUR_257	0	EUR	716	39838138	39877905	39767
EUR_257	0	EUR	716	40410992	40424856	13864
EUR_257	0	EUR	716	42493150	42498059	4909
EUR_257	0	EUR	716	42805387	42823699	18312
EUR_257	0	EUR	716	43359651	43453960	94309
EUR_257	0	EUR	716	49768647	49899094	130447
EUR_257	0	EUR	716	53821064	53859932	38868
EUR_257	0	EUR	716	54123719	54150257	26538
EUR_257	0	EUR	716	54403505	54431022	27517
EUR_257	0	EUR	716	54686744	54688209	1465
EUR_257	0	EUR	716	56442176	56448072	5896
EUR_257	0	EUR	716	57181563	57259146	77583
EUR_257	0	EUR	716	58863206	58863428	222
EUR_257	0	EUR	716	59208358	59245710	37352
EUR_257	0	EUR	716	59464397	59522281	57884
EUR_257	0	EUR	716	72256813	72314514	57701
EUR_257	0	EUR	716	74410856	74438736	27880
EUR_257	0	EUR	716	74871541	74894548	23007
EUR_257	0	EUR	716	76780192	76855179	74987
EUR_257	0	EUR	716	78872928	78886366	13438
EUR_257	0	EUR	716	79901897	79915686	13789
EUR_257	0	EUR	716	81114562	81229503	114941
EUR_257	0	EUR	716	83955315	83957574	2259
EUR_257	0	EUR	716	84790760	84919115	128355
EUR_257	0	EUR	716	88221167	88242054	20887
EUR_257	0	EUR	716	88275443	88319207	43764
EUR_257	0	EUR	716	88449900	88464514	14614
EUR_257	0	EUR	716	88541405	88707672	166267
EUR_257	0	EUR	716	88877686	88915947	38261
EUR_257	0	EUR	716	90058636	90202160	143524
EUR_257	0	EUR	716	91847626	91929323	81697
EUR_257	0	EUR	716	91987726	91991624	3898
EUR_257	0	EUR	716	94241722	94325814	84092
EUR_257	0	EUR	716	94512067	94522438	10371
EUR_257	0	EUR	716	94532669	94544971	12302
EUR_257	0	EUR	716	94915497	94930362	14865
EUR_257	0	EUR	716	96116814	96129704	12890
EUR_257	0	EUR	716	96136238	96151871	15633
EUR_257	0	EUR	716	96176046	96201851	25805
EUR_257	0	EUR	716	99242924	99279146	36222
EUR_257	0	EUR	717	2415974	2487339	71365
EUR_257	0	EUR	717	2996253	2997995	1742
EUR_257	0	EUR	717	11703759	11814111	110352
EUR_257	0	EUR	717	16248080	16259130	11050
EUR_257	0	EUR	717	16397154	16454511	57357
EUR_257	0	EUR	717	18100331	18140078	39747
EUR_257	0	EUR	717	21246127	21276019	29892
EUR_257	0	EUR	717	22365602	22393602	28000
EUR_257	0	EUR	717	23176150	23184805	8655
EUR_257	0	EUR	717	23564194	23577145	12951
EUR_257	0	EUR	717	25183341	25237709	54368
EUR_257	0	EUR	717	26375604	26436121	60517
EUR_257	0	EUR	717	26524728	26562248	37520
EUR_257	0	EUR	717	26860657	26889089	28432
EUR_257	0	EUR	717	28087103	28139866	52763
EUR_257	0	EUR	717	31516087	31581077	64990
EUR_257	0	EUR	717	31609661	31636518	26857
EUR_257	0	EUR	717	36454307	36460007	5700
EUR_257	0	EUR	717	39683574	39692065	8491
EUR_257	0	EUR	717	41359664	41360462	798
EUR_257	0	EUR	717	49741621	49765045	23424
EUR_257	0	EUR	717	53821064	53848133	27069
EUR_257	0	EUR	717	53966468	54020486	54018
EUR_257	0	EUR	717	57181563	57259146	77583
EUR_257	0	EUR	717	58680548	58694180	13632
EUR_257	0	EUR	717	69023918	69026607	2689
EUR_257	0	EUR	717	71590090	71594997	4907
EUR_257	0	EUR	717	71722082	71726336	4254
EUR_257	0	EUR	717	72160732	72205102	44370
EUR_257	0	EUR	717	72388504	72398733	10229
EUR_257	0	EUR	717	74871541	74894548	23007
EUR_257	0	EUR	717	75263541	75282527	18986
EUR_257	0	EUR	717	76022322	76059358	37036
EUR_257	0	EUR	717	76552281	76594146	41865
EUR_257	0	EUR	717	78255010	78301884	46874
EUR_257	0	EUR	717	78831605	78886366	54761
EUR_257	0	EUR	717	79901897	79903521	1624
EUR_257	0	EUR	717	79921893	79936163	14270
EUR_257	0	EUR	717	83941668	83957574	15906
EUR_257	0	EUR	717	88678345	88679238	893
EUR_257	0	EUR	717	88797692	88812922	15230
EUR_257	0	EUR	717	88838419	88877947	39528
EUR_257	0	EUR	717	88997194	89081743	84549
EUR_257	0	EUR	717	90058636	90202160	143524
EUR_257	0	EUR	717	93702886	93713967	11081
EUR_257	0	EUR	717	94239181	94275395	36214
EUR_257	0	EUR	717	94793518	94886369	92851
EUR_258	0	EUR	718	1330817	1385444	54627
EUR_258	0	EUR	718	1762556	1775693	13137
EUR_258	0	EUR	718	2415974	2430939	14965
EUR_258	0	EUR	718	4004059	4126878	122819
EUR_258	0	EUR	718	4129102	4130169	1067
EUR_258	0	EUR	718	5018475	5041230	22755
EUR_258	0	EUR	718	12831243	12847009	15766
EUR_258	0	EUR	718	13621609	13626532	4923
EUR_258	0	EUR	718	14053026	14108442	55416
EUR_258	0	EUR	718	16277035	16286721	9686
EUR_258	0	EUR	718	16377743	16397990	20247
EUR_258	0	EUR	718	17749730	17799503	49773
EUR_258	0	EUR	718	22414077	22417821	3744
EUR_258	0	EUR	718	22454245	22476003	21758
EUR_258	0	EUR	718	22519633	22533171	13538
EUR_258	0	EUR	718	23176150	23184805	8655
EUR_258	0	EUR	718	23432743	23471650	38907
EUR_258	0	EUR	718	24580740	24581630	890
EUR_258	0	EUR	718	25343770	25501390	157620
EUR_258	0	EUR	718	25741256	25777999	36743
EUR_258	0	EUR	718	26384189	26414390	30201
EUR_258	0	EUR	718	26477051	26529674	52623
EUR_258	0	EUR	718	29444267	29483168	38901
EUR_258	0	EUR	718	31087987	31138800	50813
EUR_258	0	EUR	718	31528053	31593163	65110
EUR_258	0	EUR	718	33143811	33166924	23113
EUR_258	0	EUR	718	37776227	37839133	62906
EUR_258	0	EUR	718	56401541	56448072	46531
EUR_258	0	EUR	718	57149895	57163941	14046
EUR_258	0	EUR	718	57712252	57806900	94648
EUR_258	0	EUR	718	64343818	64519080	175262
EUR_258	0	EUR	718	68626746	68648432	21686
EUR_258	0	EUR	718	73628865	73634178	5313
EUR_258	0	EUR	718	78255010	78301884	46874
EUR_258	0	EUR	718	80238643	80278256	39613
EUR_258	0	EUR	718	80941681	81055112	113431
EUR_258	0	EUR	718	81107841	81229503	121662
EUR_258	0	EUR	718	86916801	86971491	54690
EUR_258	0	EUR	718	87385759	87389813	4054
EUR_258	0	EUR	718	87969149	87990554	21405
EUR_258	0	EUR	718	88821331	88877947	56616
EUR_258	0	EUR	718	90916970	90939817	22847
EUR_258	0	EUR	718	93130067	93146996	16929
EUR_258	0	EUR	718	94239181	94246784	7603
EUR_258	0	EUR	718	94347548	94418018	70470
EUR_258	0	EUR	718	94419260	94510654	91394
EUR_258	0	EUR	719	1820511	1830270	9759
EUR_258	0	EUR	719	4105020	4130169	25149
EUR_258	0	EUR	719	9235548	9308590	73042
EUR_258	0	EUR	719	9356784	9420195	63411
EUR_258	0	EUR	719	11480169	11492904	12735
EUR_258	0	EUR	719	14051019	14112508	61489
EUR_258	0	EUR	719	23122511	23173550	51039
EUR_258	0	EUR	719	24045382	24166883	121501
EUR_258	0	EUR	719	25343770	25501390	157620
EUR_258	0	EUR	719	25867195	25987107	119912
EUR_258	0	EUR	719	27746608	27766580	19972
EUR_258	0	EUR	719	31528053	31575105	47052
EUR_258	0	EUR	719	37722669	37749485	26816
EUR_258	0	EUR	719	37809118	37815963	6845
EUR_258	0	EUR	719	37855802	37885921	30119
EUR_258	0	EUR	719	37972445	38097333	124888
EUR_258	0	EUR	719	40864889	40875488	10599
EUR_258	0	EUR	719	53821064	53859932	38868
EUR_258	0	EUR	719	54050284	54056346	6062
EUR_258	0	EUR	719	54584313	54612977	28664
EUR_258	0	EUR	719	59464397	59522281	57884
EUR_258	0	EUR	719	64338347	64458245	119898
EUR_258	0	EUR	719	69023918	69052189	28271
EUR_258	0	EUR	719	74092456	74139119	46663
EUR_258	0	EUR	719	74595799	74699907	104108
EUR_258	0	EUR	719	75263541	75282527	18986
EUR_258	0	EUR	719	79901897	79903521	1624
EUR_258	0	EUR	719	86916801	86926886	10085
EUR_258	0	EUR	719	88078757	88156291	77534
EUR_258	0	EUR	719	88200401	88319207	118806
EUR_258	0	EUR	719	88452177	88464514	12337
EUR_258	0	EUR	719	88476761	88537179	60418
EUR_258	0	EUR	719	89054631	89235318	180687
EUR_258	0	EUR	719	92028660	92056341	27681
EUR_258	0	EUR	719	93361912	93411339	49427
EUR_258	0	EUR	719	93800814	93869231	68417
EUR_258	0	EUR	719	94395991	94412962	16971
EUR_258	0	EUR	719	94473086	94544971	71885
EUR_258	0	EUR	719	94915497	94930362	14865
EUR_258	0	EUR	719	96116814	96206095	89281
EUR_259	0	EUR	720	2484893	2702115	217222
EUR_259	0	EUR	720	2996253	2997995	1742
EUR_259	0	EUR	720	4111555	4134871	23316
EUR_259	0	EUR	720	5121074	5123781	2707
EUR_259	0	EUR	720	11532006	11542173	10167
EUR_259	0	EUR	720	12804205	12847009	42804
EUR_259	0	EUR	720	13574314	13635433	61119
EUR_259	0	EUR	720	13640984	13678187	37203
EUR_259	0	EUR	720	16243211	16397990	154779
EUR_259	0	EUR	720	17918899	18041675	122776
EUR_259	0	EUR	720	18723172	18803498	80326
EUR_259	0	EUR	720	23432743	23480035	47292
EUR_259	0	EUR	720	23648833	23651476	2643
EUR_259	0	EUR	720	23841523	23859762	18239
EUR_259	0	EUR	720	25953989	25987107	33118
EUR_259	0	EUR	720	29444267	29483168	38901
EUR_259	0	EUR	720	31087987	31151086	63099
EUR_259	0	EUR	720	36293685	36357016	63331
EUR_259	0	EUR	720	40003482	40021907	18425
EUR_259	0	EUR	720	40504546	40602505	97959
EUR_259	0	EUR	720	41319133	41360462	41329
EUR_259	0	EUR	720	43361483	43453960	92477
EUR_259	0	EUR	720	54686744	54688209	1465
EUR_259	0	EUR	720	54714203	54904011	189808
EUR_259	0	EUR	720	56442176	56448072	5896
EUR_259	0	EUR	720	57248502	57291065	42563
EUR_259	0	EUR	720	58127732	58136140	8408
EUR_259	0	EUR	720	58608875	58694180	85305
EUR_259	0	EUR	720	64338347	64382745	44398
EUR_259	0	EUR	720	69048774	69068474	19700
EUR_259	0	EUR	720	70541408	70544348	2940
EUR_259	0	EUR	720	72994673	73022663	27990
EUR_259	0	EUR	720	74871541	74894548	23007
EUR_259	0	EUR	720	76798082	76855179	57097
EUR_259	0	EUR	720	76924252	76952670	28418
EUR_259	0	EUR	720	77823655	77885640	61985
EUR_259	0	EUR	720	79883818	79933512	49694
EUR_259	0	EUR	720	80454885	80489589	34704
EUR_259	0	EUR	720	88335445	88363592	28147
EUR_259	0	EUR	720	88888318	89050718	162400
EUR_259	0	EUR	720	91026914	91107582	80668
EUR_259	0	EUR	720	92022074	92044148	22074
EUR_259	0	EUR	720	93499176	93647010	147834
EUR_259	0	EUR	720	94793518	94927766	134248
EUR_259	0	EUR	720	95000428	95011492	11064
EUR_259	0	EUR	720	95270807	95445533	174726
EUR_259	0	EUR	720	96144084	96155255	11171
EUR_259	0	EUR	721	387573	401572	13999
EUR_259	0	EUR	721	4020191	4044195	24004
EUR_259	0	EUR	721	5018475	5041230	22755
EUR_259	0	EUR	721	8662954	8682424	19470
EUR_259	0	EUR	721	13574314	13635433	61119
EUR_259	0	EUR	721	13640984	13678187	37203
EUR_259	0	EUR	721	16243211	16397990	154779
EUR_259	0	EUR	721	17918899	18041675	122776
EUR_259	0	EUR	721	18717757	18844474	126717
EUR_259	0	EUR	721	21150173	21156082	5909
EUR_259	0	EUR	721	21224963	21225412	449
EUR_259	0	EUR	721	22496216	22533171	36955
EUR_259	0	EUR	721	23122511	23173550	51039
EUR_259	0	EUR	721	23236907	23244178	7271
EUR_259	0	EUR	721	23765972	23789573	23601
EUR_259	0	EUR	721	23841523	23877108	35585
EUR_259	0	EUR	721	24892444	24906091	13647
EUR_259	0	EUR	721	25741256	25777999	36743
EUR_259	0	EUR	721	26798389	26801347	2958
EUR_259	0	EUR	721	26941352	26991485	50133
EUR_259	0	EUR	721	27814859	27860674	45815
EUR_259	0	EUR	721	28645700	28663032	17332
EUR_259	0	EUR	721	29315966	29475974	160008
EUR_259	0	EUR	721	31087987	31131774	43787
EUR_259	0	EUR	721	35887157	35892995	5838
EUR_259	0	EUR	721	37727611	37762850	35239
EUR_259	0	EUR	721	39639062	39677248	38186
EUR_259	0	EUR	721	40894823	40938890	44067
EUR_259	0	EUR	721	43520906	43525374	4468
EUR_259	0	EUR	721	49720942	49741250	20308
EUR_259	0	EUR	721	49923584	49953714	30130
EUR_259	0	EUR	721	54686744	54688209	1465
EUR_259	0	EUR	721	54714203	54803548	89345
EUR_259	0	EUR	721	59744029	59762964	18935
EUR_259	0	EUR	721	63714218	63736721	22503
EUR_259	0	EUR	721	64338347	64458245	119898
EUR_259	0	EUR	721	72160732	72205102	44370
EUR_259	0	EUR	721	74640712	74670272	29560
EUR_259	0	EUR	721	74871541	74894548	23007
EUR_259	0	EUR	721	75110846	75189189	78343
EUR_259	0	EUR	721	76365488	76399941	34453
EUR_259	0	EUR	721	77733985	77735979	1994
EUR_259	0	EUR	721	79901897	79936163	34266
EUR_259	0	EUR	721	80161288	80278256	116968
EUR_259	0	EUR	721	81107841	81229503	121662
EUR_259	0	EUR	721	87536687	87623148	86461
EUR_259	0	EUR	721	88258345	88319207	60862
EUR_259	0	EUR	721	88895018	89081743	186725
EUR_259	0	EUR	721	90153261	90211457	58196
EUR_259	0	EUR	721	91891040	91902611	11571
EUR_259	0	EUR	721	93553045	93655077	102032
EUR_259	0	EUR	721	93701190	93713967	12777
EUR_259	0	EUR	721	94208817	94240518	31701
EUR_259	0	EUR	721	94262178	94325814	63636
EUR_259	0	EUR	721	94347548	94418018	70470
EUR_259	0	EUR	721	94419260	94510654	91394
EUR_260	0	EUR	722	340121	359434	19313
EUR_260	0	EUR	722	1335796	1336755	959
EUR_260	0	EUR	722	1924080	2022517	98437
EUR_260	0	EUR	722	2454787	2527168	72381
EUR_260	0	EUR	722	3970871	3978851	7980
EUR_260	0	EUR	722	4042638	4044195	1557
EUR_260	0	EUR	722	11650195	11731498	81303
EUR_260	0	EUR	722	13076756	13125585	48829
EUR_260	0	EUR	722	13574314	13635433	61119
EUR_260	0	EUR	722	13640984	13678187	37203
EUR_260	0	EUR	722	16202082	16207737	5655
EUR_260	0	EUR	722	16249681	16286721	37040
EUR_260	0	EUR	722	22397350	22417821	20471
EUR_260	0	EUR	722	22454245	22532371	78126
EUR_260	0	EUR	722	24372241	24384508	12267
EUR_260	0	EUR	722	24535579	24581630	46051
EUR_260	0	EUR	722	24892444	24906091	13647
EUR_260	0	EUR	722	25179048	25305885	126837
EUR_260	0	EUR	722	25492458	25501390	8932
EUR_260	0	EUR	722	26473666	26491352	17686
EUR_260	0	EUR	722	26886230	26972181	85951
EUR_260	0	EUR	722	27814859	27974945	160086
EUR_260	0	EUR	722	29321833	29348593	26760
EUR_260	0	EUR	722	29470174	29483168	12994
EUR_260	0	EUR	722	29541243	29579668	38425
EUR_260	0	EUR	722	30904434	31040753	136319
EUR_260	0	EUR	722	33245767	33429152	183385
EUR_260	0	EUR	722	34880550	34926785	46235
EUR_260	0	EUR	722	43359651	43413247	53596
EUR_260	0	EUR	722	50053800	50077224	23424
EUR_260	0	EUR	722	52224085	52231250	7165
EUR_260	0	EUR	722	53821064	53931126	110062
EUR_260	0	EUR	722	53977233	54004528	27295
EUR_260	0	EUR	722	57712252	57773223	60971
EUR_260	0	EUR	722	59423469	59424864	1395
EUR_260	0	EUR	722	59553546	59700527	146981
EUR_260	0	EUR	722	64496625	64519080	22455
EUR_260	0	EUR	722	77751346	77795912	44566
EUR_260	0	EUR	722	79901897	79936163	34266
EUR_260	0	EUR	722	80946931	81087964	141033
EUR_260	0	EUR	722	81088612	81190655	102043
EUR_260	0	EUR	722	86916801	86926886	10085
EUR_260	0	EUR	722	87760040	87858554	98514
EUR_260	0	EUR	722	88126552	88319207	192655
EUR_260	0	EUR	722	88797692	88831972	34280
EUR_260	0	EUR	722	89055660	89235318	179658
EUR_260	0	EUR	722	89363544	89465942	102398
EUR_260	0	EUR	722	91074962	91097487	22525
EUR_260	0	EUR	722	93470832	93517093	46261
EUR_260	0	EUR	722	93886899	94003627	116728
EUR_260	0	EUR	722	94280856	94317758	36902
EUR_260	0	EUR	722	95418231	95445533	27302
EUR_260	0	EUR	722	95885567	95887608	2041
EUR_260	0	EUR	722	96317132	96337375	20243
EUR_260	0	EUR	723	5018475	5041230	22755
EUR_260	0	EUR	723	13592472	13805391	212919
EUR_260	0	EUR	723	18717757	18844474	126717
EUR_260	0	EUR	723	21150173	21156082	5909
EUR_260	0	EUR	723	21224963	21225412	449
EUR_260	0	EUR	723	22496216	22533171	36955
EUR_260	0	EUR	723	23122511	23173550	51039
EUR_260	0	EUR	723	23236907	23244178	7271
EUR_260	0	EUR	723	23765972	23789573	23601
EUR_260	0	EUR	723	23841523	23877108	35585
EUR_260	0	EUR	723	24892444	24906091	13647
EUR_260	0	EUR	723	25741256	25777999	36743
EUR_260	0	EUR	723	26798389	26801347	2958
EUR_260	0	EUR	723	26941352	26991485	50133
EUR_260	0	EUR	723	27814859	27860674	45815
EUR_260	0	EUR	723	28645700	28663032	17332
EUR_260	0	EUR	723	29315966	29475974	160008
EUR_260	0	EUR	723	31087987	31131774	43787
EUR_260	0	EUR	723	35887157	35892995	5838
EUR_260	0	EUR	723	37727611	37762850	35239
EUR_260	0	EUR	723	39639062	39677248	38186
EUR_260	0	EUR	723	40894823	40938890	44067
EUR_260	0	EUR	723	49720942	49741250	20308
EUR_260	0	EUR	723	53821064	53859932	38868
EUR_260	0	EUR	723	54123719	54150257	26538
EUR_260	0	EUR	723	54403505	54431022	27517
EUR_260	0	EUR	723	69039730	69060887	21157
EUR_260	0	EUR	723	71722082	71732410	10328
EUR_260	0	EUR	723	75263541	75282527	18986
EUR_260	0	EUR	723	76533751	76541439	7688
EUR_260	0	EUR	723	78816419	78881412	64993
EUR_260	0	EUR	723	79860282	79933512	73230
EUR_260	0	EUR	723	81113251	81189650	76399
EUR_260	0	EUR	723	88152919	88153791	872
EUR_260	0	EUR	723	88418285	88762816	344531
EUR_260	0	EUR	723	89189593	89211291	21698
EUR_260	0	EUR	723	93130067	93146996	16929
EUR_260	0	EUR	723	94915497	94930362	14865
EUR_261	0	EUR	724	1989998	2022517	32519
EUR_261	0	EUR	724	2415974	2536319	120345
EUR_261	0	EUR	724	12764351	12785371	21020
EUR_261	0	EUR	724	13432461	13805391	372930
EUR_261	0	EUR	724	18716646	18844474	127828
EUR_261	0	EUR	724	21246127	21282925	36798
EUR_261	0	EUR	724	25140534	25305885	165351
EUR_261	0	EUR	724	25455175	25501390	46215
EUR_261	0	EUR	724	26346740	26364945	18205
EUR_261	0	EUR	724	26375604	26436121	60517
EUR_261	0	EUR	724	27746608	27884833	138225
EUR_261	0	EUR	724	29373765	29390654	16889
EUR_261	0	EUR	724	31087987	31131774	43787
EUR_261	0	EUR	724	31528053	31575105	47052
EUR_261	0	EUR	724	34904006	34926785	22779
EUR_261	0	EUR	724	37727611	37779396	51785
EUR_261	0	EUR	724	37847322	37906769	59447
EUR_261	0	EUR	724	40083840	40090192	6352
EUR_261	0	EUR	724	40947704	41087414	139710
EUR_261	0	EUR	724	43359651	43387543	27892
EUR_261	0	EUR	724	43556834	43624720	67886
EUR_261	0	EUR	724	50085590	50097389	11799
EUR_261	0	EUR	724	50219290	50246703	27413
EUR_261	0	EUR	724	53967520	54035252	67732
EUR_261	0	EUR	724	54324134	54407949	83815
EUR_261	0	EUR	724	57712252	57806900	94648
EUR_261	0	EUR	724	59631177	59631623	446
EUR_261	0	EUR	724	59744029	59762964	18935
EUR_261	0	EUR	724	64321831	64519080	197249
EUR_261	0	EUR	724	76456850	76594146	137296
EUR_261	0	EUR	724	83886982	83921060	34078
EUR_261	0	EUR	724	87075746	87077051	1305
EUR_261	0	EUR	724	87665598	87696821	31223
EUR_261	0	EUR	724	88126552	88319207	192655
EUR_261	0	EUR	724	89356470	89372641	16171
EUR_261	0	EUR	724	94006766	94031719	24953
EUR_261	0	EUR	724	94239181	94246409	7228
EUR_261	0	EUR	724	94447447	94522438	74991
EUR_261	0	EUR	724	96144084	96201851	57767
EUR_261	0	EUR	724	99256882	99280798	23916
EUR_261	0	EUR	725	2695536	2854362	158826
EUR_261	0	EUR	725	4020191	4044195	24004
EUR_261	0	EUR	725	5018475	5041230	22755
EUR_261	0	EUR	725	9235548	9246463	10915
EUR_261	0	EUR	725	9251276	9299543	48267
EUR_261	0	EUR	725	9413335	9423196	9861
EUR_261	0	EUR	725	11541406	11542173	767
EUR_261	0	EUR	725	11710648	11814111	103463
EUR_261	0	EUR	725	16234928	16240882	5954
EUR_261	0	EUR	725	16243211	16328490	85279
EUR_261	0	EUR	725	17749730	17804155	54425
EUR_261	0	EUR	725	21153243	21156082	2839
EUR_261	0	EUR	725	21200799	21216283	15484
EUR_261	0	EUR	725	22992959	23024189	31230
EUR_261	0	EUR	725	23752602	23856810	104208
EUR_261	0	EUR	725	24045382	24166883	121501
EUR_261	0	EUR	725	24372241	24384508	12267
EUR_261	0	EUR	725	24535579	24581630	46051
EUR_261	0	EUR	725	24892444	24906091	13647
EUR_261	0	EUR	725	25179048	25305885	126837
EUR_261	0	EUR	725	25492458	25501390	8932
EUR_261	0	EUR	725	26473666	26489805	16139
EUR_261	0	EUR	725	27746608	27759553	12945
EUR_261	0	EUR	725	30904434	31040753	136319
EUR_261	0	EUR	725	31527830	31674144	146314
EUR_261	0	EUR	725	32767431	32880042	112611
EUR_261	0	EUR	725	36663539	36674706	11167
EUR_261	0	EUR	725	49791142	49864433	73291
EUR_261	0	EUR	725	54037247	54070402	33155
EUR_261	0	EUR	725	54225259	54396948	171689
EUR_261	0	EUR	725	57712252	57806028	93776
EUR_261	0	EUR	725	59444860	59522281	77421
EUR_261	0	EUR	725	59525840	59631623	105783
EUR_261	0	EUR	725	63714218	63732455	18237
EUR_261	0	EUR	725	64372692	64406792	34100
EUR_261	0	EUR	725	64489532	64492914	3382
EUR_261	0	EUR	725	75110846	75118830	7984
EUR_261	0	EUR	725	75263541	75282527	18986
EUR_261	0	EUR	725	84790760	84919115	128355
EUR_261	0	EUR	725	87075746	87077051	1305
EUR_261	0	EUR	725	87760040	87858554	98514
EUR_261	0	EUR	725	88307099	88333763	26664
EUR_261	0	EUR	725	88781860	88805716	23856
EUR_261	0	EUR	725	88876560	89001971	125411
EUR_261	0	EUR	725	89069223	89081743	12520
EUR_261	0	EUR	725	89369024	89372641	3617
EUR_261	0	EUR	725	90153798	90243516	89718
EUR_261	0	EUR	725	91891040	91894135	3095
EUR_261	0	EUR	725	93553045	93558539	5494
EUR_261	0	EUR	725	93943380	94056780	113400
EUR_261	0	EUR	725	94297447	94392780	95333
EUR_261	0	EUR	725	94451319	94506614	55295
EUR_262	0	EUR	726	1330157	1385444	55287
EUR_262	0	EUR	726	2415974	2702115	286141
EUR_262	0	EUR	726	18100331	18140078	39747
EUR_262	0	EUR	726	18716646	18844474	127828
EUR_262	0	EUR	726	21246127	21282925	36798
EUR_262	0	EUR	726	22365602	22393602	28000
EUR_262	0	EUR	726	24485266	24487106	1840
EUR_262	0	EUR	726	25179048	25207450	28402
EUR_262	0	EUR	726	25264173	25276538	12365
EUR_262	0	EUR	726	25978368	25987107	8739
EUR_262	0	EUR	726	26403126	26429831	26705
EUR_262	0	EUR	726	26898268	26972181	73913
EUR_262	0	EUR	726	27746608	27974945	228337
EUR_262	0	EUR	726	31087987	31109532	21545
EUR_262	0	EUR	726	32057270	32084128	26858
EUR_262	0	EUR	726	33143811	33166924	23113
EUR_262	0	EUR	726	34880550	34926785	46235
EUR_262	0	EUR	726	37722669	37749485	26816
EUR_262	0	EUR	726	37809118	37815963	6845
EUR_262	0	EUR	726	39838138	39891202	53064
EUR_262	0	EUR	726	43359651	43413247	53596
EUR_262	0	EUR	726	49714605	49741250	26645
EUR_262	0	EUR	726	49790907	49899094	108187
EUR_262	0	EUR	726	53821064	54020486	199422
EUR_262	0	EUR	726	54403505	54431022	27517
EUR_262	0	EUR	726	56442176	56448072	5896
EUR_262	0	EUR	726	59580290	59607931	27641
EUR_262	0	EUR	726	59744029	59762964	18935
EUR_262	0	EUR	726	64857298	64922329	65031
EUR_262	0	EUR	726	72292367	72298050	5683
EUR_262	0	EUR	726	76966793	76969243	2450
EUR_262	0	EUR	726	80941681	81055112	113431
EUR_262	0	EUR	726	81107841	81229503	121662
EUR_262	0	EUR	726	87596442	87619926	23484
EUR_262	0	EUR	726	88357338	88363592	6254
EUR_262	0	EUR	726	88527647	88551173	23526
EUR_262	0	EUR	726	88609381	88682270	72889
EUR_262	0	EUR	726	89037057	89081743	44686
EUR_262	0	EUR	726	91891040	91902611	11571
EUR_262	0	EUR	726	94239181	94337048	97867
EUR_262	0	EUR	726	94348955	94351994	3039
EUR_262	0	EUR	726	95418231	95445533	27302
EUR_262	0	EUR	727	1229602	1329694	100092
EUR_262	0	EUR	727	3035366	3048937	13571
EUR_262	0	EUR	727	3963320	4017634	54314
EUR_262	0	EUR	727	8662954	8682424	19470
EUR_262	0	EUR	727	12804205	12847009	42804
EUR_262	0	EUR	727	13678075	13805391	127316
EUR_262	0	EUR	727	16234928	16286721	51793
EUR_262	0	EUR	727	17749730	17785756	36026
EUR_262	0	EUR	727	17918899	18041675	122776
EUR_262	0	EUR	727	18622886	18678327	55441
EUR_262	0	EUR	727	18787414	18806641	19227
EUR_262	0	EUR	727	23156936	23184805	27869
EUR_262	0	EUR	727	24045382	24166883	121501
EUR_262	0	EUR	727	24513193	24581630	68437
EUR_262	0	EUR	727	26473666	26489805	16139
EUR_262	0	EUR	727	27837565	27974945	137380
EUR_262	0	EUR	727	31103212	31138800	35588
EUR_262	0	EUR	727	31528053	31593163	65110
EUR_262	0	EUR	727	32824940	32871485	46545
EUR_262	0	EUR	727	36454307	36460007	5700
EUR_262	0	EUR	727	36663539	36678544	15005
EUR_262	0	EUR	727	37776227	37839133	62906
EUR_262	0	EUR	727	43359651	43413247	53596
EUR_262	0	EUR	727	43520906	43576329	55423
EUR_262	0	EUR	727	50086727	50097389	10662
EUR_262	0	EUR	727	50219290	50246703	27413
EUR_262	0	EUR	727	53821064	54035252	214188
EUR_262	0	EUR	727	54763523	54796245	32722
EUR_262	0	EUR	727	56433656	56480618	46962
EUR_262	0	EUR	727	57136159	57141457	5298
EUR_262	0	EUR	727	57188385	57251181	62796
EUR_262	0	EUR	727	64357594	64382745	25151
EUR_262	0	EUR	727	72961212	72970689	9477
EUR_262	0	EUR	727	77800262	77885640	85378
EUR_262	0	EUR	727	83886982	83921060	34078
EUR_262	0	EUR	727	87665598	87707527	41929
EUR_262	0	EUR	727	88212981	88333763	120782
EUR_262	0	EUR	727	88761110	88964672	203562
EUR_262	0	EUR	727	89356470	89389110	32640
EUR_262	0	EUR	727	89989980	89998439	8459
EUR_262	0	EUR	727	91891040	91902611	11571
EUR_262	0	EUR	727	93702886	93713967	11081
EUR_262	0	EUR	727	94915497	94930362	14865
EUR_262	0	EUR	727	96116814	96127414	10600
EUR_262	0	EUR	727	96229638	96264008	34370
EUR_263	0	EUR	728	1820511	1830270	9759
EUR_263	0	EUR	728	11703759	11708397	4638
EUR_263	0	EUR	728	14053026	14108442	55416
EUR_263	0	EUR	728	18310807	18352711	41904
EUR_263	0	EUR	728	21150173	21156082	5909
EUR_263	0	EUR	728	21200799	21216283	15484
EUR_263	0	EUR	728	22403197	22417821	14624
EUR_263	0	EUR	728	22454245	22572758	118513
EUR_263	0	EUR	728	23122511	23184805	62294
EUR_263	0	EUR	728	23752534	23770684	18150
EUR_263	0	EUR	728	24535579	24581630	46051
EUR_263	0	EUR	728	25140534	25305885	165351
EUR_263	0	EUR	728	28645700	28663032	17332
EUR_263	0	EUR	728	32824940	32871485	46545
EUR_263	0	EUR	728	35771774	35849669	77895
EUR_263	0	EUR	728	39821749	40071663	249914
EUR_263	0	EUR	728	40410992	40424856	13864
EUR_263	0	EUR	728	40572310	40602505	30195
EUR_263	0	EUR	728	40861764	41110725	248961
EUR_263	0	EUR	728	41319133	41347409	28276
EUR_263	0	EUR	728	53821064	54034568	213504
EUR_263	0	EUR	728	54060304	54076786	16482
EUR_263	0	EUR	728	57136159	57234981	98822
EUR_263	0	EUR	728	57248502	57291065	42563
EUR_263	0	EUR	728	58127732	58136140	8408
EUR_263	0	EUR	728	58608875	58694180	85305
EUR_263	0	EUR	728	59464397	59522281	57884
EUR_263	0	EUR	728	64496625	64519080	22455
EUR_263	0	EUR	728	73647366	73702901	55535
EUR_263	0	EUR	728	76502715	76594146	91431
EUR_263	0	EUR	728	86916801	86971491	54690
EUR_263	0	EUR	728	87369479	87389813	20334
EUR_263	0	EUR	728	87504329	87507341	3012
EUR_263	0	EUR	728	88219640	88301352	81712
EUR_263	0	EUR	728	88825376	88861101	35725
EUR_263	0	EUR	728	89356470	89465942	109472
EUR_263	0	EUR	728	92006288	92056341	50053
EUR_263	0	EUR	728	93553045	93713967	160922
EUR_263	0	EUR	728	94347488	94418018	70530
EUR_263	0	EUR	728	94419260	94510034	90774
EUR_263	0	EUR	729	2524858	2666717	141859
EUR_263	0	EUR	729	2984450	2997995	13545
EUR_263	0	EUR	729	8662954	8714283	51329
EUR_263	0	EUR	729	9235548	9270524	34976
EUR_263	0	EUR	729	11778115	11795837	17722
EUR_263	0	EUR	729	16235582	16286721	51139
EUR_263	0	EUR	729	16392437	16401162	8725
EUR_263	0	EUR	729	17918899	18041675	122776
EUR_263	0	EUR	729	18723172	18803498	80326
EUR_263	0	EUR	729	21150173	21156082	5909
EUR_263	0	EUR	729	21200799	21216283	15484
EUR_263	0	EUR	729	22968943	23113974	145031
EUR_263	0	EUR	729	23176150	23184805	8655
EUR_263	0	EUR	729	23432743	23471650	38907
EUR_263	0	EUR	729	24081636	24094707	13071
EUR_263	0	EUR	729	24175786	24211824	36038
EUR_263	0	EUR	729	25140534	25264496	123962
EUR_263	0	EUR	729	25356497	25501390	144893
EUR_263	0	EUR	729	26798389	26801347	2958
EUR_263	0	EUR	729	31087987	31109532	21545
EUR_263	0	EUR	729	32262916	32267787	4871
EUR_263	0	EUR	729	32844928	32871485	26557
EUR_263	0	EUR	729	33126757	33166924	40167
EUR_263	0	EUR	729	35887157	35892995	5838
EUR_263	0	EUR	729	41359664	41360462	798
EUR_263	0	EUR	729	52286725	52294766	8041
EUR_263	0	EUR	729	53821064	53859932	38868
EUR_263	0	EUR	729	53914494	54020486	105992
EUR_263	0	EUR	729	58863206	58863428	222
EUR_263	0	EUR	729	72359726	72373817	14091
EUR_263	0	EUR	729	73488506	73493479	4973
EUR_263	0	EUR	729	73645076	73702901	57825
EUR_263	0	EUR	729	73884457	73906350	21893
EUR_263	0	EUR	729	76365488	76399941	34453
EUR_263	0	EUR	729	79860282	79933512	73230
EUR_263	0	EUR	729	88126552	88236907	110355
EUR_263	0	EUR	729	88466364	88593512	127148
EUR_263	0	EUR	729	88761110	88767965	6855
EUR_263	0	EUR	729	88895018	89081743	186725
EUR_263	0	EUR	729	90471492	90558518	87026
EUR_263	0	EUR	729	92062604	92171686	109082
EUR_263	0	EUR	729	93361912	93411339	49427
EUR_263	0	EUR	729	93553045	93655077	102032
EUR_263	0	EUR	729	94006766	94031719	24953
EUR_263	0	EUR	729	94239181	94246409	7228
EUR_263	0	EUR	729	94473086	94544971	71885
EUR_263	0	EUR	729	95891667	95901699	10032
EUR_263	0	EUR	729	96229638	96241778	12140
EUR_264	0	EUR	730	387573	401572	13999
EUR_264	0	EUR	730	1330157	1385444	55287
EUR_264	0	EUR	730	2415974	2536319	120345
EUR_264	0	EUR	730	4020191	4069279	49088
EUR_264	0	EUR	730	11703759	11814111	110352
EUR_264	0	EUR	730	12764351	12780195	15844
EUR_264	0	EUR	730	16234928	16286721	51793
EUR_264	0	EUR	730	17749730	17822978	73248
EUR_264	0	EUR	730	17946005	17967105	21100
EUR_264	0	EUR	730	18100331	18140078	39747
EUR_264	0	EUR	730	18622886	18751123	128237
EUR_264	0	EUR	730	21246127	21282925	36798
EUR_264	0	EUR	730	23120612	23120638	26
EUR_264	0	EUR	730	23427310	23492190	64880
EUR_264	0	EUR	730	23721919	23725831	3912
EUR_264	0	EUR	730	24045382	24089668	44286
EUR_264	0	EUR	730	25867195	25904509	37314
EUR_264	0	EUR	730	26473666	26489805	16139
EUR_264	0	EUR	730	26860657	26889089	28432
EUR_264	0	EUR	730	27838823	27884833	46010
EUR_264	0	EUR	730	31087987	31151086	63099
EUR_264	0	EUR	730	40555384	40602505	47121
EUR_264	0	EUR	730	42525645	42532178	6533
EUR_264	0	EUR	730	53847831	53859932	12101
EUR_264	0	EUR	730	53876467	54035252	158785
EUR_264	0	EUR	730	57712252	57806900	94648
EUR_264	0	EUR	730	58863206	58863428	222
EUR_264	0	EUR	730	59554189	59607931	53742
EUR_264	0	EUR	730	59665101	59669529	4428
EUR_264	0	EUR	730	59744029	59762964	18935
EUR_264	0	EUR	730	69023918	69052189	28271
EUR_264	0	EUR	730	72964182	73031970	67788
EUR_264	0	EUR	730	73500653	73660589	159936
EUR_264	0	EUR	730	74092456	74139119	46663
EUR_264	0	EUR	730	76566986	76594146	27160
EUR_264	0	EUR	730	76804298	76855179	50881
EUR_264	0	EUR	730	76924252	76929274	5022
EUR_264	0	EUR	730	77733985	77735979	1994
EUR_264	0	EUR	730	81031954	81036282	4328
EUR_264	0	EUR	730	86916801	86926886	10085
EUR_264	0	EUR	730	87665598	87721794	56196
EUR_264	0	EUR	730	88292993	88319207	26214
EUR_264	0	EUR	730	88463687	88464514	827
EUR_264	0	EUR	730	88476761	88477220	459
EUR_264	0	EUR	730	88594414	88600577	6163
EUR_264	0	EUR	730	88776193	88859673	83480
EUR_264	0	EUR	730	89037057	89081743	44686
EUR_264	0	EUR	730	90086859	90239708	152849
EUR_264	0	EUR	730	90443917	90514932	71015
EUR_264	0	EUR	730	91074962	91097487	22525
EUR_264	0	EUR	730	92028660	92056341	27681
EUR_264	0	EUR	730	93326533	93369362	42829
EUR_264	0	EUR	730	93499176	93647010	147834
EUR_264	0	EUR	730	93908281	93925519	17238
EUR_264	0	EUR	730	94005320	94056780	51460
EUR_264	0	EUR	730	94297447	94418018	120571
EUR_264	0	EUR	730	94419260	94515224	95964
EUR_264	0	EUR	730	96116814	96140060	23246
EUR_264	0	EUR	731	340121	401572	61451
EUR_264	0	EUR	731	1330157	1334322	4165
EUR_264	0	EUR	731	8662954	8682424	19470
EUR_264	0	EUR	731	11731770	11814111	82341
EUR_264	0	EUR	731	13439477	13752578	313101
EUR_264	0	EUR	731	14051019	14108442	57423
EUR_264	0	EUR	731	17749730	17804155	54425
EUR_264	0	EUR	731	18020807	18041675	20868
EUR_264	0	EUR	731	18622886	18678327	55441
EUR_264	0	EUR	731	21150173	21156082	5909
EUR_264	0	EUR	731	21200799	21216283	15484
EUR_264	0	EUR	731	22320042	22417821	97779
EUR_264	0	EUR	731	22454245	22522556	68311
EUR_264	0	EUR	731	23648833	23651476	2643
EUR_264	0	EUR	731	24045382	24166883	121501
EUR_264	0	EUR	731	24528522	24581630	53108
EUR_264	0	EUR	731	25160112	25209294	49182
EUR_264	0	EUR	731	25285126	25305885	20759
EUR_264	0	EUR	731	26473666	26489805	16139
EUR_264	0	EUR	731	26860657	26889089	28432
EUR_264	0	EUR	731	27746608	27759553	12945
EUR_264	0	EUR	731	29373765	29390654	16889
EUR_264	0	EUR	731	31087987	31109532	21545
EUR_264	0	EUR	731	32731788	32870350	138562
EUR_264	0	EUR	731	39652652	39692065	39413
EUR_264	0	EUR	731	43359651	43413247	53596
EUR_264	0	EUR	731	49791142	49824337	33195
EUR_264	0	EUR	731	49888473	49899094	10621
EUR_264	0	EUR	731	54010807	54035252	24445
EUR_264	0	EUR	731	59064557	59245738	181181
EUR_264	0	EUR	731	59515765	59515940	175
EUR_264	0	EUR	731	63714218	63784151	69933
EUR_264	0	EUR	731	64338347	64382745	44398
EUR_264	0	EUR	731	69023918	69060887	36969
EUR_264	0	EUR	731	72292367	72298050	5683
EUR_264	0	EUR	731	73647366	73702901	55535
EUR_264	0	EUR	731	77716962	77775382	58420
EUR_264	0	EUR	731	77823655	77881732	58077
EUR_264	0	EUR	731	79082049	79134588	52539
EUR_264	0	EUR	731	79906665	79933512	26847
EUR_264	0	EUR	731	80946931	81087964	141033
EUR_264	0	EUR	731	81088612	81190655	102043
EUR_264	0	EUR	731	83955315	83957574	2259
EUR_264	0	EUR	731	87369479	87389813	20334
EUR_264	0	EUR	731	87969149	87990554	21405
EUR_264	0	EUR	731	88781320	88877947	96627
EUR_264	0	EUR	731	93553045	93567584	14539
EUR_264	0	EUR	731	94239181	94296489	57308
EUR_264	0	EUR	731	94447447	94476038	28591
EUR_265	0	EUR	732	3035366	3048937	13571
EUR_265	0	EUR	732	3963320	4017634	54314
EUR_265	0	EUR	732	8698156	8699527	1371
EUR_265	0	EUR	732	9235548	9270524	34976
EUR_265	0	EUR	732	20981647	20982609	962
EUR_265	0	EUR	732	24580740	24581630	890
EUR_265	0	EUR	732	24892444	24906091	13647
EUR_265	0	EUR	732	25343770	25501390	157620
EUR_265	0	EUR	732	25847649	25855304	7655
EUR_265	0	EUR	732	25950286	25987107	36821
EUR_265	0	EUR	732	26048379	26167295	118916
EUR_265	0	EUR	732	26886230	26991485	105255
EUR_265	0	EUR	732	27746608	27759553	12945
EUR_265	0	EUR	732	29306591	29347390	40799
EUR_265	0	EUR	732	29347606	29568048	220442
EUR_265	0	EUR	732	30904434	31040753	136319
EUR_265	0	EUR	732	32731788	32870350	138562
EUR_265	0	EUR	732	33316683	33429152	112469
EUR_265	0	EUR	732	35887157	35892995	5838
EUR_265	0	EUR	732	40410992	40426834	15842
EUR_265	0	EUR	732	40864889	40875488	10599
EUR_265	0	EUR	732	43359651	43413247	53596
EUR_265	0	EUR	732	51971549	52007205	35656
EUR_265	0	EUR	732	54010807	54035252	24445
EUR_265	0	EUR	732	59255178	59341956	86778
EUR_265	0	EUR	732	59514589	59522281	7692
EUR_265	0	EUR	732	59744029	59762964	18935
EUR_265	0	EUR	732	64439000	64519080	80080
EUR_265	0	EUR	732	72967423	73172795	205372
EUR_265	0	EUR	732	74633480	74654368	20888
EUR_265	0	EUR	732	76566986	76594146	27160
EUR_265	0	EUR	732	78263002	78301884	38882
EUR_265	0	EUR	732	79901897	79936163	34266
EUR_265	0	EUR	732	81113251	81189650	76399
EUR_265	0	EUR	732	83370620	83384810	14190
EUR_265	0	EUR	732	83955315	83957574	2259
EUR_265	0	EUR	732	84848072	84919115	71043
EUR_265	0	EUR	732	88126552	88319207	192655
EUR_265	0	EUR	732	88462576	88464514	1938
EUR_265	0	EUR	732	88476761	88537179	60418
EUR_265	0	EUR	732	89356470	89465942	109472
EUR_265	0	EUR	732	92062604	92171686	109082
EUR_265	0	EUR	732	93172929	93217584	44655
EUR_265	0	EUR	732	93553045	93660183	107138
EUR_265	0	EUR	732	94523809	94559172	35363
EUR_265	0	EUR	732	94697627	94701010	3383
EUR_265	0	EUR	732	96136238	96175807	39569
EUR_265	0	EUR	733	1330157	1385444	55287
EUR_265	0	EUR	733	4096776	4130169	33393
EUR_265	0	EUR	733	12764351	12785371	21020
EUR_265	0	EUR	733	18704683	18833631	128948
EUR_265	0	EUR	733	21150173	21156082	5909
EUR_265	0	EUR	733	21200799	21216283	15484
EUR_265	0	EUR	733	22412666	22417821	5155
EUR_265	0	EUR	733	22454245	22532371	78126
EUR_265	0	EUR	733	23176150	23184805	8655
EUR_265	0	EUR	733	23785514	23829976	44462
EUR_265	0	EUR	733	24045382	24166883	121501
EUR_265	0	EUR	733	25978368	25987107	8739
EUR_265	0	EUR	733	26403126	26429831	26705
EUR_265	0	EUR	733	28645700	28663032	17332
EUR_265	0	EUR	733	29321833	29348593	26760
EUR_265	0	EUR	733	31235544	31314394	78850
EUR_265	0	EUR	733	32824940	32871485	46545
EUR_265	0	EUR	733	35887157	35892995	5838
EUR_265	0	EUR	733	37809118	37815963	6845
EUR_265	0	EUR	733	39639062	39696725	57663
EUR_265	0	EUR	733	39838138	39895074	56936
EUR_265	0	EUR	733	40142452	40145306	2854
EUR_265	0	EUR	733	43359651	43398080	38429
EUR_265	0	EUR	733	43520906	43624720	103814
EUR_265	0	EUR	733	54324134	54407949	83815
EUR_265	0	EUR	733	54693132	54796245	103113
EUR_265	0	EUR	733	56378802	56448072	69270
EUR_265	0	EUR	733	57149895	57163941	14046
EUR_265	0	EUR	733	57712252	57768121	55869
EUR_265	0	EUR	733	69023918	69060887	36969
EUR_265	0	EUR	733	74669092	74670272	1180
EUR_265	0	EUR	733	74871541	74894548	23007
EUR_265	0	EUR	733	76631563	76641374	9811
EUR_265	0	EUR	733	79860282	79933512	73230
EUR_265	0	EUR	733	80852609	80890918	38309
EUR_265	0	EUR	733	81107841	81152495	44654
EUR_265	0	EUR	733	81161389	81229503	68114
EUR_265	0	EUR	733	84898186	84919115	20929
EUR_265	0	EUR	733	85353810	85485432	131622
EUR_265	0	EUR	733	88224553	88317076	92523
EUR_265	0	EUR	733	88388547	88425276	36729
EUR_265	0	EUR	733	88781860	88805716	23856
EUR_265	0	EUR	733	88876560	88983925	107365
EUR_265	0	EUR	733	89356470	89465942	109472
EUR_265	0	EUR	733	91018779	91107582	88803
EUR_265	0	EUR	733	93123848	93146996	23148
EUR_265	0	EUR	733	93499176	93623371	124195
EUR_265	0	EUR	733	93943380	94056780	113400
EUR_265	0	EUR	733	94246383	94246409	26
EUR_265	0	EUR	733	94447447	94522438	74991
EUR_266	0	EUR	734	1820511	1830270	9759
EUR_266	0	EUR	734	5018475	5041230	22755
EUR_266	0	EUR	734	11532006	11542173	10167
EUR_266	0	EUR	734	16234928	16286721	51793
EUR_266	0	EUR	734	18704683	18833631	128948
EUR_266	0	EUR	734	21150173	21156082	5909
EUR_266	0	EUR	734	21224963	21225412	449
EUR_266	0	EUR	734	23176150	23184805	8655
EUR_266	0	EUR	734	23752602	23856810	104208
EUR_266	0	EUR	734	25285126	25305885	20759
EUR_266	0	EUR	734	29306591	29478208	171617
EUR_266	0	EUR	734	31087987	31109532	21545
EUR_266	0	EUR	734	31528053	31593163	65110
EUR_266	0	EUR	734	40894823	41134712	239889
EUR_266	0	EUR	734	41161176	41163502	2326
EUR_266	0	EUR	734	42369514	42405338	35824
EUR_266	0	EUR	734	43359651	43376011	16360
EUR_266	0	EUR	734	52224085	52231250	7165
EUR_266	0	EUR	734	54037247	54070402	33155
EUR_266	0	EUR	734	54225259	54396948	171689
EUR_266	0	EUR	734	57188385	57259820	71435
EUR_266	0	EUR	734	57765480	57806900	41420
EUR_266	0	EUR	734	59064557	59245738	181181
EUR_266	0	EUR	734	63714218	63732455	18237
EUR_266	0	EUR	734	69023918	69038496	14578
EUR_266	0	EUR	734	69048774	69068474	19700
EUR_266	0	EUR	734	73488506	73491846	3340
EUR_266	0	EUR	734	73498527	73660589	162062
EUR_266	0	EUR	734	75263541	75282527	18986
EUR_266	0	EUR	734	78816419	78881412	64993
EUR_266	0	EUR	734	79082049	79134588	52539
EUR_266	0	EUR	734	80999290	81087964	88674
EUR_266	0	EUR	734	81229018	81229503	485
EUR_266	0	EUR	734	90159786	90243516	83730
EUR_266	0	EUR	734	91018779	91107582	88803
EUR_266	0	EUR	734	93702886	93713967	11081
EUR_266	0	EUR	734	94239181	94275395	36214
EUR_266	0	EUR	734	94793518	94886369	92851
EUR_266	0	EUR	734	99230141	99279146	49005
EUR_266	0	EUR	735	2524858	2666717	141859
EUR_266	0	EUR	735	2984450	2997995	13545
EUR_266	0	EUR	735	9417527	9439317	21790
EUR_266	0	EUR	735	11703759	11708397	4638
EUR_266	0	EUR	735	17749730	17804155	54425
EUR_266	0	EUR	735	21246127	21276019	29892
EUR_266	0	EUR	735	22462287	22608307	146020
EUR_266	0	EUR	735	24485266	24581630	96364
EUR_266	0	EUR	735	25343770	25501390	157620
EUR_266	0	EUR	735	27929422	27974945	45523
EUR_266	0	EUR	735	29444267	29483168	38901
EUR_266	0	EUR	735	31516087	31581077	64990
EUR_266	0	EUR	735	31609661	31636518	26857
EUR_266	0	EUR	735	32731788	32870350	138562
EUR_266	0	EUR	735	33238659	33281653	42994
EUR_266	0	EUR	735	42805387	42823699	18312
EUR_266	0	EUR	735	43359651	43376011	16360
EUR_266	0	EUR	735	52286725	52294766	8041
EUR_266	0	EUR	735	57249879	57262845	12966
EUR_266	0	EUR	735	64430635	64447663	17028
EUR_266	0	EUR	735	64496625	64519080	22455
EUR_266	0	EUR	735	69048774	69068474	19700
EUR_266	0	EUR	735	72292367	72298050	5683
EUR_266	0	EUR	735	75263541	75282527	18986
EUR_266	0	EUR	735	75522893	75529067	6174
EUR_266	0	EUR	735	76022322	76122979	100657
EUR_266	0	EUR	735	76365488	76370460	4972
EUR_266	0	EUR	735	76456850	76594146	137296
EUR_266	0	EUR	735	78246564	78301884	55320
EUR_266	0	EUR	735	79105993	79134588	28595
EUR_266	0	EUR	735	79860282	79933512	73230
EUR_266	0	EUR	735	83886982	83921060	34078
EUR_266	0	EUR	735	87533821	87546866	13045
EUR_266	0	EUR	735	88077880	88172209	94329
EUR_266	0	EUR	735	88212981	88333763	120782
EUR_266	0	EUR	735	88405406	88464514	59108
EUR_266	0	EUR	735	88476761	88537179	60418
EUR_266	0	EUR	735	88761110	88877947	116837
EUR_266	0	EUR	735	92062604	92171686	109082
EUR_266	0	EUR	735	94239181	94412962	173781
EUR_266	0	EUR	735	94480906	94515224	34318
EUR_266	0	EUR	735	99256882	99280798	23916
EUR_267	0	EUR	736	1330157	1385444	55287
EUR_267	0	EUR	736	9149188	9164904	15716
EUR_267	0	EUR	736	17749730	17804155	54425
EUR_267	0	EUR	736	22968943	23113974	145031
EUR_267	0	EUR	736	23176150	23184805	8655
EUR_267	0	EUR	736	23752602	23856810	104208
EUR_267	0	EUR	736	24081639	24081872	233
EUR_267	0	EUR	736	24485266	24581630	96364
EUR_267	0	EUR	736	24892444	24906091	13647
EUR_267	0	EUR	736	25554348	25609073	54725
EUR_267	0	EUR	736	26473666	26489805	16139
EUR_267	0	EUR	736	26860657	26889089	28432
EUR_267	0	EUR	736	27746608	27766580	19972
EUR_267	0	EUR	736	31003667	31127610	123943
EUR_267	0	EUR	736	40483863	40498219	14356
EUR_267	0	EUR	736	43520906	43525374	4468
EUR_267	0	EUR	736	43630936	43653793	22857
EUR_267	0	EUR	736	50097264	50097389	125
EUR_267	0	EUR	736	53966468	54020486	54018
EUR_267	0	EUR	736	54747772	54766545	18773
EUR_267	0	EUR	736	57254822	57262128	7306
EUR_267	0	EUR	736	58863206	58863428	222
EUR_267	0	EUR	736	59489915	59522281	32366
EUR_267	0	EUR	736	73673176	73690740	17564
EUR_267	0	EUR	736	76022322	76128798	106476
EUR_267	0	EUR	736	76365488	76399941	34453
EUR_267	0	EUR	736	77733985	77735979	1994
EUR_267	0	EUR	736	79901897	79903521	1624
EUR_267	0	EUR	736	79921893	79936163	14270
EUR_267	0	EUR	736	80454885	80489589	34704
EUR_267	0	EUR	736	88152919	88153791	872
EUR_267	0	EUR	736	88418285	88556342	138057
EUR_267	0	EUR	736	88821331	88877947	56616
EUR_267	0	EUR	736	91847626	91928674	81048
EUR_267	0	EUR	736	93123848	93146996	23148
EUR_267	0	EUR	736	93553045	93655077	102032
EUR_267	0	EUR	736	94319740	94358113	38373
EUR_267	0	EUR	736	94395991	94412962	16971
EUR_267	0	EUR	736	94473086	94544971	71885
EUR_267	0	EUR	737	2415974	2611568	195594
EUR_267	0	EUR	737	4020191	4044195	24004
EUR_267	0	EUR	737	8679492	8714283	34791
EUR_267	0	EUR	737	8783056	8849385	66329
EUR_267	0	EUR	737	13492976	13655815	162839
EUR_267	0	EUR	737	13656673	13678187	21514
EUR_267	0	EUR	737	17889447	17902017	12570
EUR_267	0	EUR	737	18081536	18107085	25549
EUR_267	0	EUR	737	21150173	21156082	5909
EUR_267	0	EUR	737	21200799	21216283	15484
EUR_267	0	EUR	737	22519633	22533171	13538
EUR_267	0	EUR	737	22992959	23024189	31230
EUR_267	0	EUR	737	23752602	23856810	104208
EUR_267	0	EUR	737	25140534	25305885	165351
EUR_267	0	EUR	737	27746608	27974945	228337
EUR_267	0	EUR	737	31087987	31151086	63099
EUR_267	0	EUR	737	33245767	33429152	183385
EUR_267	0	EUR	737	37837167	37861599	24432
EUR_267	0	EUR	737	40410992	40508892	97900
EUR_267	0	EUR	737	42525645	42558825	33180
EUR_267	0	EUR	737	43359651	43471816	112165
EUR_267	0	EUR	737	57136159	57253147	116988
EUR_267	0	EUR	737	57264407	57291065	26658
EUR_267	0	EUR	737	58863206	58863428	222
EUR_267	0	EUR	737	59064557	59245738	181181
EUR_267	0	EUR	737	68626746	68648432	21686
EUR_267	0	EUR	737	69023918	69056281	32363
EUR_267	0	EUR	737	71590090	71594997	4907
EUR_267	0	EUR	737	71722082	71732410	10328
EUR_267	0	EUR	737	74410856	74438736	27880
EUR_267	0	EUR	737	74871541	74894548	23007
EUR_267	0	EUR	737	76365488	76397099	31611
EUR_267	0	EUR	737	83886982	83921060	34078
EUR_267	0	EUR	737	84790760	84919115	128355
EUR_267	0	EUR	737	88152919	88153791	872
EUR_267	0	EUR	737	88418285	88762816	344531
EUR_267	0	EUR	737	89189593	89211291	21698
EUR_267	0	EUR	737	91026914	91107582	80668
EUR_267	0	EUR	737	92006288	92056341	50053
EUR_267	0	EUR	737	93553045	93682209	129164
EUR_267	0	EUR	737	93701190	93713967	12777
EUR_267	0	EUR	737	94034997	94105458	70461
EUR_267	0	EUR	737	95774147	95844558	70411
EUR_268	0	EUR	738	2415974	2666717	250743
EUR_268	0	EUR	738	2996253	2997995	1742
EUR_268	0	EUR	738	3963309	4000297	36988
EUR_268	0	EUR	738	5253381	5312534	59153
EUR_268	0	EUR	738	16319606	16401162	81556
EUR_268	0	EUR	738	16676133	16681323	5190
EUR_268	0	EUR	738	21150173	21156082	5909
EUR_268	0	EUR	738	21200799	21216283	15484
EUR_268	0	EUR	738	22519633	22533171	13538
EUR_268	0	EUR	738	22992959	23024189	31230
EUR_268	0	EUR	738	23432743	23471650	38907
EUR_268	0	EUR	738	24580740	24581630	890
EUR_268	0	EUR	738	25343770	25501390	157620
EUR_268	0	EUR	738	25867195	25987107	119912
EUR_268	0	EUR	738	29448880	29483168	34288
EUR_268	0	EUR	738	31233297	31263167	29870
EUR_268	0	EUR	738	31528053	31593163	65110
EUR_268	0	EUR	738	32262916	32267787	4871
EUR_268	0	EUR	738	32824940	32828620	3680
EUR_268	0	EUR	738	32858056	32870350	12294
EUR_268	0	EUR	738	33143811	33166924	23113
EUR_268	0	EUR	738	39639062	39696725	57663
EUR_268	0	EUR	738	39838138	39849671	11533
EUR_268	0	EUR	738	42493150	42550782	57632
EUR_268	0	EUR	738	43359651	43443877	84226
EUR_268	0	EUR	738	43444654	43453960	9306
EUR_268	0	EUR	738	49714605	49741250	26645
EUR_268	0	EUR	738	53821064	53848133	27069
EUR_268	0	EUR	738	53966468	54020486	54018
EUR_268	0	EUR	738	54503155	54794755	291600
EUR_268	0	EUR	738	57188385	57259820	71435
EUR_268	0	EUR	738	57765480	57806900	41420
EUR_268	0	EUR	738	59064557	59289101	224544
EUR_268	0	EUR	738	64338347	64347365	9018
EUR_268	0	EUR	738	72967423	73172795	205372
EUR_268	0	EUR	738	75110846	75133281	22435
EUR_268	0	EUR	738	76573565	76594146	20581
EUR_268	0	EUR	738	83370620	83384810	14190
EUR_268	0	EUR	738	83941668	83957574	15906
EUR_268	0	EUR	738	87665598	87696821	31223
EUR_268	0	EUR	738	88126552	88319207	192655
EUR_268	0	EUR	738	88761110	88877947	116837
EUR_268	0	EUR	738	89356470	89465942	109472
EUR_268	0	EUR	738	91552179	91564027	11848
EUR_268	0	EUR	738	91847626	91929323	81697
EUR_268	0	EUR	738	91987726	91991624	3898
EUR_268	0	EUR	738	94239181	94246784	7603
EUR_268	0	EUR	738	94347548	94544971	197423
EUR_268	0	EUR	738	94805865	94819760	13895
EUR_268	0	EUR	738	96136238	96175807	39569
EUR_268	0	EUR	738	99256882	99280798	23916
EUR_268	0	EUR	739	2560412	2702115	141703
EUR_268	0	EUR	739	9413335	9449917	36582
EUR_268	0	EUR	739	13076756	13125585	48829
EUR_268	0	EUR	739	16319606	16401162	81556
EUR_268	0	EUR	739	18100331	18140078	39747
EUR_268	0	EUR	739	24892444	24906091	13647
EUR_268	0	EUR	739	25179048	25305885	126837
EUR_268	0	EUR	739	25492458	25501390	8932
EUR_268	0	EUR	739	26886230	26960927	74697
EUR_268	0	EUR	739	27746608	27766580	19972
EUR_268	0	EUR	739	30904434	30925177	20743
EUR_268	0	EUR	739	32839324	32880042	40718
EUR_268	0	EUR	739	33316149	33336694	20545
EUR_268	0	EUR	739	36293685	36357016	63331
EUR_268	0	EUR	739	40944607	41024466	79859
EUR_268	0	EUR	739	41319133	41347409	28276
EUR_268	0	EUR	739	43359651	43449383	89732
EUR_268	0	EUR	739	54747772	54904011	156239
EUR_268	0	EUR	739	68626746	68648432	21686
EUR_268	0	EUR	739	72964182	73031970	67788
EUR_268	0	EUR	739	73500653	73660589	159936
EUR_268	0	EUR	739	74871541	74894548	23007
EUR_268	0	EUR	739	75263541	75282527	18986
EUR_268	0	EUR	739	78263002	78301884	38882
EUR_268	0	EUR	739	86916801	86926886	10085
EUR_268	0	EUR	739	88825376	89047979	222603
EUR_268	0	EUR	739	89084957	89107132	22175
EUR_268	0	EUR	739	91026914	91107582	80668
EUR_268	0	EUR	739	92022074	92044148	22074
EUR_268	0	EUR	739	93702886	93713967	11081
EUR_268	0	EUR	739	94297447	94325532	28085
EUR_268	0	EUR	739	94362487	94382190	19703
EUR_268	0	EUR	739	94410380	94412962	2582
EUR_268	0	EUR	739	94499209	94522438	23229
EUR_268	0	EUR	739	94532669	94544971	12302
EUR_268	0	EUR	739	99224465	99280798	56333
EUR_269	0	EUR	740	2484893	2702115	217222
EUR_269	0	EUR	740	2996253	2997995	1742
EUR_269	0	EUR	740	8662954	8682424	19470
EUR_269	0	EUR	740	12764351	12780195	15844
EUR_269	0	EUR	740	13621609	13626532	4923
EUR_269	0	EUR	740	21150173	21156082	5909
EUR_269	0	EUR	740	22447027	22448993	1966
EUR_269	0	EUR	740	22454245	22572758	118513
EUR_269	0	EUR	740	24045382	24065585	20203
EUR_269	0	EUR	740	24892444	24906091	13647
EUR_269	0	EUR	740	25356497	25501390	144893
EUR_269	0	EUR	740	25978368	25987107	8739
EUR_269	0	EUR	740	26798389	26801347	2958
EUR_269	0	EUR	740	26941352	26991485	50133
EUR_269	0	EUR	740	29306591	29347390	40799
EUR_269	0	EUR	740	29347606	29568048	220442
EUR_269	0	EUR	740	31087987	31131774	43787
EUR_269	0	EUR	740	37727611	37861599	133988
EUR_269	0	EUR	740	39951760	40129961	178201
EUR_269	0	EUR	740	40572310	40602505	30195
EUR_269	0	EUR	740	43520906	43525374	4468
EUR_269	0	EUR	740	59409355	59522281	112926
EUR_269	0	EUR	740	59744029	59762964	18935
EUR_269	0	EUR	740	64338347	64458245	119898
EUR_269	0	EUR	740	74871541	74894548	23007
EUR_269	0	EUR	740	77735282	77735979	697
EUR_269	0	EUR	740	79901897	79936163	34266
EUR_269	0	EUR	740	80520393	80530144	9751
EUR_269	0	EUR	740	80992031	81087964	95933
EUR_269	0	EUR	740	88761110	88877947	116837
EUR_269	0	EUR	740	90426720	90469639	42919
EUR_269	0	EUR	740	91847626	91875197	27571
EUR_269	0	EUR	740	94239181	94337048	97867
EUR_269	0	EUR	740	94348955	94385143	36188
EUR_269	0	EUR	740	94395991	94412962	16971
EUR_269	0	EUR	740	94473086	94544971	71885
EUR_269	0	EUR	740	95891667	95901699	10032
EUR_269	0	EUR	741	1330157	1385444	55287
EUR_269	0	EUR	741	8348919	8386102	37183
EUR_269	0	EUR	741	9414397	9449917	35520
EUR_269	0	EUR	741	16365017	16437214	72197
EUR_269	0	EUR	741	17749730	17804155	54425
EUR_269	0	EUR	741	18787414	18806641	19227
EUR_269	0	EUR	741	22519633	22533171	13538
EUR_269	0	EUR	741	22992959	23024189	31230
EUR_269	0	EUR	741	24045382	24166883	121501
EUR_269	0	EUR	741	24372241	24424495	52254
EUR_269	0	EUR	741	24516931	24581630	64699
EUR_269	0	EUR	741	25323974	25357719	33745
EUR_269	0	EUR	741	26049163	26195455	146292
EUR_269	0	EUR	741	27894016	27894364	348
EUR_269	0	EUR	741	29347606	29396432	48826
EUR_269	0	EUR	741	30904434	31040753	136319
EUR_269	0	EUR	741	31567042	31593163	26121
EUR_269	0	EUR	741	34845302	34926785	81483
EUR_269	0	EUR	741	37748178	37869194	121016
EUR_269	0	EUR	741	40410992	40421024	10032
EUR_269	0	EUR	741	43485261	43515922	30661
EUR_269	0	EUR	741	49791142	49864433	73291
EUR_269	0	EUR	741	53821064	54034568	213504
EUR_269	0	EUR	741	54060304	54076786	16482
EUR_269	0	EUR	741	57204714	57291065	86351
EUR_269	0	EUR	741	59464397	59469060	4663
EUR_269	0	EUR	741	72288615	72298050	9435
EUR_269	0	EUR	741	74092456	74139119	46663
EUR_269	0	EUR	741	81229018	81229503	485
EUR_269	0	EUR	741	83533777	83550130	16353
EUR_269	0	EUR	741	83554127	83592822	38695
EUR_269	0	EUR	741	87665598	87707527	41929
EUR_269	0	EUR	741	88212981	88333763	120782
EUR_269	0	EUR	741	88761110	88877947	116837
EUR_269	0	EUR	741	90769120	90852419	83299
EUR_269	0	EUR	741	94447447	94522438	74991
EUR_269	0	EUR	741	99230141	99250616	20475
EUR_270	0	EUR	742	343836	401572	57736
EUR_270	0	EUR	742	1322727	1329694	6967
EUR_270	0	EUR	742	2447654	2560700	113046
EUR_270	0	EUR	742	4004742	4069279	64537
EUR_270	0	EUR	742	5121074	5123781	2707
EUR_270	0	EUR	742	9235548	9308590	73042
EUR_270	0	EUR	742	9356784	9449917	93133
EUR_270	0	EUR	742	16243211	16367500	124289
EUR_270	0	EUR	742	16397154	16454511	57357
EUR_270	0	EUR	742	18100331	18140078	39747
EUR_270	0	EUR	742	18716646	18844474	127828
EUR_270	0	EUR	742	21246127	21282925	36798
EUR_270	0	EUR	742	22523307	22533171	9864
EUR_270	0	EUR	742	22993236	23082600	89364
EUR_270	0	EUR	742	23432743	23480035	47292
EUR_270	0	EUR	742	23648833	23651476	2643
EUR_270	0	EUR	742	23841523	23859762	18239
EUR_270	0	EUR	742	25323974	25378298	54324
EUR_270	0	EUR	742	27894016	27894364	348
EUR_270	0	EUR	742	31233297	31314394	81097
EUR_270	0	EUR	742	31528053	31593163	65110
EUR_270	0	EUR	742	32731788	32870350	138562
EUR_270	0	EUR	742	33298309	33324776	26467
EUR_270	0	EUR	742	34889103	34926785	37682
EUR_270	0	EUR	742	37722669	37749485	26816
EUR_270	0	EUR	742	37809118	37815963	6845
EUR_270	0	EUR	742	37855802	37890590	34788
EUR_270	0	EUR	742	39683574	39692065	8491
EUR_270	0	EUR	742	41359664	41360462	798
EUR_270	0	EUR	742	54037247	54070402	33155
EUR_270	0	EUR	742	54225259	54396948	171689
EUR_270	0	EUR	742	59064557	59245738	181181
EUR_270	0	EUR	742	64421884	64458245	36361
EUR_270	0	EUR	742	69023918	69060887	36969
EUR_270	0	EUR	742	71670386	71678663	8277
EUR_270	0	EUR	742	72395276	72398733	3457
EUR_270	0	EUR	742	72961212	72970689	9477
EUR_270	0	EUR	742	73488506	73491846	3340
EUR_270	0	EUR	742	73498527	73655419	156892
EUR_270	0	EUR	742	74410856	74438736	27880
EUR_270	0	EUR	742	74581736	74738891	157155
EUR_270	0	EUR	742	78872928	78886366	13438
EUR_270	0	EUR	742	83533777	83550130	16353
EUR_270	0	EUR	742	83554127	83592822	38695
EUR_270	0	EUR	742	85475176	85490844	15668
EUR_270	0	EUR	742	88126552	88319207	192655
EUR_270	0	EUR	742	88639661	88664918	25257
EUR_270	0	EUR	742	88761110	89009551	248441
EUR_270	0	EUR	742	90058636	90122299	63663
EUR_270	0	EUR	742	91987726	91991624	3898
EUR_270	0	EUR	742	93361912	93411339	49427
EUR_270	0	EUR	742	94489573	94510654	21081
EUR_270	0	EUR	742	94915497	94930362	14865
EUR_270	0	EUR	742	95774147	95774999	852
EUR_270	0	EUR	742	95898833	95901699	2866
EUR_270	0	EUR	742	96478106	96546756	68650
EUR_270	0	EUR	743	3963309	4000297	36988
EUR_270	0	EUR	743	11703759	11708397	4638
EUR_270	0	EUR	743	13538296	13635433	97137
EUR_270	0	EUR	743	13640984	13678187	37203
EUR_270	0	EUR	743	16235582	16286721	51139
EUR_270	0	EUR	743	18100331	18140078	39747
EUR_270	0	EUR	743	18716646	18844474	127828
EUR_270	0	EUR	743	21200799	21216283	15484
EUR_270	0	EUR	743	22519633	22533171	13538
EUR_270	0	EUR	743	23122511	23184805	62294
EUR_270	0	EUR	743	23752534	23770684	18150
EUR_270	0	EUR	743	23841523	23859612	18089
EUR_270	0	EUR	743	24045382	24089668	44286
EUR_270	0	EUR	743	26954022	26991485	37463
EUR_270	0	EUR	743	29306591	29365834	59243
EUR_270	0	EUR	743	31235544	31314394	78850
EUR_270	0	EUR	743	32081977	32141896	59919
EUR_270	0	EUR	743	32855612	32870350	14738
EUR_270	0	EUR	743	39686272	39696725	10453
EUR_270	0	EUR	743	39838138	39895074	56936
EUR_270	0	EUR	743	40049886	40068128	18242
EUR_270	0	EUR	743	43361285	43376011	14726
EUR_270	0	EUR	743	53821064	53848133	27069
EUR_270	0	EUR	743	53966468	54020486	54018
EUR_270	0	EUR	743	57289191	57291065	1874
EUR_270	0	EUR	743	57712252	57806028	93776
EUR_270	0	EUR	743	59409355	59522281	112926
EUR_270	0	EUR	743	59744029	59762964	18935
EUR_270	0	EUR	743	63714218	63732455	18237
EUR_270	0	EUR	743	64333373	64476517	143144
EUR_270	0	EUR	743	73039375	73140128	100753
EUR_270	0	EUR	743	74019705	74094072	74367
EUR_270	0	EUR	743	75263541	75282527	18986
EUR_270	0	EUR	743	76780192	76855179	74987
EUR_270	0	EUR	743	79901897	79936163	34266
EUR_270	0	EUR	743	88761110	88964672	203562
EUR_270	0	EUR	743	89356470	89389110	32640
EUR_270	0	EUR	743	89989980	89998439	8459
EUR_270	0	EUR	743	91891040	91902611	11571
EUR_270	0	EUR	743	93553045	93660183	107138
EUR_270	0	EUR	743	94262178	94325814	63636
EUR_270	0	EUR	743	94347548	94418018	70470
EUR_270	0	EUR	743	94419260	94510654	91394
EUR_270	0	EUR	743	94915497	94930362	14865
EUR_270	0	EUR	743	94962888	95011492	48604
EUR_270	0	EUR	743	96223843	96337375	113532
EUR_270	0	EUR	743	99230141	99250616	20475
EUR_271	0	EUR	744	1762556	1793930	31374
EUR_271	0	EUR	744	2415974	2536319	120345
EUR_271	0	EUR	744	2588056	2648359	60303
EUR_271	0	EUR	744	5121074	5123781	2707
EUR_271	0	EUR	744	12804205	12847009	42804
EUR_271	0	EUR	744	13621609	13626532	4923
EUR_271	0	EUR	744	14053026	14108442	55416
EUR_271	0	EUR	744	17687142	17689297	2155
EUR_271	0	EUR	744	18081536	18107085	25549
EUR_271	0	EUR	744	23721919	23725831	3912
EUR_271	0	EUR	744	24621120	24737906	116786
EUR_271	0	EUR	744	24809049	24863002	53953
EUR_271	0	EUR	744	25867195	25904509	37314
EUR_271	0	EUR	744	25978125	25987107	8982
EUR_271	0	EUR	744	27746608	27843271	96663
EUR_271	0	EUR	744	29373765	29390654	16889
EUR_271	0	EUR	744	30904434	31012627	108193
EUR_271	0	EUR	744	31073056	31127610	54554
EUR_271	0	EUR	744	31260922	31314394	53472
EUR_271	0	EUR	744	31505594	31636518	130924
EUR_271	0	EUR	744	32767431	32801316	33885
EUR_271	0	EUR	744	36454307	36460007	5700
EUR_271	0	EUR	744	37727611	37757885	30274
EUR_271	0	EUR	744	39664057	39692065	28008
EUR_271	0	EUR	744	40015733	40108006	92273
EUR_271	0	EUR	744	50097264	50097389	125
EUR_271	0	EUR	744	56442176	56448072	5896
EUR_271	0	EUR	744	59064557	59245738	181181
EUR_271	0	EUR	744	59554189	59607931	53742
EUR_271	0	EUR	744	63714218	63732455	18237
EUR_271	0	EUR	744	64857298	64922329	65031
EUR_271	0	EUR	744	71722082	71732410	10328
EUR_271	0	EUR	744	72160732	72205102	44370
EUR_271	0	EUR	744	72388504	72398733	10229
EUR_271	0	EUR	744	72964182	73035038	70856
EUR_271	0	EUR	744	74871541	74894548	23007
EUR_271	0	EUR	744	75263541	75282527	18986
EUR_271	0	EUR	744	79901897	79936163	34266
EUR_271	0	EUR	744	80852609	80881534	28925
EUR_271	0	EUR	744	81113251	81229503	116252
EUR_271	0	EUR	744	83370620	83384810	14190
EUR_271	0	EUR	744	87369479	87389813	20334
EUR_271	0	EUR	744	87504329	87507341	3012
EUR_271	0	EUR	744	88895018	88995554	100536
EUR_271	0	EUR	744	90153261	90208764	55503
EUR_271	0	EUR	744	90699420	90969654	270234
EUR_271	0	EUR	744	94297447	94418018	120571
EUR_271	0	EUR	744	94419260	94435095	15835
EUR_271	0	EUR	745	4105020	4130169	25149
EUR_271	0	EUR	745	11703759	11708397	4638
EUR_271	0	EUR	745	12764351	12785371	21020
EUR_271	0	EUR	745	13593425	13671934	78509
EUR_271	0	EUR	745	17889447	17902017	12570
EUR_271	0	EUR	745	18622886	18636940	14054
EUR_271	0	EUR	745	22397350	22417821	20471
EUR_271	0	EUR	745	22992959	23024189	31230
EUR_271	0	EUR	745	23752602	23752988	386
EUR_271	0	EUR	745	23785514	23829976	44462
EUR_271	0	EUR	745	24088240	24091227	2987
EUR_271	0	EUR	745	25867195	25904509	37314
EUR_271	0	EUR	745	25978125	25987107	8982
EUR_271	0	EUR	745	26351163	26436121	84958
EUR_271	0	EUR	745	32667412	32679016	11604
EUR_271	0	EUR	745	39639062	39696725	57663
EUR_271	0	EUR	745	39838138	39895074	56936
EUR_271	0	EUR	745	40049886	40068128	18242
EUR_271	0	EUR	745	40410992	40495016	84024
EUR_271	0	EUR	745	40572310	40602505	30195
EUR_271	0	EUR	745	52224085	52231250	7165
EUR_271	0	EUR	745	59481017	59515940	34923
EUR_271	0	EUR	745	74595799	74699907	104108
EUR_271	0	EUR	745	74871541	74894548	23007
EUR_271	0	EUR	745	76022322	76055308	32986
EUR_271	0	EUR	745	81031954	81036282	4328
EUR_271	0	EUR	745	83533777	83550130	16353
EUR_271	0	EUR	745	83554127	83592822	38695
EUR_271	0	EUR	745	88152919	88153791	872
EUR_271	0	EUR	745	88418285	88677239	258954
EUR_271	0	EUR	745	88761110	88877947	116837
EUR_271	0	EUR	745	91018779	91107582	88803
EUR_271	0	EUR	745	94347548	94418018	70470
EUR_271	0	EUR	745	94419260	94503617	84357
EUR_272	0	EUR	746	343836	401572	57736
EUR_272	0	EUR	746	1322727	1329694	6967
EUR_272	0	EUR	746	2447654	2560700	113046
EUR_272	0	EUR	746	4004742	4069279	64537
EUR_272	0	EUR	746	5121074	5123781	2707
EUR_272	0	EUR	746	9235548	9308590	73042
EUR_272	0	EUR	746	9356784	9449917	93133
EUR_272	0	EUR	746	13606916	13635433	28517
EUR_272	0	EUR	746	13640984	13678187	37203
EUR_272	0	EUR	746	16234928	16286721	51793
EUR_272	0	EUR	746	16670198	16681323	11125
EUR_272	0	EUR	746	18100331	18140078	39747
EUR_272	0	EUR	746	21200799	21216283	15484
EUR_272	0	EUR	746	22397350	22417821	20471
EUR_272	0	EUR	746	23120612	23120638	26
EUR_272	0	EUR	746	23427310	23492190	64880
EUR_272	0	EUR	746	23721919	23725831	3912
EUR_272	0	EUR	746	24535579	24581630	46051
EUR_272	0	EUR	746	24892444	24906091	13647
EUR_272	0	EUR	746	26068761	26195455	126694
EUR_272	0	EUR	746	29510693	29579668	68975
EUR_272	0	EUR	746	32262916	32267787	4871
EUR_272	0	EUR	746	32667412	32830147	162735
EUR_272	0	EUR	746	36663539	36674706	11167
EUR_272	0	EUR	746	37776227	37839133	62906
EUR_272	0	EUR	746	39838138	39849671	11533
EUR_272	0	EUR	746	40501323	40602505	101182
EUR_272	0	EUR	746	43359651	43369625	9974
EUR_272	0	EUR	746	53821064	53848039	26975
EUR_272	0	EUR	746	53849047	54035252	186205
EUR_272	0	EUR	746	56433656	56480618	46962
EUR_272	0	EUR	746	57857678	57861351	3673
EUR_272	0	EUR	746	59464397	59469060	4663
EUR_272	0	EUR	746	76365488	76399941	34453
EUR_272	0	EUR	746	76805591	76838106	32515
EUR_272	0	EUR	746	79086495	79134588	48093
EUR_272	0	EUR	746	81031954	81036282	4328
EUR_272	0	EUR	746	83533777	83550130	16353
EUR_272	0	EUR	746	83554127	83592822	38695
EUR_272	0	EUR	746	87369479	87389813	20334
EUR_272	0	EUR	746	87504329	87507341	3012
EUR_272	0	EUR	746	88405406	88464514	59108
EUR_272	0	EUR	746	90153261	90208764	55503
EUR_272	0	EUR	746	90699420	90969654	270234
EUR_272	0	EUR	746	91087654	91107582	19928
EUR_272	0	EUR	746	91891040	91902611	11571
EUR_272	0	EUR	746	93123848	93146996	23148
EUR_272	0	EUR	746	94297447	94418018	120571
EUR_272	0	EUR	746	94419260	94442951	23691
EUR_272	0	EUR	746	94528754	94530882	2128
EUR_272	0	EUR	746	95315455	95445533	130078
EUR_272	0	EUR	746	96144084	96201851	57767
EUR_272	0	EUR	746	96537974	96636521	98547
EUR_272	0	EUR	747	1330157	1349723	19566
EUR_272	0	EUR	747	2454787	2456835	2048
EUR_272	0	EUR	747	2489837	2702115	212278
EUR_272	0	EUR	747	4076140	4130169	54029
EUR_272	0	EUR	747	9413335	9449917	36582
EUR_272	0	EUR	747	17889447	17902017	12570
EUR_272	0	EUR	747	18100331	18140078	39747
EUR_272	0	EUR	747	18622886	18636940	14054
EUR_272	0	EUR	747	21032367	21145554	113187
EUR_272	0	EUR	747	22968943	23113974	145031
EUR_272	0	EUR	747	23176150	23184805	8655
EUR_272	0	EUR	747	23752602	23856810	104208
EUR_272	0	EUR	747	24081639	24081872	233
EUR_272	0	EUR	747	24485266	24581630	96364
EUR_272	0	EUR	747	26977884	26991485	13601
EUR_272	0	EUR	747	27894016	27894364	348
EUR_272	0	EUR	747	29352220	29396432	44212
EUR_272	0	EUR	747	31842746	31866371	23625
EUR_272	0	EUR	747	32057270	32084128	26858
EUR_272	0	EUR	747	33143811	33166924	23113
EUR_272	0	EUR	747	37722669	37749485	26816
EUR_272	0	EUR	747	37809118	37815963	6845
EUR_272	0	EUR	747	37855802	37881409	25607
EUR_272	0	EUR	747	38062578	38097333	34755
EUR_272	0	EUR	747	40047500	40068128	20628
EUR_272	0	EUR	747	42430229	42468277	38048
EUR_272	0	EUR	747	49714605	49741250	26645
EUR_272	0	EUR	747	54695493	54796245	100752
EUR_272	0	EUR	747	57857678	57861351	3673
EUR_272	0	EUR	747	63714218	63784151	69933
EUR_272	0	EUR	747	64338347	64382745	44398
EUR_272	0	EUR	747	72160732	72205102	44370
EUR_272	0	EUR	747	72388504	72398733	10229
EUR_272	0	EUR	747	72964182	73035038	70856
EUR_272	0	EUR	747	74871541	74894548	23007
EUR_272	0	EUR	747	75263541	75282527	18986
EUR_272	0	EUR	747	77733985	77735979	1994
EUR_272	0	EUR	747	78839770	78881412	41642
EUR_272	0	EUR	747	79860282	79894254	33972
EUR_272	0	EUR	747	80946931	81087964	141033
EUR_272	0	EUR	747	81088612	81190655	102043
EUR_272	0	EUR	747	83886982	83921060	34078
EUR_272	0	EUR	747	87665598	87707527	41929
EUR_272	0	EUR	747	88258345	88319207	60862
EUR_272	0	EUR	747	88527647	88554847	27200
EUR_272	0	EUR	747	88895018	89081743	186725
EUR_272	0	EUR	747	89455722	89465942	10220
EUR_272	0	EUR	747	89989980	89998439	8459
EUR_272	0	EUR	747	91087654	91107582	19928
EUR_272	0	EUR	747	91891040	91902611	11571
EUR_272	0	EUR	747	93470832	93517093	46261
EUR_272	0	EUR	747	94239181	94276840	37659
EUR_272	0	EUR	747	96116814	96299057	182243
EUR_272	0	EUR	747	99238892	99250616	11724
EUR_273	0	EUR	748	1330157	1385444	55287
EUR_273	0	EUR	748	4096776	4130169	33393
EUR_273	0	EUR	748	12764351	12785371	21020
EUR_273	0	EUR	748	20981647	21202559	220912
EUR_273	0	EUR	748	21310174	21428203	118029
EUR_273	0	EUR	748	22403197	22417821	14624
EUR_273	0	EUR	748	22454245	22572758	118513
EUR_273	0	EUR	748	25179048	25305885	126837
EUR_273	0	EUR	748	25492458	25501390	8932
EUR_273	0	EUR	748	25950286	25987107	36821
EUR_273	0	EUR	748	26048379	26136042	87663
EUR_273	0	EUR	748	26351163	26436121	84958
EUR_273	0	EUR	748	26949707	26991485	41778
EUR_273	0	EUR	748	29373765	29390654	16889
EUR_273	0	EUR	748	31235544	31314394	78850
EUR_273	0	EUR	748	32431231	32446630	15399
EUR_273	0	EUR	748	32824940	32871485	46545
EUR_273	0	EUR	748	35091612	35095643	4031
EUR_273	0	EUR	748	39951760	40129961	178201
EUR_273	0	EUR	748	40572310	40602505	30195
EUR_273	0	EUR	748	41319133	41360462	41329
EUR_273	0	EUR	748	49714605	49791673	77068
EUR_273	0	EUR	748	53828789	53848133	19344
EUR_273	0	EUR	748	53908164	53911210	3046
EUR_273	0	EUR	748	54695493	54796245	100752
EUR_273	0	EUR	748	57136159	57141457	5298
EUR_273	0	EUR	748	57188385	57251181	62796
EUR_273	0	EUR	748	59064557	59245738	181181
EUR_273	0	EUR	748	64338347	64382745	44398
EUR_273	0	EUR	748	68626746	68648432	21686
EUR_273	0	EUR	748	72964182	73132219	168037
EUR_273	0	EUR	748	78816419	78881412	64993
EUR_273	0	EUR	748	79860282	79933512	73230
EUR_273	0	EUR	748	87596442	87619926	23484
EUR_273	0	EUR	748	88357338	88363592	6254
EUR_273	0	EUR	748	88527647	88551173	23526
EUR_273	0	EUR	748	88609381	88682270	72889
EUR_273	0	EUR	748	88781860	88877947	96087
EUR_273	0	EUR	748	90159786	90243516	83730
EUR_273	0	EUR	748	92153800	92171686	17886
EUR_273	0	EUR	748	93519909	93647010	127101
EUR_273	0	EUR	748	94240024	94317758	77734
EUR_273	0	EUR	748	94338811	94418018	79207
EUR_273	0	EUR	748	94419260	94510654	91394
EUR_273	0	EUR	748	96116814	96220219	103405
EUR_273	0	EUR	749	2524858	2666717	141859
EUR_273	0	EUR	749	5121074	5123781	2707
EUR_273	0	EUR	749	23432743	23480035	47292
EUR_273	0	EUR	749	23648833	23651476	2643
EUR_273	0	EUR	749	23841523	23859762	18239
EUR_273	0	EUR	749	25953989	25987107	33118
EUR_273	0	EUR	749	29444267	29483168	38901
EUR_273	0	EUR	749	31087987	31151086	63099
EUR_273	0	EUR	749	32731788	32880042	148254
EUR_273	0	EUR	749	38075148	38097333	22185
EUR_273	0	EUR	749	40410992	40508892	97900
EUR_273	0	EUR	749	41359664	41360462	798
EUR_273	0	EUR	749	49714605	49741250	26645
EUR_273	0	EUR	749	52286725	52294766	8041
EUR_273	0	EUR	749	54503155	54701593	198438
EUR_273	0	EUR	749	57857678	57861351	3673
EUR_273	0	EUR	749	63714218	63784151	69933
EUR_273	0	EUR	749	64338347	64382745	44398
EUR_273	0	EUR	749	73498527	73536154	37627
EUR_273	0	EUR	749	74871541	74894548	23007
EUR_273	0	EUR	749	75263541	75282527	18986
EUR_273	0	EUR	749	76365488	76395555	30067
EUR_273	0	EUR	749	81031954	81036282	4328
EUR_273	0	EUR	749	81113251	81229503	116252
EUR_273	0	EUR	749	83886982	83921060	34078
EUR_273	0	EUR	749	92062604	92171686	109082
EUR_273	0	EUR	749	93553045	93567584	14539
EUR_273	0	EUR	749	94252798	94337048	84250
EUR_273	0	EUR	749	94348955	94476389	127434
EUR_273	0	EUR	749	96537974	96636521	98547
EUR_274	0	EUR	750	2695536	2854362	158826
EUR_274	0	EUR	750	4020191	4069279	49088
EUR_274	0	EUR	750	11703759	11708397	4638
EUR_274	0	EUR	750	16234928	16286721	51793
EUR_274	0	EUR	750	17687142	17689297	2155
EUR_274	0	EUR	750	18100331	18140078	39747
EUR_274	0	EUR	750	18704683	18833631	128948
EUR_274	0	EUR	750	21124075	21202559	78484
EUR_274	0	EUR	750	21310174	21428203	118029
EUR_274	0	EUR	750	22529964	22533171	3207
EUR_274	0	EUR	750	23432743	23480035	47292
EUR_274	0	EUR	750	23784279	23797839	13560
EUR_274	0	EUR	750	23812752	23877108	64356
EUR_274	0	EUR	750	24045382	24089668	44286
EUR_274	0	EUR	750	24372241	24424495	52254
EUR_274	0	EUR	750	24516931	24581630	64699
EUR_274	0	EUR	750	24892444	24906091	13647
EUR_274	0	EUR	750	25323974	25378298	54324
EUR_274	0	EUR	750	27746608	27884833	138225
EUR_274	0	EUR	750	28668804	28692721	23917
EUR_274	0	EUR	750	29347606	29396432	48826
EUR_274	0	EUR	750	31233297	31314394	81097
EUR_274	0	EUR	750	32039879	32057645	17766
EUR_274	0	EUR	750	32804778	32880042	75264
EUR_274	0	EUR	750	36293685	36357016	63331
EUR_274	0	EUR	750	37885686	37943125	57439
EUR_274	0	EUR	750	40861764	40915899	54135
EUR_274	0	EUR	750	43359651	43453960	94309
EUR_274	0	EUR	750	49791142	49824337	33195
EUR_274	0	EUR	750	49888473	49899094	10621
EUR_274	0	EUR	750	53847831	53859932	12101
EUR_274	0	EUR	750	54123719	54150257	26538
EUR_274	0	EUR	750	54403505	54431022	27517
EUR_274	0	EUR	750	54686744	54688209	1465
EUR_274	0	EUR	750	54714203	54904011	189808
EUR_274	0	EUR	750	57188385	57262845	74460
EUR_274	0	EUR	750	58863206	58863428	222
EUR_274	0	EUR	750	71722082	71732410	10328
EUR_274	0	EUR	750	72160732	72205102	44370
EUR_274	0	EUR	750	72388504	72398733	10229
EUR_274	0	EUR	750	72964182	73035038	70856
EUR_274	0	EUR	750	74871541	74894548	23007
EUR_274	0	EUR	750	75263541	75282527	18986
EUR_274	0	EUR	750	76365488	76395555	30067
EUR_274	0	EUR	750	80161288	80278256	116968
EUR_274	0	EUR	750	81113251	81229503	116252
EUR_274	0	EUR	750	83955315	83957574	2259
EUR_274	0	EUR	750	87369479	87389813	20334
EUR_274	0	EUR	750	87504329	87507341	3012
EUR_274	0	EUR	750	88239735	88300295	60560
EUR_274	0	EUR	750	88324698	88371433	46735
EUR_274	0	EUR	750	88761110	88766124	5014
EUR_274	0	EUR	750	89037057	89081743	44686
EUR_274	0	EUR	750	90086859	90239708	152849
EUR_274	0	EUR	750	90443917	90514932	71015
EUR_274	0	EUR	750	91074962	91097487	22525
EUR_274	0	EUR	750	92028660	92056341	27681
EUR_274	0	EUR	750	93326533	93369362	42829
EUR_274	0	EUR	750	93499176	93647010	147834
EUR_274	0	EUR	750	93908281	93925519	17238
EUR_274	0	EUR	750	94005320	94056780	51460
EUR_274	0	EUR	750	94297447	94418018	120571
EUR_274	0	EUR	750	94419260	94515224	95964
EUR_274	0	EUR	750	96116814	96140060	23246
EUR_274	0	EUR	751	2415974	2702115	286141
EUR_274	0	EUR	751	2996253	2997995	1742
EUR_274	0	EUR	751	9321331	9384265	62934
EUR_274	0	EUR	751	9431845	9449917	18072
EUR_274	0	EUR	751	14051019	14099119	48100
EUR_274	0	EUR	751	16286156	16286721	565
EUR_274	0	EUR	751	16676133	16681323	5190
EUR_274	0	EUR	751	18721159	18751123	29964
EUR_274	0	EUR	751	23176150	23184805	8655
EUR_274	0	EUR	751	23432743	23471650	38907
EUR_274	0	EUR	751	23752602	23789573	36971
EUR_274	0	EUR	751	24372241	24424495	52254
EUR_274	0	EUR	751	24516931	24581630	64699
EUR_274	0	EUR	751	25953989	25987107	33118
EUR_274	0	EUR	751	26319359	26320890	1531
EUR_274	0	EUR	751	26473666	26491352	17686
EUR_274	0	EUR	751	26886230	26972181	85951
EUR_274	0	EUR	751	29444267	29483168	38901
EUR_274	0	EUR	751	30904434	31040753	136319
EUR_274	0	EUR	751	32731788	32870350	138562
EUR_274	0	EUR	751	33316683	33429152	112469
EUR_274	0	EUR	751	37776227	37839133	62906
EUR_274	0	EUR	751	43432372	43453960	21588
EUR_274	0	EUR	751	49741621	49846762	105141
EUR_274	0	EUR	751	50053800	50097389	43589
EUR_274	0	EUR	751	53847831	53859932	12101
EUR_274	0	EUR	751	53956971	54035252	78281
EUR_274	0	EUR	751	58569405	58694180	124775
EUR_274	0	EUR	751	59553546	59700527	146981
EUR_274	0	EUR	751	64338347	64519080	180733
EUR_274	0	EUR	751	73519049	73587814	68765
EUR_274	0	EUR	751	76566986	76594146	27160
EUR_274	0	EUR	751	77880564	77881732	1168
EUR_274	0	EUR	751	86916801	86926886	10085
EUR_274	0	EUR	751	87504329	87507341	3012
EUR_274	0	EUR	751	87760040	87858554	98514
EUR_274	0	EUR	751	88405406	88464514	59108
EUR_274	0	EUR	751	88612163	88762816	150653
EUR_274	0	EUR	751	88818076	88936674	118598
EUR_274	0	EUR	751	89037352	89235318	197966
EUR_274	0	EUR	751	90153798	90243516	89718
EUR_274	0	EUR	751	90443917	90558518	114601
EUR_274	0	EUR	751	93553045	93607994	54949
EUR_274	0	EUR	751	93630747	93713967	83220
EUR_274	0	EUR	751	94915497	94930362	14865
EUR_275	0	EUR	752	2898490	2998355	99865
EUR_275	0	EUR	752	4020191	4044195	24004
EUR_275	0	EUR	752	11703759	11708397	4638
EUR_275	0	EUR	752	12764351	12845452	81101
EUR_275	0	EUR	752	13558933	13585616	26683
EUR_275	0	EUR	752	22462287	22608307	146020
EUR_275	0	EUR	752	22890136	22914121	23985
EUR_275	0	EUR	752	23138000	23184805	46805
EUR_275	0	EUR	752	23648833	23651476	2643
EUR_275	0	EUR	752	24580740	24581630	890
EUR_275	0	EUR	752	24892444	24906091	13647
EUR_275	0	EUR	752	25343770	25501390	157620
EUR_275	0	EUR	752	25817587	25896396	78809
EUR_275	0	EUR	752	26798389	26801347	2958
EUR_275	0	EUR	752	26941352	26991485	50133
EUR_275	0	EUR	752	28645700	28663032	17332
EUR_275	0	EUR	752	32293660	32336893	43233
EUR_275	0	EUR	752	32767431	32834769	67338
EUR_275	0	EUR	752	33298309	33336694	38385
EUR_275	0	EUR	752	40410992	40495016	84024
EUR_275	0	EUR	752	59064557	59522281	457724
EUR_275	0	EUR	752	68626746	68648432	21686
EUR_275	0	EUR	752	74700049	74701524	1475
EUR_275	0	EUR	752	74871541	74890086	18545
EUR_275	0	EUR	752	76022322	76042609	20287
EUR_275	0	EUR	752	79860282	79933512	73230
EUR_275	0	EUR	752	80852609	80890918	38309
EUR_275	0	EUR	752	81107841	81158002	50161
EUR_275	0	EUR	752	87969149	87990554	21405
EUR_275	0	EUR	752	88200401	88319207	118806
EUR_275	0	EUR	752	88527647	88551173	23526
EUR_275	0	EUR	752	88609381	88682270	72889
EUR_275	0	EUR	752	88776193	88877947	101754
EUR_275	0	EUR	752	89455722	89465942	10220
EUR_275	0	EUR	752	90115145	90182923	67778
EUR_275	0	EUR	752	91018779	91107582	88803
EUR_275	0	EUR	752	94297447	94325532	28085
EUR_275	0	EUR	752	94362487	94382190	19703
EUR_275	0	EUR	752	94410380	94412962	2582
EUR_275	0	EUR	752	94499209	94522438	23229
EUR_275	0	EUR	752	94532669	94544971	12302
EUR_275	0	EUR	752	96116814	96217388	100574
EUR_275	0	EUR	753	2415974	2702115	286141
EUR_275	0	EUR	753	2996253	2997995	1742
EUR_275	0	EUR	753	9414397	9443621	29224
EUR_275	0	EUR	753	11703759	11708397	4638
EUR_275	0	EUR	753	12764351	12785371	21020
EUR_275	0	EUR	753	17749730	17785756	36026
EUR_275	0	EUR	753	17918899	18041675	122776
EUR_275	0	EUR	753	22968943	23113974	145031
EUR_275	0	EUR	753	23176150	23184805	8655
EUR_275	0	EUR	753	23752602	23856810	104208
EUR_275	0	EUR	753	24081639	24081872	233
EUR_275	0	EUR	753	24485266	24581630	96364
EUR_275	0	EUR	753	24892444	24906091	13647
EUR_275	0	EUR	753	25554348	25609073	54725
EUR_275	0	EUR	753	26473666	26489805	16139
EUR_275	0	EUR	753	26860657	26889089	28432
EUR_275	0	EUR	753	27746608	27766580	19972
EUR_275	0	EUR	753	31003667	31127610	123943
EUR_275	0	EUR	753	32874517	32880042	5525
EUR_275	0	EUR	753	34136759	34142302	5543
EUR_275	0	EUR	753	40410992	40424856	13864
EUR_275	0	EUR	753	42430229	42456760	26531
EUR_275	0	EUR	753	49714605	49741250	26645
EUR_275	0	EUR	753	52286725	52294766	8041
EUR_275	0	EUR	753	54113043	54132044	19001
EUR_275	0	EUR	753	54403505	54460909	57404
EUR_275	0	EUR	753	54485671	54645939	160268
EUR_275	0	EUR	753	57188385	57259820	71435
EUR_275	0	EUR	753	57765480	57806900	41420
EUR_275	0	EUR	753	58093392	58136140	42748
EUR_275	0	EUR	753	64496625	64519080	22455
EUR_275	0	EUR	753	69023918	69060887	36969
EUR_275	0	EUR	753	73628865	73634178	5313
EUR_275	0	EUR	753	78255010	78301884	46874
EUR_275	0	EUR	753	78831605	78886366	54761
EUR_275	0	EUR	753	79901897	79903521	1624
EUR_275	0	EUR	753	79921893	79936163	14270
EUR_275	0	EUR	753	83370620	83384810	14190
EUR_275	0	EUR	753	87536687	87623148	86461
EUR_275	0	EUR	753	88258345	88319207	60862
EUR_275	0	EUR	753	88895018	89081743	186725
EUR_275	0	EUR	753	90153261	90211457	58196
EUR_275	0	EUR	753	91891040	91902611	11571
EUR_275	0	EUR	753	93361912	93411339	49427
EUR_275	0	EUR	753	93666700	93713967	47267
EUR_275	0	EUR	753	94006766	94031719	24953
EUR_275	0	EUR	753	94239181	94246409	7228
EUR_275	0	EUR	753	94447447	94522438	74991
EUR_275	0	EUR	753	96116814	96217388	100574
EUR_276	0	EUR	754	1330157	1336755	6598
EUR_276	0	EUR	754	2415974	2702115	286141
EUR_276	0	EUR	754	2947381	3048937	101556
EUR_276	0	EUR	754	3963320	4017634	54314
EUR_276	0	EUR	754	5121074	5123781	2707
EUR_276	0	EUR	754	9235548	9308590	73042
EUR_276	0	EUR	754	9356784	9365876	9092
EUR_276	0	EUR	754	12804205	12847009	42804
EUR_276	0	EUR	754	13621609	13626532	4923
EUR_276	0	EUR	754	16319606	16401162	81556
EUR_276	0	EUR	754	18310807	18352711	41904
EUR_276	0	EUR	754	21150173	21156082	5909
EUR_276	0	EUR	754	21200799	21216283	15484
EUR_276	0	EUR	754	22519633	22533171	13538
EUR_276	0	EUR	754	22992959	23024189	31230
EUR_276	0	EUR	754	23432743	23471650	38907
EUR_276	0	EUR	754	24580740	24581630	890
EUR_276	0	EUR	754	24809049	24866754	57705
EUR_276	0	EUR	754	25817587	25896396	78809
EUR_276	0	EUR	754	27837565	27974945	137380
EUR_276	0	EUR	754	30904434	31092945	188511
EUR_276	0	EUR	754	32057270	32141896	84626
EUR_276	0	EUR	754	32824940	32871485	46545
EUR_276	0	EUR	754	36454307	36460007	5700
EUR_276	0	EUR	754	36663539	36678544	15005
EUR_276	0	EUR	754	37776227	37839133	62906
EUR_276	0	EUR	754	43359651	43413247	53596
EUR_276	0	EUR	754	43520906	43576329	55423
EUR_276	0	EUR	754	54680860	54904011	223151
EUR_276	0	EUR	754	57857678	57861351	3673
EUR_276	0	EUR	754	59064557	59245738	181181
EUR_276	0	EUR	754	59464397	59522281	57884
EUR_276	0	EUR	754	73628865	73634178	5313
EUR_276	0	EUR	754	74595799	74699907	104108
EUR_276	0	EUR	754	76780192	76855179	74987
EUR_276	0	EUR	754	79901897	79903521	1624
EUR_276	0	EUR	754	79921893	79936163	14270
EUR_276	0	EUR	754	83886982	83921060	34078
EUR_276	0	EUR	754	85353810	85452441	98631
EUR_276	0	EUR	754	87369479	87389813	20334
EUR_276	0	EUR	754	87504329	87507341	3012
EUR_276	0	EUR	754	88405406	88464514	59108
EUR_276	0	EUR	754	93553045	93713967	160922
EUR_276	0	EUR	754	94208817	94313443	104626
EUR_276	0	EUR	754	94595895	94701010	105115
EUR_276	0	EUR	755	13492976	13655815	162839
EUR_276	0	EUR	755	13656673	13678187	21514
EUR_276	0	EUR	755	22557088	22590466	33378
EUR_276	0	EUR	755	23120612	23120638	26
EUR_276	0	EUR	755	24045382	24089668	44286
EUR_276	0	EUR	755	24372241	24424495	52254
EUR_276	0	EUR	755	25231699	25305885	74186
EUR_276	0	EUR	755	26477051	26562248	85197
EUR_276	0	EUR	755	29306591	29365834	59243
EUR_276	0	EUR	755	31087987	31109532	21545
EUR_276	0	EUR	755	31528053	31593163	65110
EUR_276	0	EUR	755	32831638	32871485	39847
EUR_276	0	EUR	755	33126757	33166924	40167
EUR_276	0	EUR	755	34880550	34926785	46235
EUR_276	0	EUR	755	42430229	42456760	26531
EUR_276	0	EUR	755	53821064	53848133	27069
EUR_276	0	EUR	755	53966468	54020486	54018
EUR_276	0	EUR	755	56378802	56448072	69270
EUR_276	0	EUR	755	59064557	59245738	181181
EUR_276	0	EUR	755	59744029	59762964	18935
EUR_276	0	EUR	755	69048774	69068474	19700
EUR_276	0	EUR	755	72257616	72314514	56898
EUR_276	0	EUR	755	74710986	74738891	27905
EUR_276	0	EUR	755	74889460	74894548	5088
EUR_276	0	EUR	755	76558352	76641374	83022
EUR_276	0	EUR	755	77823655	77885640	61985
EUR_276	0	EUR	755	80999290	81087964	88674
EUR_276	0	EUR	755	81229018	81229503	485
EUR_276	0	EUR	755	87075746	87077051	1305
EUR_276	0	EUR	755	87665598	87696821	31223
EUR_276	0	EUR	755	88459902	88558762	98860
EUR_276	0	EUR	755	88776193	88877947	101754
EUR_276	0	EUR	755	91847626	91875197	27571
EUR_276	0	EUR	755	92062604	92171686	109082
EUR_276	0	EUR	755	93123848	93146996	23148
EUR_276	0	EUR	755	93800814	93864866	64052
EUR_276	0	EUR	755	94239181	94337048	97867
EUR_276	0	EUR	755	94348955	94544971	196016
EUR_276	0	EUR	755	99256882	99280798	23916
EUR_277	0	EUR	756	2415974	2536319	120345
EUR_277	0	EUR	756	2987403	2997995	10592
EUR_277	0	EUR	756	5121074	5123781	2707
EUR_277	0	EUR	756	9235548	9308590	73042
EUR_277	0	EUR	756	9356784	9449917	93133
EUR_277	0	EUR	756	16319606	16401162	81556
EUR_277	0	EUR	756	16676133	16681323	5190
EUR_277	0	EUR	756	17918899	18041675	122776
EUR_277	0	EUR	756	18723172	18844474	121302
EUR_277	0	EUR	756	21246127	21282925	36798
EUR_277	0	EUR	756	22279659	22313169	33510
EUR_277	0	EUR	756	22456611	22462305	5694
EUR_277	0	EUR	756	24045382	24166883	121501
EUR_277	0	EUR	756	24372241	24424495	52254
EUR_277	0	EUR	756	24516931	24581630	64699
EUR_277	0	EUR	756	24892444	24906091	13647
EUR_277	0	EUR	756	29306591	29478208	171617
EUR_277	0	EUR	756	32057270	32141896	84626
EUR_277	0	EUR	756	32824940	32871485	46545
EUR_277	0	EUR	756	36350791	36408555	57764
EUR_277	0	EUR	756	37815968	37906769	90801
EUR_277	0	EUR	756	53961646	54076786	115140
EUR_277	0	EUR	756	59617240	59663042	45802
EUR_277	0	EUR	756	63714218	63732455	18237
EUR_277	0	EUR	756	64857298	64922329	65031
EUR_277	0	EUR	756	69023918	69060887	36969
EUR_277	0	EUR	756	72964182	73031970	67788
EUR_277	0	EUR	756	74889460	74894548	5088
EUR_277	0	EUR	756	76022322	76055308	32986
EUR_277	0	EUR	756	83533777	83550130	16353
EUR_277	0	EUR	756	83554127	83592822	38695
EUR_277	0	EUR	756	85353810	85485432	131622
EUR_277	0	EUR	756	87075746	87077051	1305
EUR_277	0	EUR	756	88291179	88319207	28028
EUR_277	0	EUR	756	88463687	88464514	827
EUR_277	0	EUR	756	88476761	88477220	459
EUR_277	0	EUR	756	88825376	88861101	35725
EUR_277	0	EUR	756	91891040	91902611	11571
EUR_277	0	EUR	756	94299508	94325532	26024
EUR_277	0	EUR	756	94362487	94382190	19703
EUR_277	0	EUR	756	94462929	94510654	47725
EUR_277	0	EUR	756	94915497	94930362	14865
EUR_277	0	EUR	756	96116814	96129704	12890
EUR_277	0	EUR	756	96136238	96151871	15633
EUR_277	0	EUR	756	96176046	96201851	25805
EUR_277	0	EUR	757	5018475	5041230	22755
EUR_277	0	EUR	757	8662954	8682424	19470
EUR_277	0	EUR	757	11703759	11708397	4638
EUR_277	0	EUR	757	14051019	14112508	61489
EUR_277	0	EUR	757	16343483	16367500	24017
EUR_277	0	EUR	757	21150173	21156082	5909
EUR_277	0	EUR	757	21200799	21216283	15484
EUR_277	0	EUR	757	22414077	22417821	3744
EUR_277	0	EUR	757	22454245	22476003	21758
EUR_277	0	EUR	757	22519633	22533171	13538
EUR_277	0	EUR	757	23176150	23184805	8655
EUR_277	0	EUR	757	23432743	23471650	38907
EUR_277	0	EUR	757	24580740	24581630	890
EUR_277	0	EUR	757	25343770	25501390	157620
EUR_277	0	EUR	757	25867195	25987107	119912
EUR_277	0	EUR	757	29273800	29279379	5579
EUR_277	0	EUR	757	29444267	29480892	36625
EUR_277	0	EUR	757	30904434	30907607	3173
EUR_277	0	EUR	757	31255290	31314394	59104
EUR_277	0	EUR	757	33245767	33429152	183385
EUR_277	0	EUR	757	34880550	34926785	46235
EUR_277	0	EUR	757	39664057	39692065	28008
EUR_277	0	EUR	757	41010587	41024466	13879
EUR_277	0	EUR	757	42792406	42823699	31293
EUR_277	0	EUR	757	59553546	59700527	146981
EUR_277	0	EUR	757	72388504	72398733	10229
EUR_277	0	EUR	757	73488506	73491846	3340
EUR_277	0	EUR	757	73498527	73605250	106723
EUR_277	0	EUR	757	74037318	74066564	29246
EUR_277	0	EUR	757	74092456	74139119	46663
EUR_277	0	EUR	757	74871541	74894548	23007
EUR_277	0	EUR	757	75121914	75179690	57776
EUR_277	0	EUR	757	75263541	75282527	18986
EUR_277	0	EUR	757	75522893	75632489	109596
EUR_277	0	EUR	757	76022322	76079223	56901
EUR_277	0	EUR	757	79860282	79894254	33972
EUR_277	0	EUR	757	80852609	80854395	1786
EUR_277	0	EUR	757	88126552	88236907	110355
EUR_277	0	EUR	757	89356470	89372641	16171
EUR_277	0	EUR	757	90153261	90211457	58196
EUR_277	0	EUR	757	92022074	92044148	22074
EUR_277	0	EUR	757	93553045	93567584	14539
EUR_277	0	EUR	757	94239181	94337048	97867
EUR_277	0	EUR	757	94348955	94412962	64007
EUR_277	0	EUR	757	94915497	94930362	14865
EUR_277	0	EUR	757	96116814	96129704	12890
EUR_277	0	EUR	757	96136238	96151871	15633
EUR_277	0	EUR	757	96537974	96636521	98547
EUR_278	0	EUR	758	2415974	2536319	120345
EUR_278	0	EUR	758	2987403	2997995	10592
EUR_278	0	EUR	758	4111555	4134871	23316
EUR_278	0	EUR	758	18622886	18751123	128237
EUR_278	0	EUR	758	22992959	23024189	31230
EUR_278	0	EUR	758	23752602	23752988	386
EUR_278	0	EUR	758	23785514	23829976	44462
EUR_278	0	EUR	758	24088240	24091227	2987
EUR_278	0	EUR	758	24892444	24906091	13647
EUR_278	0	EUR	758	25295733	25305885	10152
EUR_278	0	EUR	758	25847649	25855304	7655
EUR_278	0	EUR	758	25978368	25987107	8739
EUR_278	0	EUR	758	26798389	26801347	2958
EUR_278	0	EUR	758	26941352	26991485	50133
EUR_278	0	EUR	758	28619504	28692721	73217
EUR_278	0	EUR	758	30904434	30957155	52721
EUR_278	0	EUR	758	31098941	31127610	28669
EUR_278	0	EUR	758	37727611	37779396	51785
EUR_278	0	EUR	758	40410992	40421024	10032
EUR_278	0	EUR	758	40864889	40875488	10599
EUR_278	0	EUR	758	41349000	41349361	361
EUR_278	0	EUR	758	53847831	53859932	12101
EUR_278	0	EUR	758	53876467	54035252	158785
EUR_278	0	EUR	758	54686744	54688209	1465
EUR_278	0	EUR	758	54714203	54904011	189808
EUR_278	0	EUR	758	59064557	59289101	224544
EUR_278	0	EUR	758	73136973	73172795	35822
EUR_278	0	EUR	758	73588449	73602054	13605
EUR_278	0	EUR	758	81113251	81140731	27480
EUR_278	0	EUR	758	83886982	83921060	34078
EUR_278	0	EUR	758	87533821	87546866	13045
EUR_278	0	EUR	758	88405406	88464514	59108
EUR_278	0	EUR	758	88612163	88762816	150653
EUR_278	0	EUR	758	88818076	88936674	118598
EUR_278	0	EUR	758	94915497	94930362	14865
EUR_278	0	EUR	758	95829965	95887608	57643
EUR_278	0	EUR	758	96537974	96636521	98547
EUR_278	0	EUR	759	1330157	1349723	19566
EUR_278	0	EUR	759	2454787	2456835	2048
EUR_278	0	EUR	759	2489837	2702115	212278
EUR_278	0	EUR	759	4076140	4130169	54029
EUR_278	0	EUR	759	8662954	8714283	51329
EUR_278	0	EUR	759	9235548	9270524	34976
EUR_278	0	EUR	759	11778115	11795837	17722
EUR_278	0	EUR	759	13592472	13629161	36689
EUR_278	0	EUR	759	14107814	14108442	628
EUR_278	0	EUR	759	16223994	16240882	16888
EUR_278	0	EUR	759	16243211	16325554	82343
EUR_278	0	EUR	759	16394370	16404358	9988
EUR_278	0	EUR	759	16615459	16681323	65864
EUR_278	0	EUR	759	18100331	18140078	39747
EUR_278	0	EUR	759	22414077	22417821	3744
EUR_278	0	EUR	759	22454245	22476003	21758
EUR_278	0	EUR	759	22519633	22533171	13538
EUR_278	0	EUR	759	23176150	23183923	7773
EUR_278	0	EUR	759	23427310	23526309	98999
EUR_278	0	EUR	759	23863969	23877108	13139
EUR_278	0	EUR	759	24084401	24166883	82482
EUR_278	0	EUR	759	25554348	25609073	54725
EUR_278	0	EUR	759	29291099	29311528	20429
EUR_278	0	EUR	759	32855612	32870350	14738
EUR_278	0	EUR	759	35771774	35849669	77895
EUR_278	0	EUR	759	37754246	37771813	17567
EUR_278	0	EUR	759	38062578	38097333	34755
EUR_278	0	EUR	759	41343966	41360462	16496
EUR_278	0	EUR	759	43359651	43471816	112165
EUR_278	0	EUR	759	52224085	52231250	7165
EUR_278	0	EUR	759	54686744	54688209	1465
EUR_278	0	EUR	759	54714203	54904011	189808
EUR_278	0	EUR	759	57249879	57262845	12966
EUR_278	0	EUR	759	58093392	58136140	42748
EUR_278	0	EUR	759	58863206	58863428	222
EUR_278	0	EUR	759	59208358	59245710	37352
EUR_278	0	EUR	759	69809636	69864575	54939
EUR_278	0	EUR	759	73647366	73702901	55535
EUR_278	0	EUR	759	76365488	76395555	30067
EUR_278	0	EUR	759	76825105	76869710	44605
EUR_278	0	EUR	759	79901897	79936163	34266
EUR_278	0	EUR	759	83370620	83384810	14190
EUR_278	0	EUR	759	88335445	88363592	28147
EUR_278	0	EUR	759	89356470	89372641	16171
EUR_278	0	EUR	759	91026914	91066210	39296
EUR_278	0	EUR	759	93470832	93517093	46261
EUR_278	0	EUR	759	94239181	94276840	37659
EUR_279	0	EUR	760	2415974	2702115	286141
EUR_279	0	EUR	760	2996253	2997995	1742
EUR_279	0	EUR	760	4020191	4044195	24004
EUR_279	0	EUR	760	5121074	5123781	2707
EUR_279	0	EUR	760	16243211	16437214	194003
EUR_279	0	EUR	760	17889447	17902017	12570
EUR_279	0	EUR	760	22320042	22382212	62170
EUR_279	0	EUR	760	23176150	23184805	8655
EUR_279	0	EUR	760	23432743	23480035	47292
EUR_279	0	EUR	760	23648833	23651476	2643
EUR_279	0	EUR	760	23841523	23859762	18239
EUR_279	0	EUR	760	24372241	24384508	12267
EUR_279	0	EUR	760	24535579	24581630	46051
EUR_279	0	EUR	760	24892444	24906091	13647
EUR_279	0	EUR	760	25179048	25305885	126837
EUR_279	0	EUR	760	25492458	25501390	8932
EUR_279	0	EUR	760	27837565	27974945	137380
EUR_279	0	EUR	760	29306591	29365834	59243
EUR_279	0	EUR	760	31003667	31068328	64661
EUR_279	0	EUR	760	31671896	31680133	8237
EUR_279	0	EUR	760	31842746	31866371	23625
EUR_279	0	EUR	760	33245767	33429152	183385
EUR_279	0	EUR	760	43359651	43449383	89732
EUR_279	0	EUR	760	43520906	43653793	132887
EUR_279	0	EUR	760	59064557	59289101	224544
EUR_279	0	EUR	760	64430635	64447663	17028
EUR_279	0	EUR	760	64496625	64519080	22455
EUR_279	0	EUR	760	69023918	69060887	36969
EUR_279	0	EUR	760	74669262	74699907	30645
EUR_279	0	EUR	760	78831605	78886366	54761
EUR_279	0	EUR	760	79095078	79134588	39510
EUR_279	0	EUR	760	79901897	79936163	34266
EUR_279	0	EUR	760	83886982	83921060	34078
EUR_279	0	EUR	760	87760040	87779883	19843
EUR_279	0	EUR	760	88212981	88333763	120782
EUR_279	0	EUR	760	88761110	88912293	151183
EUR_279	0	EUR	760	89037352	89091247	53895
EUR_279	0	EUR	760	89356470	89465942	109472
EUR_279	0	EUR	760	93130067	93146996	16929
EUR_279	0	EUR	760	93624969	93660183	35214
EUR_279	0	EUR	760	93937866	93968931	31065
EUR_279	0	EUR	760	94297447	94338679	41232
EUR_279	0	EUR	760	94348955	94385143	36188
EUR_279	0	EUR	760	94395991	94412962	16971
EUR_279	0	EUR	761	4076140	4088141	12001
EUR_279	0	EUR	761	5121074	5123781	2707
EUR_279	0	EUR	761	11703759	11708397	4638
EUR_279	0	EUR	761	13574314	13635433	61119
EUR_279	0	EUR	761	13640984	13678187	37203
EUR_279	0	EUR	761	16234928	16286721	51793
EUR_279	0	EUR	761	17749730	17804155	54425
EUR_279	0	EUR	761	18787414	18806641	19227
EUR_279	0	EUR	761	21251363	21276019	24656
EUR_279	0	EUR	761	22462287	22608307	146020
EUR_279	0	EUR	761	22890136	22908285	18149
EUR_279	0	EUR	761	23432743	23480035	47292
EUR_279	0	EUR	761	23648833	23651476	2643
EUR_279	0	EUR	761	23841523	23859762	18239
EUR_279	0	EUR	761	25264173	25276538	12365
EUR_279	0	EUR	761	25867195	25904509	37314
EUR_279	0	EUR	761	29291099	29311528	20429
EUR_279	0	EUR	761	30824839	30867949	43110
EUR_279	0	EUR	761	30916037	30925177	9140
EUR_279	0	EUR	761	31138594	31138800	206
EUR_279	0	EUR	761	32667412	32673800	6388
EUR_279	0	EUR	761	32767431	32880042	112611
EUR_279	0	EUR	761	35091612	35095643	4031
EUR_279	0	EUR	761	43359651	43453960	94309
EUR_279	0	EUR	761	49863058	49868492	5434
EUR_279	0	EUR	761	73519049	73585002	65953
EUR_279	0	EUR	761	73593016	73701911	108895
EUR_279	0	EUR	761	75110846	75133281	22435
EUR_279	0	EUR	761	76502715	76594146	91431
EUR_279	0	EUR	761	80161288	80278256	116968
EUR_279	0	EUR	761	83370620	83384810	14190
EUR_279	0	EUR	761	87533821	87546866	13045
EUR_279	0	EUR	761	88126552	88144332	17780
EUR_279	0	EUR	761	88219640	88268906	49266
EUR_279	0	EUR	761	88291179	88319207	28028
EUR_279	0	EUR	761	88452177	88464514	12337
EUR_279	0	EUR	761	88476761	88537179	60418
EUR_279	0	EUR	761	89054631	89055677	1046
EUR_279	0	EUR	761	90153798	90243516	89718
EUR_279	0	EUR	761	92006288	92056341	50053
EUR_279	0	EUR	761	92155254	92171686	16432
EUR_279	0	EUR	761	93123848	93146996	23148
EUR_279	0	EUR	761	93499176	93623371	124195
EUR_279	0	EUR	761	93943380	94056780	113400
EUR_279	0	EUR	761	94297447	94412962	115515
EUR_279	0	EUR	761	94595895	94701010	105115
EUR_279	0	EUR	761	95774147	95844558	70411
EUR_279	0	EUR	761	96184017	96206095	22078
EUR_280	0	EUR	762	2415974	2536319	120345
EUR_280	0	EUR	762	11718857	11730400	11543
EUR_280	0	EUR	762	21150173	21156082	5909
EUR_280	0	EUR	762	21200799	21216283	15484
EUR_280	0	EUR	762	25382767	25501390	118623
EUR_280	0	EUR	762	25978368	25987107	8739
EUR_280	0	EUR	762	26415865	26436121	20256
EUR_280	0	EUR	762	26886230	26991485	105255
EUR_280	0	EUR	762	27746608	27787460	40852
EUR_280	0	EUR	762	34845302	34926785	81483
EUR_280	0	EUR	762	39881061	39891202	10141
EUR_280	0	EUR	762	40132875	40145306	12431
EUR_280	0	EUR	762	40572310	40602505	30195
EUR_280	0	EUR	762	42792406	42823699	31293
EUR_280	0	EUR	762	49714605	49741250	26645
EUR_280	0	EUR	762	54005322	54016981	11659
EUR_280	0	EUR	762	54397910	54407949	10039
EUR_280	0	EUR	762	56378802	56448072	69270
EUR_280	0	EUR	762	57857678	57861351	3673
EUR_280	0	EUR	762	58093392	58136140	42748
EUR_280	0	EUR	762	64857298	64922329	65031
EUR_280	0	EUR	762	72471551	72471635	84
EUR_280	0	EUR	762	73539223	73613535	74312
EUR_280	0	EUR	762	83886982	83921060	34078
EUR_280	0	EUR	762	87971258	87990554	19296
EUR_280	0	EUR	762	88219640	88293188	73548
EUR_280	0	EUR	762	88683028	88762816	79788
EUR_280	0	EUR	762	88785379	88912293	126914
EUR_280	0	EUR	762	89037352	89085311	47959
EUR_280	0	EUR	762	93553045	93660183	107138
EUR_280	0	EUR	762	94523809	94559172	35363
EUR_280	0	EUR	762	94989290	95011492	22202
EUR_280	0	EUR	763	2447654	2560700	113046
EUR_280	0	EUR	763	4004281	4029447	25166
EUR_280	0	EUR	763	5020424	5034623	14199
EUR_280	0	EUR	763	12764351	12845452	81101
EUR_280	0	EUR	763	13621609	13626532	4923
EUR_280	0	EUR	763	16234928	16286721	51793
EUR_280	0	EUR	763	21246127	21282925	36798
EUR_280	0	EUR	763	22365602	22393602	28000
EUR_280	0	EUR	763	24045382	24166883	121501
EUR_280	0	EUR	763	24580740	24581630	890
EUR_280	0	EUR	763	25867195	25906725	39530
EUR_280	0	EUR	763	26351163	26383533	32370
EUR_280	0	EUR	763	27915600	27974945	59345
EUR_280	0	EUR	763	28111916	28138518	26602
EUR_280	0	EUR	763	28645700	28663032	17332
EUR_280	0	EUR	763	29291099	29311528	20429
EUR_280	0	EUR	763	30904434	31040753	136319
EUR_280	0	EUR	763	31235544	31314394	78850
EUR_280	0	EUR	763	32293660	32302938	9278
EUR_280	0	EUR	763	34136759	34138136	1377
EUR_280	0	EUR	763	37754246	37771813	17567
EUR_280	0	EUR	763	38062578	38097333	34755
EUR_280	0	EUR	763	39652652	39692065	39413
EUR_280	0	EUR	763	42805387	42823699	18312
EUR_280	0	EUR	763	53847831	53859932	12101
EUR_280	0	EUR	763	53876467	54035252	158785
EUR_280	0	EUR	763	54113043	54177383	64340
EUR_280	0	EUR	763	59064557	59245738	181181
EUR_280	0	EUR	763	71670386	71678663	8277
EUR_280	0	EUR	763	73039375	73160136	120761
EUR_280	0	EUR	763	73519049	73585002	65953
EUR_280	0	EUR	763	73593016	73701911	108895
EUR_280	0	EUR	763	74889460	74894548	5088
EUR_280	0	EUR	763	75587305	75641163	53858
EUR_280	0	EUR	763	78816419	78881412	64993
EUR_280	0	EUR	763	79860282	79861219	937
EUR_280	0	EUR	763	80238643	80278256	39613
EUR_280	0	EUR	763	83886982	83921060	34078
EUR_280	0	EUR	763	88452177	88464514	12337
EUR_280	0	EUR	763	88476761	88537179	60418
EUR_280	0	EUR	763	88863429	88877947	14518
EUR_280	0	EUR	763	91847626	91875197	27571
EUR_280	0	EUR	763	92062604	92171686	109082
EUR_280	0	EUR	763	93553045	93713967	160922
EUR_280	0	EUR	763	93876597	93887313	10716
EUR_280	0	EUR	763	93943380	94031719	88339
EUR_280	0	EUR	763	94239181	94246409	7228
EUR_280	0	EUR	763	94297447	94418018	120571
EUR_280	0	EUR	763	94419260	94510654	91394
EUR_281	0	EUR	764	343836	401572	57736
EUR_281	0	EUR	764	9235548	9270524	34976
EUR_281	0	EUR	764	11731770	11814111	82341
EUR_281	0	EUR	764	13439477	13752578	313101
EUR_281	0	EUR	764	14051019	14108442	57423
EUR_281	0	EUR	764	16223994	16240882	16888
EUR_281	0	EUR	764	16243211	16286721	43510
EUR_281	0	EUR	764	18100331	18140078	39747
EUR_281	0	EUR	764	18622886	18751123	128237
EUR_281	0	EUR	764	23752602	23856810	104208
EUR_281	0	EUR	764	24081636	24094707	13071
EUR_281	0	EUR	764	24892444	24894673	2229
EUR_281	0	EUR	764	27894016	27894364	348
EUR_281	0	EUR	764	29306591	29478208	171617
EUR_281	0	EUR	764	31087987	31138800	50813
EUR_281	0	EUR	764	31528053	31593163	65110
EUR_281	0	EUR	764	32730368	32759145	28777
EUR_281	0	EUR	764	32851725	32880042	28317
EUR_281	0	EUR	764	35771774	35849669	77895
EUR_281	0	EUR	764	38062578	38097333	34755
EUR_281	0	EUR	764	40410992	40424856	13864
EUR_281	0	EUR	764	43359651	43443877	84226
EUR_281	0	EUR	764	43444654	43453960	9306
EUR_281	0	EUR	764	49791142	49837661	46519
EUR_281	0	EUR	764	57188385	57203075	14690
EUR_281	0	EUR	764	64338347	64393512	55165
EUR_281	0	EUR	764	64496625	64519080	22455
EUR_281	0	EUR	764	74581736	74738891	157155
EUR_281	0	EUR	764	75592795	75632489	39694
EUR_281	0	EUR	764	77735282	77735979	697
EUR_281	0	EUR	764	80852609	80881534	28925
EUR_281	0	EUR	764	81113251	81161550	48299
EUR_281	0	EUR	764	83370620	83384810	14190
EUR_281	0	EUR	764	83941668	83957574	15906
EUR_281	0	EUR	764	88219640	88363592	143952
EUR_281	0	EUR	764	89048549	89091247	42698
EUR_281	0	EUR	764	89356470	89465942	109472
EUR_281	0	EUR	764	91891040	91902611	11571
EUR_281	0	EUR	764	92065436	92141232	75796
EUR_281	0	EUR	764	93636357	93713967	77610
EUR_281	0	EUR	764	93876597	93887313	10716
EUR_281	0	EUR	764	93943380	94031719	88339
EUR_281	0	EUR	764	94239181	94246409	7228
EUR_281	0	EUR	764	94297447	94418018	120571
EUR_281	0	EUR	764	94419260	94544971	125711
EUR_281	0	EUR	764	95356313	95424095	67782
EUR_281	0	EUR	764	96306773	96333512	26739
EUR_281	0	EUR	764	99230141	99279146	49005
EUR_281	0	EUR	765	1330157	1385444	55287
EUR_281	0	EUR	765	4076140	4130169	54029
EUR_281	0	EUR	765	5018475	5041230	22755
EUR_281	0	EUR	765	8348919	8386102	37183
EUR_281	0	EUR	765	9149188	9161447	12259
EUR_281	0	EUR	765	11480169	11492904	12735
EUR_281	0	EUR	765	11806319	11814111	7792
EUR_281	0	EUR	765	13592472	13605335	12863
EUR_281	0	EUR	765	14051019	14112508	61489
EUR_281	0	EUR	765	18081536	18107085	25549
EUR_281	0	EUR	765	22519633	22533171	13538
EUR_281	0	EUR	765	25140534	25264496	123962
EUR_281	0	EUR	765	25356497	25501390	144893
EUR_281	0	EUR	765	26798389	26801347	2958
EUR_281	0	EUR	765	27929422	27974945	45523
EUR_281	0	EUR	765	29444267	29483168	38901
EUR_281	0	EUR	765	31528053	31575105	47052
EUR_281	0	EUR	765	39881061	39891202	10141
EUR_281	0	EUR	765	40132875	40145306	12431
EUR_281	0	EUR	765	40549617	40602505	52888
EUR_281	0	EUR	765	40919189	41024466	105277
EUR_281	0	EUR	765	42805387	42823699	18312
EUR_281	0	EUR	765	43359651	43376011	16360
EUR_281	0	EUR	765	57712252	57806900	94648
EUR_281	0	EUR	765	59686990	59737678	50688
EUR_281	0	EUR	765	63714218	63732455	18237
EUR_281	0	EUR	765	64372692	64406792	34100
EUR_281	0	EUR	765	64489532	64492914	3382
EUR_281	0	EUR	765	71722082	71732410	10328
EUR_281	0	EUR	765	74410856	74438736	27880
EUR_281	0	EUR	765	80852609	80890918	38309
EUR_281	0	EUR	765	80999290	81087964	88674
EUR_281	0	EUR	765	81229018	81229503	485
EUR_281	0	EUR	765	88503129	88762816	259687
EUR_281	0	EUR	765	88777994	88877947	99953
EUR_281	0	EUR	765	91847626	91929323	81697
EUR_281	0	EUR	765	93553045	93567584	14539
EUR_281	0	EUR	765	93702886	93713967	11081
EUR_281	0	EUR	765	96116814	96333512	216698
EUR_282	0	EUR	766	2415974	2702115	286141
EUR_282	0	EUR	766	2996253	2997995	1742
EUR_282	0	EUR	766	9235548	9308590	73042
EUR_282	0	EUR	766	9356784	9449917	93133
EUR_282	0	EUR	766	16243211	16286721	43510
EUR_282	0	EUR	766	17889447	17902017	12570
EUR_282	0	EUR	766	18622886	18678327	55441
EUR_282	0	EUR	766	23432743	23480035	47292
EUR_282	0	EUR	766	23648833	23651476	2643
EUR_282	0	EUR	766	23841523	23859762	18239
EUR_282	0	EUR	766	25953989	25987107	33118
EUR_282	0	EUR	766	29444267	29483168	38901
EUR_282	0	EUR	766	31087987	31151086	63099
EUR_282	0	EUR	766	32731788	32880042	148254
EUR_282	0	EUR	766	40572310	40602505	30195
EUR_282	0	EUR	766	43359651	43449383	89732
EUR_282	0	EUR	766	49738638	49803673	65035
EUR_282	0	EUR	766	54503155	54794755	291600
EUR_282	0	EUR	766	57181563	57259146	77583
EUR_282	0	EUR	766	59744029	59762964	18935
EUR_282	0	EUR	766	64338347	64382745	44398
EUR_282	0	EUR	766	68626746	68648432	21686
EUR_282	0	EUR	766	69023918	69060887	36969
EUR_282	0	EUR	766	74092456	74139119	46663
EUR_282	0	EUR	766	77733985	77735979	1994
EUR_282	0	EUR	766	79860282	79933512	73230
EUR_282	0	EUR	766	80852609	80890918	38309
EUR_282	0	EUR	766	81107841	81152495	44654
EUR_282	0	EUR	766	81161389	81229503	68114
EUR_282	0	EUR	766	88269341	88319207	49866
EUR_282	0	EUR	766	88976048	89023617	47569
EUR_282	0	EUR	766	90846588	90969654	123066
EUR_282	0	EUR	766	91018779	91107582	88803
EUR_282	0	EUR	766	93702886	93713967	11081
EUR_282	0	EUR	766	96265168	96324757	59589
EUR_282	0	EUR	767	4105020	4130169	25149
EUR_282	0	EUR	767	11703759	11708397	4638
EUR_282	0	EUR	767	12764351	12785371	21020
EUR_282	0	EUR	767	13593425	13671934	78509
EUR_282	0	EUR	767	16319606	16401162	81556
EUR_282	0	EUR	767	17749730	17785756	36026
EUR_282	0	EUR	767	17918899	18041675	122776
EUR_282	0	EUR	767	23752602	23856810	104208
EUR_282	0	EUR	767	24507871	24517101	9230
EUR_282	0	EUR	767	25151604	25305885	154281
EUR_282	0	EUR	767	29273800	29279379	5579
EUR_282	0	EUR	767	29378375	29432002	53627
EUR_282	0	EUR	767	30904434	31092945	188511
EUR_282	0	EUR	767	32057270	32141896	84626
EUR_282	0	EUR	767	32824940	32828620	3680
EUR_282	0	EUR	767	32858056	32870350	12294
EUR_282	0	EUR	767	35887157	35892995	5838
EUR_282	0	EUR	767	37727611	37757885	30274
EUR_282	0	EUR	767	40083840	40090192	6352
EUR_282	0	EUR	767	40947704	41087414	139710
EUR_282	0	EUR	767	52168283	52224041	55758
EUR_282	0	EUR	767	54570690	54612977	42287
EUR_282	0	EUR	767	59064557	59233616	169059
EUR_282	0	EUR	767	71745787	71764001	18214
EUR_282	0	EUR	767	73039375	73160136	120761
EUR_282	0	EUR	767	73584558	73660589	76031
EUR_282	0	EUR	767	75110846	75189189	78343
EUR_282	0	EUR	767	75522893	75622671	99778
EUR_282	0	EUR	767	76365488	76395555	30067
EUR_282	0	EUR	767	76825105	76869710	44605
EUR_282	0	EUR	767	78816419	78881412	64993
EUR_282	0	EUR	767	79105993	79134588	28595
EUR_282	0	EUR	767	79901897	79903521	1624
EUR_282	0	EUR	767	79921893	79936163	14270
EUR_282	0	EUR	767	87512858	87546866	34008
EUR_282	0	EUR	767	88077880	88113143	35263
EUR_282	0	EUR	767	88764684	88915947	151263
EUR_282	0	EUR	767	89017110	89038093	20983
EUR_282	0	EUR	767	90467547	90486618	19071
EUR_282	0	EUR	767	93553045	93713967	160922
EUR_282	0	EUR	767	93876597	93887313	10716
EUR_282	0	EUR	767	93894686	93900172	5486
EUR_282	0	EUR	767	94298428	94418018	119590
EUR_282	0	EUR	767	94419260	94466650	47390
EUR_282	0	EUR	767	94595895	94701010	105115
EUR_282	0	EUR	767	99177558	99280798	103240
EUR_283	0	EUR	768	343836	401572	57736
EUR_283	0	EUR	768	1322727	1329694	6967
EUR_283	0	EUR	768	2447654	2560700	113046
EUR_283	0	EUR	768	4004742	4069279	64537
EUR_283	0	EUR	768	5121074	5123781	2707
EUR_283	0	EUR	768	11731272	11814111	82839
EUR_283	0	EUR	768	13626867	13635433	8566
EUR_283	0	EUR	768	13640984	13805391	164407
EUR_283	0	EUR	768	16258452	16293048	34596
EUR_283	0	EUR	768	16318960	16331886	12926
EUR_283	0	EUR	768	21246127	21282925	36798
EUR_283	0	EUR	768	23120612	23120638	26
EUR_283	0	EUR	768	23427310	23492190	64880
EUR_283	0	EUR	768	23721919	23725831	3912
EUR_283	0	EUR	768	24621120	24737906	116786
EUR_283	0	EUR	768	24809049	24866754	57705
EUR_283	0	EUR	768	25179048	25179265	217
EUR_283	0	EUR	768	25332662	25378298	45636
EUR_283	0	EUR	768	25847649	25855304	7655
EUR_283	0	EUR	768	31550310	31575105	24795
EUR_283	0	EUR	768	31609661	31636518	26857
EUR_283	0	EUR	768	32767431	32880042	112611
EUR_283	0	EUR	768	33263445	33281653	18208
EUR_283	0	EUR	768	39681230	39692065	10835
EUR_283	0	EUR	768	40003482	40145306	141824
EUR_283	0	EUR	768	40518696	40602505	83809
EUR_283	0	EUR	768	50097264	50097389	125
EUR_283	0	EUR	768	54844670	54904011	59341
EUR_283	0	EUR	768	56378802	56448072	69270
EUR_283	0	EUR	768	59686990	59737678	50688
EUR_283	0	EUR	768	72994673	73022663	27990
EUR_283	0	EUR	768	74669092	74670272	1180
EUR_283	0	EUR	768	74871541	74894548	23007
EUR_283	0	EUR	768	76365488	76399941	34453
EUR_283	0	EUR	768	76805591	76969243	163652
EUR_283	0	EUR	768	77880564	77881732	1168
EUR_283	0	EUR	768	79082049	79134588	52539
EUR_283	0	EUR	768	81031954	81036282	4328
EUR_283	0	EUR	768	88078757	88161538	82781
EUR_283	0	EUR	768	88167557	88172209	4652
EUR_283	0	EUR	768	88212981	88333763	120782
EUR_283	0	EUR	768	89037057	89081743	44686
EUR_283	0	EUR	768	93172929	93217584	44655
EUR_283	0	EUR	768	93628871	93669773	40902
EUR_283	0	EUR	768	94240024	94317758	77734
EUR_283	0	EUR	768	94338811	94418018	79207
EUR_283	0	EUR	768	94419260	94510654	91394
EUR_283	0	EUR	768	96116814	96220219	103405
EUR_283	0	EUR	768	99165891	99280798	114907
EUR_283	0	EUR	769	2898490	2923429	24939
EUR_283	0	EUR	769	5253381	5312534	59153
EUR_283	0	EUR	769	11532006	11542173	10167
EUR_283	0	EUR	769	13621609	13626532	4923
EUR_283	0	EUR	769	16319606	16401162	81556
EUR_283	0	EUR	769	16676133	16681323	5190
EUR_283	0	EUR	769	17749730	17804155	54425
EUR_283	0	EUR	769	18622886	18636940	14054
EUR_283	0	EUR	769	20981647	20982609	962
EUR_283	0	EUR	769	23176150	23184805	8655
EUR_283	0	EUR	769	23432743	23480035	47292
EUR_283	0	EUR	769	23648833	23651476	2643
EUR_283	0	EUR	769	23841523	23859762	18239
EUR_283	0	EUR	769	24372241	24384508	12267
EUR_283	0	EUR	769	24535579	24581630	46051
EUR_283	0	EUR	769	24892444	24906091	13647
EUR_283	0	EUR	769	25179048	25305885	126837
EUR_283	0	EUR	769	25492458	25501390	8932
EUR_283	0	EUR	769	27837565	27974945	137380
EUR_283	0	EUR	769	29306591	29365834	59243
EUR_283	0	EUR	769	31087987	31109532	21545
EUR_283	0	EUR	769	31528053	31593163	65110
EUR_283	0	EUR	769	33143811	33166924	23113
EUR_283	0	EUR	769	39682757	39692065	9308
EUR_283	0	EUR	769	40015733	40145306	129573
EUR_283	0	EUR	769	40410992	40602505	191513
EUR_283	0	EUR	769	53821064	53859932	38868
EUR_283	0	EUR	769	54123719	54150257	26538
EUR_283	0	EUR	769	54403505	54431022	27517
EUR_283	0	EUR	769	54686744	54688209	1465
EUR_283	0	EUR	769	54714203	54904011	189808
EUR_283	0	EUR	769	59464397	59522281	57884
EUR_283	0	EUR	769	63714218	63732455	18237
EUR_283	0	EUR	769	75110846	75156481	45635
EUR_283	0	EUR	769	76022322	76032875	10553
EUR_283	0	EUR	769	78831605	78886366	54761
EUR_283	0	EUR	769	79921893	79936163	14270
EUR_283	0	EUR	769	80161288	80278256	116968
EUR_283	0	EUR	769	83370620	83384810	14190
EUR_283	0	EUR	769	83933477	83957574	24097
EUR_283	0	EUR	769	88106479	88107284	805
EUR_283	0	EUR	769	93499176	93647010	147834
EUR_283	0	EUR	769	93908281	93925519	17238
EUR_283	0	EUR	769	94005320	94105458	100138
EUR_283	0	EUR	769	94290726	94412962	122236
EUR_284	0	EUR	770	2415974	2430939	14965
EUR_284	0	EUR	770	4004059	4126878	122819
EUR_284	0	EUR	770	4129102	4130169	1067
EUR_284	0	EUR	770	5018475	5041230	22755
EUR_284	0	EUR	770	9235548	9270524	34976
EUR_284	0	EUR	770	11703759	11708397	4638
EUR_284	0	EUR	770	13592472	13685072	92600
EUR_284	0	EUR	770	16240404	16325554	85150
EUR_284	0	EUR	770	16368540	16401162	32622
EUR_284	0	EUR	770	16676133	16681323	5190
EUR_284	0	EUR	770	21150173	21156082	5909
EUR_284	0	EUR	770	21224963	21225412	449
EUR_284	0	EUR	770	21324588	21390474	65886
EUR_284	0	EUR	770	23648833	23651476	2643
EUR_284	0	EUR	770	25953989	25987107	33118
EUR_284	0	EUR	770	31283404	31314394	30990
EUR_284	0	EUR	770	31478668	31502542	23874
EUR_284	0	EUR	770	31527830	31674144	146314
EUR_284	0	EUR	770	32855612	32870350	14738
EUR_284	0	EUR	770	40132875	40145306	12431
EUR_284	0	EUR	770	42525645	42532178	6533
EUR_284	0	EUR	770	49724999	49741250	16251
EUR_284	0	EUR	770	53926656	53973414	46758
EUR_284	0	EUR	770	54021241	54034568	13327
EUR_284	0	EUR	770	54060304	54076786	16482
EUR_284	0	EUR	770	56433656	56480618	46962
EUR_284	0	EUR	770	57181563	57259146	77583
EUR_284	0	EUR	770	59064557	59245738	181181
EUR_284	0	EUR	770	69023918	69060887	36969
EUR_284	0	EUR	770	71722082	71732410	10328
EUR_284	0	EUR	770	74092678	74094072	1394
EUR_284	0	EUR	770	74595799	74699907	104108
EUR_284	0	EUR	770	75110846	75126468	15622
EUR_284	0	EUR	770	75263541	75282527	18986
EUR_284	0	EUR	770	76031608	76124545	92937
EUR_284	0	EUR	770	76365488	76397099	31611
EUR_284	0	EUR	770	81031954	81036282	4328
EUR_284	0	EUR	770	83955315	83957574	2259
EUR_284	0	EUR	770	86916801	86926886	10085
EUR_284	0	EUR	770	88126552	88223988	97436
EUR_284	0	EUR	770	88761110	89009551	248441
EUR_284	0	EUR	770	90471492	90558518	87026
EUR_284	0	EUR	770	91891040	91902611	11571
EUR_284	0	EUR	770	92156246	92171686	15440
EUR_284	0	EUR	770	96254823	96333512	78689
EUR_284	0	EUR	771	340121	355955	15834
EUR_284	0	EUR	771	1322727	1329694	6967
EUR_284	0	EUR	771	2447654	2560700	113046
EUR_284	0	EUR	771	4004742	4069279	64537
EUR_284	0	EUR	771	5121074	5123781	2707
EUR_284	0	EUR	771	9414397	9449917	35520
EUR_284	0	EUR	771	17889447	17902017	12570
EUR_284	0	EUR	771	21246127	21282925	36798
EUR_284	0	EUR	771	23432743	23480035	47292
EUR_284	0	EUR	771	23721919	23725831	3912
EUR_284	0	EUR	771	29352220	29396432	44212
EUR_284	0	EUR	771	29444267	29483168	38901
EUR_284	0	EUR	771	31003667	31032597	28930
EUR_284	0	EUR	771	31587507	31593163	5656
EUR_284	0	EUR	771	32731788	32870350	138562
EUR_284	0	EUR	771	40570428	40602505	32077
EUR_284	0	EUR	771	49714605	49741250	26645
EUR_284	0	EUR	771	53821064	53909006	87942
EUR_284	0	EUR	771	54570690	54612977	42287
EUR_284	0	EUR	771	57136159	57262845	126686
EUR_284	0	EUR	771	59297352	59341956	44604
EUR_284	0	EUR	771	59514589	59522281	7692
EUR_284	0	EUR	771	59744029	59762964	18935
EUR_284	0	EUR	771	68626746	68648432	21686
EUR_284	0	EUR	771	71722082	71732410	10328
EUR_284	0	EUR	771	72288615	72398733	110118
EUR_284	0	EUR	771	76502715	76594146	91431
EUR_284	0	EUR	771	77757119	77795912	38793
EUR_284	0	EUR	771	78816419	78881412	64993
EUR_284	0	EUR	771	87533821	87546866	13045
EUR_284	0	EUR	771	87969149	87990554	21405
EUR_284	0	EUR	771	88251833	88319207	67374
EUR_284	0	EUR	771	88462576	88464514	1938
EUR_284	0	EUR	771	88476761	88537179	60418
EUR_284	0	EUR	771	89356470	89465942	109472
EUR_284	0	EUR	771	92062604	92171686	109082
EUR_284	0	EUR	771	93172929	93217584	44655
EUR_284	0	EUR	771	93553045	93660183	107138
EUR_284	0	EUR	771	94297447	94418018	120571
EUR_284	0	EUR	771	94419260	94515224	95964
EUR_284	0	EUR	771	96116814	96217388	100574
EUR_285	0	EUR	772	8662954	8714283	51329
EUR_285	0	EUR	772	9235548	9270524	34976
EUR_285	0	EUR	772	11778115	11795837	17722
EUR_285	0	EUR	772	16235582	16286721	51139
EUR_285	0	EUR	772	16392437	16401162	8725
EUR_285	0	EUR	772	22412098	22417821	5723
EUR_285	0	EUR	772	22454245	22532371	78126
EUR_285	0	EUR	772	23120612	23120638	26
EUR_285	0	EUR	772	23146006	23184805	38799
EUR_285	0	EUR	772	23752534	23770684	18150
EUR_285	0	EUR	772	24045382	24166883	121501
EUR_285	0	EUR	772	24580740	24581630	890
EUR_285	0	EUR	772	24892444	24906091	13647
EUR_285	0	EUR	772	25343770	25501390	157620
EUR_285	0	EUR	772	25950286	25987107	36821
EUR_285	0	EUR	772	26048379	26143612	95233
EUR_285	0	EUR	772	29273800	29279379	5579
EUR_285	0	EUR	772	29444267	29483168	38901
EUR_285	0	EUR	772	30824839	31151086	326247
EUR_285	0	EUR	772	31233297	31314394	81097
EUR_285	0	EUR	772	31528053	31593163	65110
EUR_285	0	EUR	772	32312667	32447123	134456
EUR_285	0	EUR	772	32767431	32880042	112611
EUR_285	0	EUR	772	34124908	34182116	57208
EUR_285	0	EUR	772	35586924	35627884	40960
EUR_285	0	EUR	772	36050639	36072513	21874
EUR_285	0	EUR	772	37722669	37749485	26816
EUR_285	0	EUR	772	37749533	37779396	29863
EUR_285	0	EUR	772	37781734	37861278	79544
EUR_285	0	EUR	772	40861764	40915899	54135
EUR_285	0	EUR	772	43359651	43453960	94309
EUR_285	0	EUR	772	58863206	58863428	222
EUR_285	0	EUR	772	63714218	63732455	18237
EUR_285	0	EUR	772	72994673	73022663	27990
EUR_285	0	EUR	772	74669092	74670272	1180
EUR_285	0	EUR	772	74871541	74894548	23007
EUR_285	0	EUR	772	77854808	77881732	26924
EUR_285	0	EUR	772	87533821	87546866	13045
EUR_285	0	EUR	772	88152919	88153791	872
EUR_285	0	EUR	772	88418285	88457272	38987
EUR_285	0	EUR	772	88761110	89009551	248441
EUR_285	0	EUR	772	91072171	91107582	35411
EUR_285	0	EUR	772	93680632	93680672	40
EUR_285	0	EUR	772	99256882	99280798	23916
EUR_285	0	EUR	773	2898490	2998355	99865
EUR_285	0	EUR	773	11703759	11708397	4638
EUR_285	0	EUR	773	12822877	12847009	24132
EUR_285	0	EUR	773	18622886	18751123	128237
EUR_285	0	EUR	773	22283237	22352515	69278
EUR_285	0	EUR	773	22447027	22448993	1966
EUR_285	0	EUR	773	22454245	22572758	118513
EUR_285	0	EUR	773	22992959	23024189	31230
EUR_285	0	EUR	773	23752602	23856810	104208
EUR_285	0	EUR	773	24580740	24581630	890
EUR_285	0	EUR	773	24892444	24906091	13647
EUR_285	0	EUR	773	25343770	25501390	157620
EUR_285	0	EUR	773	26319359	26331325	11966
EUR_285	0	EUR	773	27746608	27766580	19972
EUR_285	0	EUR	773	29321833	29348593	26760
EUR_285	0	EUR	773	30904434	31092945	188511
EUR_285	0	EUR	773	32262916	32267787	4871
EUR_285	0	EUR	773	32824940	32828620	3680
EUR_285	0	EUR	773	32858056	32870350	12294
EUR_285	0	EUR	773	33143811	33166924	23113
EUR_285	0	EUR	773	52286725	52304744	18019
EUR_285	0	EUR	773	54005322	54016981	11659
EUR_285	0	EUR	773	54397910	54407949	10039
EUR_285	0	EUR	773	54693132	54796245	103113
EUR_285	0	EUR	773	57233337	57253147	19810
EUR_285	0	EUR	773	57264407	57291065	26658
EUR_285	0	EUR	773	59064557	59117998	53441
EUR_285	0	EUR	773	59744029	59762964	18935
EUR_285	0	EUR	773	64338347	64382745	44398
EUR_285	0	EUR	773	69023918	69060887	36969
EUR_285	0	EUR	773	71593495	71678116	84621
EUR_285	0	EUR	773	72395574	72398733	3159
EUR_285	0	EUR	773	72471551	72471635	84
EUR_285	0	EUR	773	73079315	73132219	52904
EUR_285	0	EUR	773	73519049	73587814	68765
EUR_285	0	EUR	773	75166047	75189189	23142
EUR_285	0	EUR	773	75263541	75282527	18986
EUR_285	0	EUR	773	76022322	76093521	71199
EUR_285	0	EUR	773	76365488	76399941	34453
EUR_285	0	EUR	773	80161288	80252503	91215
EUR_285	0	EUR	773	86916801	86971491	54690
EUR_285	0	EUR	773	87533821	87546866	13045
EUR_285	0	EUR	773	88077880	88172209	94329
EUR_285	0	EUR	773	88212981	88333763	120782
EUR_285	0	EUR	773	88405406	88464514	59108
EUR_285	0	EUR	773	88476761	88537179	60418
EUR_285	0	EUR	773	88761110	88877947	116837
EUR_285	0	EUR	773	90471492	90558518	87026
EUR_285	0	EUR	773	92062604	92171686	109082
EUR_285	0	EUR	773	93361912	93411339	49427
EUR_285	0	EUR	773	93666700	93713967	47267
EUR_285	0	EUR	773	94006766	94031719	24953
EUR_285	0	EUR	773	95774147	95844558	70411
EUR_286	0	EUR	774	11532006	11542173	10167
EUR_286	0	EUR	774	14051019	14108442	57423
EUR_286	0	EUR	774	16676133	16681323	5190
EUR_286	0	EUR	774	17918899	18022658	103759
EUR_286	0	EUR	774	18717757	18844474	126717
EUR_286	0	EUR	774	23120612	23120638	26
EUR_286	0	EUR	774	24088240	24211824	123584
EUR_286	0	EUR	774	24468369	24581630	113261
EUR_286	0	EUR	774	24892444	24906091	13647
EUR_286	0	EUR	774	25867195	25906725	39530
EUR_286	0	EUR	774	26319359	26327062	7703
EUR_286	0	EUR	774	26329336	26331325	1989
EUR_286	0	EUR	774	31528053	31575105	47052
EUR_286	0	EUR	774	32730368	32759145	28777
EUR_286	0	EUR	774	32851725	32880042	28317
EUR_286	0	EUR	774	33298309	33324776	26467
EUR_286	0	EUR	774	34151714	34182116	30402
EUR_286	0	EUR	774	37885686	37943125	57439
EUR_286	0	EUR	774	40410992	40426834	15842
EUR_286	0	EUR	774	42805387	42823699	18312
EUR_286	0	EUR	774	43359651	43376011	16360
EUR_286	0	EUR	774	49714605	49781657	67052
EUR_286	0	EUR	774	53821064	53859932	38868
EUR_286	0	EUR	774	58863206	58863428	222
EUR_286	0	EUR	774	64338347	64367731	29384
EUR_286	0	EUR	774	71722082	71732410	10328
EUR_286	0	EUR	774	72967423	73172795	205372
EUR_286	0	EUR	774	74410856	74438736	27880
EUR_286	0	EUR	774	75110846	75189189	78343
EUR_286	0	EUR	774	77733985	77735979	1994
EUR_286	0	EUR	774	87075746	87077051	1305
EUR_286	0	EUR	774	87665598	87696821	31223
EUR_286	0	EUR	774	88335445	88363592	28147
EUR_286	0	EUR	774	89356470	89372641	16171
EUR_286	0	EUR	774	93499176	93647010	147834
EUR_286	0	EUR	774	93908281	93925519	17238
EUR_286	0	EUR	774	94005320	94105458	100138
EUR_286	0	EUR	774	94290726	94412962	122236
EUR_286	0	EUR	775	5121074	5123781	2707
EUR_286	0	EUR	775	13492976	13597881	104905
EUR_286	0	EUR	775	13626867	13635433	8566
EUR_286	0	EUR	775	13640984	13647479	6495
EUR_286	0	EUR	775	17749730	17822978	73248
EUR_286	0	EUR	775	18704683	18833631	128948
EUR_286	0	EUR	775	21150173	21156082	5909
EUR_286	0	EUR	775	21200799	21216283	15484
EUR_286	0	EUR	775	22519633	22533171	13538
EUR_286	0	EUR	775	23120612	23120638	26
EUR_286	0	EUR	775	25140534	25283463	142929
EUR_286	0	EUR	775	26319359	26436121	116762
EUR_286	0	EUR	775	26523308	26580898	57590
EUR_286	0	EUR	775	29373765	29390654	16889
EUR_286	0	EUR	775	31087987	31109532	21545
EUR_286	0	EUR	775	31587507	31593163	5656
EUR_286	0	EUR	775	33245767	33429152	183385
EUR_286	0	EUR	775	35887157	35892995	5838
EUR_286	0	EUR	775	38062578	38074300	11722
EUR_286	0	EUR	775	40410992	40421024	10032
EUR_286	0	EUR	775	42369514	42431902	62388
EUR_286	0	EUR	775	43359651	43453960	94309
EUR_286	0	EUR	775	49714605	49803673	89068
EUR_286	0	EUR	775	57289191	57291065	1874
EUR_286	0	EUR	775	57712252	57806028	93776
EUR_286	0	EUR	775	58569405	58593792	24387
EUR_286	0	EUR	775	59464397	59522281	57884
EUR_286	0	EUR	775	64496625	64519080	22455
EUR_286	0	EUR	775	73519049	73587814	68765
EUR_286	0	EUR	775	75110846	75189189	78343
EUR_286	0	EUR	775	77733985	77735979	1994
EUR_286	0	EUR	775	88078757	88161538	82781
EUR_286	0	EUR	775	88167557	88172209	4652
EUR_286	0	EUR	775	88212981	88333763	120782
EUR_286	0	EUR	775	89037057	89081743	44686
EUR_286	0	EUR	775	90058636	90090830	32194
EUR_286	0	EUR	775	91072171	91107582	35411
EUR_286	0	EUR	775	93553045	93655077	102032
EUR_286	0	EUR	775	94319740	94418018	98278
EUR_286	0	EUR	775	94419260	94544971	125711
EUR_286	0	EUR	775	96904377	96942045	37668
EUR_287	0	EUR	776	2813723	3048937	235214
EUR_287	0	EUR	776	4020191	4044195	24004
EUR_287	0	EUR	776	5121074	5123781	2707
EUR_287	0	EUR	776	11703759	11708397	4638
EUR_287	0	EUR	776	12831243	12847009	15766
EUR_287	0	EUR	776	13574314	13635433	61119
EUR_287	0	EUR	776	13640984	13678187	37203
EUR_287	0	EUR	776	17749730	17822978	73248
EUR_287	0	EUR	776	18622886	18636940	14054
EUR_287	0	EUR	776	21224963	21225412	449
EUR_287	0	EUR	776	22365602	22393602	28000
EUR_287	0	EUR	776	22454245	22559756	105511
EUR_287	0	EUR	776	23432743	23480035	47292
EUR_287	0	EUR	776	23648833	23651476	2643
EUR_287	0	EUR	776	23841523	23859762	18239
EUR_287	0	EUR	776	24045382	24166883	121501
EUR_287	0	EUR	776	25140534	25305885	165351
EUR_287	0	EUR	776	26321560	26331325	9765
EUR_287	0	EUR	776	29373765	29374197	432
EUR_287	0	EUR	776	30824839	30867949	43110
EUR_287	0	EUR	776	30916037	30925177	9140
EUR_287	0	EUR	776	31235544	31314394	78850
EUR_287	0	EUR	776	36454307	36460007	5700
EUR_287	0	EUR	776	39951760	40129961	178201
EUR_287	0	EUR	776	40572310	40602505	30195
EUR_287	0	EUR	776	41319133	41360462	41329
EUR_287	0	EUR	776	50097264	50097389	125
EUR_287	0	EUR	776	54844670	54904011	59341
EUR_287	0	EUR	776	56378802	56448072	69270
EUR_287	0	EUR	776	57857678	57861351	3673
EUR_287	0	EUR	776	58093392	58136140	42748
EUR_287	0	EUR	776	59464397	59480931	16534
EUR_287	0	EUR	776	59686990	59737678	50688
EUR_287	0	EUR	776	64421884	64458245	36361
EUR_287	0	EUR	776	72292367	72298050	5683
EUR_287	0	EUR	776	72994673	73022663	27990
EUR_287	0	EUR	776	74649621	74670272	20651
EUR_287	0	EUR	776	74871541	74894548	23007
EUR_287	0	EUR	776	75263541	75282527	18986
EUR_287	0	EUR	776	84790760	84919115	128355
EUR_287	0	EUR	776	87075746	87077051	1305
EUR_287	0	EUR	776	87369479	87389813	20334
EUR_287	0	EUR	776	87504329	87507341	3012
EUR_287	0	EUR	776	87971258	87990554	19296
EUR_287	0	EUR	776	88212981	88333763	120782
EUR_287	0	EUR	776	90467547	90486618	19071
EUR_287	0	EUR	776	93553045	93610527	57482
EUR_287	0	EUR	776	93908415	93925519	17104
EUR_287	0	EUR	776	94297447	94325532	28085
EUR_287	0	EUR	776	94362487	94382190	19703
EUR_287	0	EUR	776	94595895	94698014	102119
EUR_287	0	EUR	776	95432701	95445533	12832
EUR_287	0	EUR	777	4004059	4126878	122819
EUR_287	0	EUR	777	4129102	4130169	1067
EUR_287	0	EUR	777	5018475	5041230	22755
EUR_287	0	EUR	777	12804205	12847009	42804
EUR_287	0	EUR	777	17687142	17689297	2155
EUR_287	0	EUR	777	18310807	18352711	41904
EUR_287	0	EUR	777	21150173	21156082	5909
EUR_287	0	EUR	777	21200799	21216283	15484
EUR_287	0	EUR	777	23432743	23480035	47292
EUR_287	0	EUR	777	23648833	23651476	2643
EUR_287	0	EUR	777	23841523	23859762	18239
EUR_287	0	EUR	777	24573246	24581630	8384
EUR_287	0	EUR	777	25323974	25378298	54324
EUR_287	0	EUR	777	25867195	25906725	39530
EUR_287	0	EUR	777	27971554	27974945	3391
EUR_287	0	EUR	777	29373765	29390654	16889
EUR_287	0	EUR	777	31087987	31151086	63099
EUR_287	0	EUR	777	32314299	32336893	22594
EUR_287	0	EUR	777	32767431	32880042	112611
EUR_287	0	EUR	777	35887157	35892995	5838
EUR_287	0	EUR	777	40894823	41134712	239889
EUR_287	0	EUR	777	41161176	41163502	2326
EUR_287	0	EUR	777	43556834	43624720	67886
EUR_287	0	EUR	777	53828789	53848133	19344
EUR_287	0	EUR	777	53908164	53911210	3046
EUR_287	0	EUR	777	53915328	54020486	105158
EUR_287	0	EUR	777	56378802	56448072	69270
EUR_287	0	EUR	777	59744029	59762964	18935
EUR_287	0	EUR	777	63714218	63736721	22503
EUR_287	0	EUR	777	64338347	64458245	119898
EUR_287	0	EUR	777	64502842	64519080	16238
EUR_287	0	EUR	777	80238643	80278256	39613
EUR_287	0	EUR	777	80941681	81055112	113431
EUR_287	0	EUR	777	81107841	81229503	121662
EUR_287	0	EUR	777	88527647	88537179	9532
EUR_287	0	EUR	777	92006288	92030975	24687
EUR_287	0	EUR	777	94297447	94325532	28085
EUR_287	0	EUR	777	94362487	94382190	19703
EUR_287	0	EUR	777	94595895	94701010	105115
EUR_287	0	EUR	777	96215227	96217388	2161
EUR_288	0	EUR	778	2519034	2648737	129703
EUR_288	0	EUR	778	2996253	2997995	1742
EUR_288	0	EUR	778	9149188	9164904	15716
EUR_288	0	EUR	778	21150173	21156082	5909
EUR_288	0	EUR	778	21200799	21216283	15484
EUR_288	0	EUR	778	24500404	24581630	81226
EUR_288	0	EUR	778	25230162	25305885	75723
EUR_288	0	EUR	778	26886230	26960927	74697
EUR_288	0	EUR	778	27746608	27766580	19972
EUR_288	0	EUR	778	29304480	29311528	7048
EUR_288	0	EUR	778	30904434	31040753	136319
EUR_288	0	EUR	778	31528053	31593163	65110
EUR_288	0	EUR	778	32731788	32870350	138562
EUR_288	0	EUR	778	34136759	34182116	45357
EUR_288	0	EUR	778	37727611	37762850	35239
EUR_288	0	EUR	778	39664057	39692065	28008
EUR_288	0	EUR	778	42792406	42823699	31293
EUR_288	0	EUR	778	49714605	49741250	26645
EUR_288	0	EUR	778	52286725	52294766	8041
EUR_288	0	EUR	778	53875418	53927676	52258
EUR_288	0	EUR	778	54123719	54150257	26538
EUR_288	0	EUR	778	54403505	54431022	27517
EUR_288	0	EUR	778	54686744	54688209	1465
EUR_288	0	EUR	778	57857678	57861351	3673
EUR_288	0	EUR	778	58569405	58593792	24387
EUR_288	0	EUR	778	59464397	59522281	57884
EUR_288	0	EUR	778	63714218	63732455	18237
EUR_288	0	EUR	778	71590090	71594997	4907
EUR_288	0	EUR	778	71722082	71732410	10328
EUR_288	0	EUR	778	72961212	73122070	160858
EUR_288	0	EUR	778	73519049	73527612	8563
EUR_288	0	EUR	778	73658302	73690740	32438
EUR_288	0	EUR	778	81113251	81140731	27480
EUR_288	0	EUR	778	83886982	83921060	34078
EUR_288	0	EUR	778	87533821	87546866	13045
EUR_288	0	EUR	778	88405406	88464514	59108
EUR_288	0	EUR	778	88612163	88762816	150653
EUR_288	0	EUR	778	88818076	88936674	118598
EUR_288	0	EUR	778	91087654	91097487	9833
EUR_288	0	EUR	778	93202740	93217584	14844
EUR_288	0	EUR	778	93553045	93713967	160922
EUR_288	0	EUR	778	94239181	94275395	36214
EUR_288	0	EUR	778	94793518	94886369	92851
EUR_288	0	EUR	779	2415974	2648359	232385
EUR_288	0	EUR	779	2694269	2702115	7846
EUR_288	0	EUR	779	11703759	11708397	4638
EUR_288	0	EUR	779	12804205	12847009	42804
EUR_288	0	EUR	779	16319606	16350015	30409
EUR_288	0	EUR	779	18352643	18352711	68
EUR_288	0	EUR	779	22522103	22533171	11068
EUR_288	0	EUR	779	23551311	23651476	100165
EUR_288	0	EUR	779	23721919	23797839	75920
EUR_288	0	EUR	779	24456376	24581630	125254
EUR_288	0	EUR	779	25867195	25904509	37314
EUR_288	0	EUR	779	25978125	25987107	8982
EUR_288	0	EUR	779	27746608	27843271	96663
EUR_288	0	EUR	779	29373765	29390654	16889
EUR_288	0	EUR	779	30904434	31012627	108193
EUR_288	0	EUR	779	31073056	31127610	54554
EUR_288	0	EUR	779	31260922	31314394	53472
EUR_288	0	EUR	779	31505594	31636518	130924
EUR_288	0	EUR	779	32767431	32801316	33885
EUR_288	0	EUR	779	36454307	36460007	5700
EUR_288	0	EUR	779	37815968	37906769	90801
EUR_288	0	EUR	779	52174352	52255939	81587
EUR_288	0	EUR	779	53821064	53837973	16909
EUR_288	0	EUR	779	54397910	54407949	10039
EUR_288	0	EUR	779	54693132	54796245	103113
EUR_288	0	EUR	779	59464397	59522281	57884
EUR_288	0	EUR	779	64496625	64519080	22455
EUR_288	0	EUR	779	68626746	68648432	21686
EUR_288	0	EUR	779	69023918	69036704	12786
EUR_288	0	EUR	779	74410856	74438736	27880
EUR_288	0	EUR	779	76365488	76399941	34453
EUR_288	0	EUR	779	79901897	79936163	34266
EUR_288	0	EUR	779	80852609	80881534	28925
EUR_288	0	EUR	779	81035905	81036282	377
EUR_288	0	EUR	779	85520555	85554711	34156
EUR_288	0	EUR	779	88152919	88153791	872
EUR_288	0	EUR	779	88418285	88762816	344531
EUR_288	0	EUR	779	88877686	88915947	38261
EUR_288	0	EUR	779	89420261	89465942	45681
EUR_288	0	EUR	779	92156987	92171686	14699
EUR_288	0	EUR	779	93553045	93596203	43158
EUR_288	0	EUR	779	94085070	94105458	20388
EUR_288	0	EUR	779	94297447	94375754	78307
EUR_288	0	EUR	779	99256882	99280798	23916
EUR_289	0	EUR	780	2415974	2668501	252527
EUR_289	0	EUR	780	5121074	5123781	2707
EUR_289	0	EUR	780	16432029	16437214	5185
EUR_289	0	EUR	780	18622886	18636940	14054
EUR_289	0	EUR	780	23648833	23651476	2643
EUR_289	0	EUR	780	24621120	24737906	116786
EUR_289	0	EUR	780	24809049	24866754	57705
EUR_289	0	EUR	780	25343770	25417104	73334
EUR_289	0	EUR	780	25867195	25904509	37314
EUR_289	0	EUR	780	25978125	25987107	8982
EUR_289	0	EUR	780	27746608	27810197	63589
EUR_289	0	EUR	780	30824839	31151086	326247
EUR_289	0	EUR	780	32057270	32141896	84626
EUR_289	0	EUR	780	32767431	32880042	112611
EUR_289	0	EUR	780	33316149	33336694	20545
EUR_289	0	EUR	780	37776227	37831348	55121
EUR_289	0	EUR	780	40132875	40145306	12431
EUR_289	0	EUR	780	42369514	42405338	35824
EUR_289	0	EUR	780	53961646	54076786	115140
EUR_289	0	EUR	780	54747772	54904011	156239
EUR_289	0	EUR	780	57712252	57806028	93776
EUR_289	0	EUR	780	59631177	59631623	446
EUR_289	0	EUR	780	59744029	59762964	18935
EUR_289	0	EUR	780	64421884	64458245	36361
EUR_289	0	EUR	780	69023918	69060887	36969
EUR_289	0	EUR	780	73519049	73587814	68765
EUR_289	0	EUR	780	76566986	76594146	27160
EUR_289	0	EUR	780	79860282	79909102	48820
EUR_289	0	EUR	780	88078757	88161538	82781
EUR_289	0	EUR	780	88167557	88172209	4652
EUR_289	0	EUR	780	88212981	88333763	120782
EUR_289	0	EUR	780	89037057	89081743	44686
EUR_289	0	EUR	780	90058636	90122299	63663
EUR_289	0	EUR	780	91074962	91097487	22525
EUR_289	0	EUR	780	92028660	92056341	27681
EUR_289	0	EUR	780	94290726	94412962	122236
EUR_289	0	EUR	780	94473086	94544971	71885
EUR_289	0	EUR	780	94915497	94930362	14865
EUR_289	0	EUR	780	94962888	95011492	48604
EUR_289	0	EUR	780	95774147	95774999	852
EUR_289	0	EUR	780	96136238	96151871	15633
EUR_289	0	EUR	780	96633718	96637424	3706
EUR_289	0	EUR	780	99177558	99280798	103240
EUR_289	0	EUR	781	2415974	2702115	286141
EUR_289	0	EUR	781	2996253	2997995	1742
EUR_289	0	EUR	781	3963309	4029447	66138
EUR_289	0	EUR	781	16340432	16409878	69446
EUR_289	0	EUR	781	18704683	18833631	128948
EUR_289	0	EUR	781	22365602	22393602	28000
EUR_289	0	EUR	781	24045382	24166883	121501
EUR_289	0	EUR	781	24528522	24581630	53108
EUR_289	0	EUR	781	25183341	25237709	54368
EUR_289	0	EUR	781	28087103	28104304	17201
EUR_289	0	EUR	781	29444267	29483168	38901
EUR_289	0	EUR	781	31090719	31151086	60367
EUR_289	0	EUR	781	32824940	32831059	6119
EUR_289	0	EUR	781	32851725	32880042	28317
EUR_289	0	EUR	781	52286725	52304744	18019
EUR_289	0	EUR	781	53876467	53900048	23581
EUR_289	0	EUR	781	54238494	54297173	58679
EUR_289	0	EUR	781	54300284	54330423	30139
EUR_289	0	EUR	781	54363426	54396948	33522
EUR_289	0	EUR	781	56378802	56448072	69270
EUR_289	0	EUR	781	57136159	57262845	126686
EUR_289	0	EUR	781	63714218	63732455	18237
EUR_289	0	EUR	781	64496625	64519080	22455
EUR_289	0	EUR	781	73039375	73160136	120761
EUR_289	0	EUR	781	73628865	73634178	5313
EUR_289	0	EUR	781	74019705	74036753	17048
EUR_289	0	EUR	781	75110846	75183416	72570
EUR_289	0	EUR	781	75522893	75529067	6174
EUR_289	0	EUR	781	76022322	76059358	37036
EUR_289	0	EUR	781	77733985	77735979	1994
EUR_289	0	EUR	781	79883818	79933512	49694
EUR_289	0	EUR	781	83533777	83550130	16353
EUR_289	0	EUR	781	83554127	83592822	38695
EUR_289	0	EUR	781	83955315	83957574	2259
EUR_289	0	EUR	781	87971258	87990554	19296
EUR_289	0	EUR	781	88219640	88263666	44026
EUR_289	0	EUR	781	88405406	88464514	59108
EUR_289	0	EUR	781	88612163	88762816	150653
EUR_289	0	EUR	781	88818076	88936674	118598
EUR_289	0	EUR	781	89037352	89235318	197966
EUR_289	0	EUR	781	93553045	93713967	160922
EUR_289	0	EUR	781	94297447	94418018	120571
EUR_289	0	EUR	781	94419260	94470836	51576
EUR_289	0	EUR	781	96116814	96140060	23246
EUR_290	0	EUR	782	340121	359434	19313
EUR_290	0	EUR	782	2987403	2997995	10592
EUR_290	0	EUR	782	4111555	4134871	23316
EUR_290	0	EUR	782	5121074	5123781	2707
EUR_290	0	EUR	782	14051019	14112508	61489
EUR_290	0	EUR	782	21246127	21282925	36798
EUR_290	0	EUR	782	23176150	23184805	8655
EUR_290	0	EUR	782	23648833	23651476	2643
EUR_290	0	EUR	782	23841523	23859762	18239
EUR_290	0	EUR	782	24045382	24089668	44286
EUR_290	0	EUR	782	24372241	24424495	52254
EUR_290	0	EUR	782	25741256	25777999	36743
EUR_290	0	EUR	782	26798389	26801347	2958
EUR_290	0	EUR	782	26941352	26991485	50133
EUR_290	0	EUR	782	27894016	27894364	348
EUR_290	0	EUR	782	28087103	28110553	23450
EUR_290	0	EUR	782	29332037	29365210	33173
EUR_290	0	EUR	782	30976914	31073245	96331
EUR_290	0	EUR	782	31480032	31502542	22510
EUR_290	0	EUR	782	32731788	32870350	138562
EUR_290	0	EUR	782	40132875	40145306	12431
EUR_290	0	EUR	782	40861764	40889660	27896
EUR_290	0	EUR	782	40973349	41037792	64443
EUR_290	0	EUR	782	41359664	41360462	798
EUR_290	0	EUR	782	42805387	42823699	18312
EUR_290	0	EUR	782	53821064	53870305	49241
EUR_290	0	EUR	782	54010807	54035252	24445
EUR_290	0	EUR	782	56378802	56448072	69270
EUR_290	0	EUR	782	57136159	57253147	116988
EUR_290	0	EUR	782	57264407	57291065	26658
EUR_290	0	EUR	782	59423469	59440361	16892
EUR_290	0	EUR	782	59683857	59696190	12333
EUR_290	0	EUR	782	69023918	69060887	36969
EUR_290	0	EUR	782	73628865	73634178	5313
EUR_290	0	EUR	782	75110846	75133281	22435
EUR_290	0	EUR	782	88221167	88242054	20887
EUR_290	0	EUR	782	88275443	88319207	43764
EUR_290	0	EUR	782	88527647	88610811	83164
EUR_290	0	EUR	782	88976048	89023617	47569
EUR_290	0	EUR	782	91891040	91902611	11571
EUR_290	0	EUR	782	93123848	93146298	22450
EUR_290	0	EUR	782	94297447	94392780	95333
EUR_290	0	EUR	782	94451319	94506614	55295
EUR_290	0	EUR	782	96116814	96217388	100574
EUR_290	0	EUR	782	99165891	99280798	114907
EUR_290	0	EUR	783	2898490	2998355	99865
EUR_290	0	EUR	783	5018475	5041230	22755
EUR_290	0	EUR	783	8662954	8682424	19470
EUR_290	0	EUR	783	11703759	11708397	4638
EUR_290	0	EUR	783	13076756	13125585	48829
EUR_290	0	EUR	783	13574314	13635433	61119
EUR_290	0	EUR	783	13640984	13678187	37203
EUR_290	0	EUR	783	16676133	16681323	5190
EUR_290	0	EUR	783	18310807	18352711	41904
EUR_290	0	EUR	783	22555020	22558220	3200
EUR_290	0	EUR	783	23176150	23184805	8655
EUR_290	0	EUR	783	24081636	24094707	13071
EUR_290	0	EUR	783	24892444	24894673	2229
EUR_290	0	EUR	783	31087987	31109532	21545
EUR_290	0	EUR	783	32057270	32085447	28177
EUR_290	0	EUR	783	32824940	32871485	46545
EUR_290	0	EUR	783	36350791	36376380	25589
EUR_290	0	EUR	783	37727446	37817231	89785
EUR_290	0	EUR	783	39681230	39686489	5259
EUR_290	0	EUR	783	40919189	41024466	105277
EUR_290	0	EUR	783	53847831	53859932	12101
EUR_290	0	EUR	783	53876467	54035252	158785
EUR_290	0	EUR	783	58569405	58694180	124775
EUR_290	0	EUR	783	59553546	59700527	146981
EUR_290	0	EUR	783	71670386	71678663	8277
EUR_290	0	EUR	783	72961212	72994894	33682
EUR_290	0	EUR	783	73039375	73160136	120761
EUR_290	0	EUR	783	73488506	73493479	4973
EUR_290	0	EUR	783	74037318	74066564	29246
EUR_290	0	EUR	783	74092456	74094379	1923
EUR_290	0	EUR	783	74871541	74884817	13276
EUR_290	0	EUR	783	77733985	77735979	1994
EUR_290	0	EUR	783	80161288	80278256	116968
EUR_290	0	EUR	783	81113251	81229503	116252
EUR_290	0	EUR	783	84898186	84919115	20929
EUR_290	0	EUR	783	87512858	87546866	34008
EUR_290	0	EUR	783	88077880	88113143	35263
EUR_290	0	EUR	783	88781320	88912293	130973
EUR_290	0	EUR	783	91074962	91097487	22525
EUR_290	0	EUR	783	92028660	92056341	27681
EUR_290	0	EUR	783	93800814	93869231	68417
EUR_290	0	EUR	783	94395991	94412962	16971
EUR_290	0	EUR	783	94473086	94544971	71885
EUR_291	0	EUR	784	343836	401572	57736
EUR_291	0	EUR	784	2594073	2648737	54664
EUR_291	0	EUR	784	5121074	5123781	2707
EUR_291	0	EUR	784	8662954	8682424	19470
EUR_291	0	EUR	784	12804205	12847009	42804
EUR_291	0	EUR	784	14053026	14108442	55416
EUR_291	0	EUR	784	16258452	16293048	34596
EUR_291	0	EUR	784	16318960	16331886	12926
EUR_291	0	EUR	784	21150173	21156082	5909
EUR_291	0	EUR	784	21200799	21216283	15484
EUR_291	0	EUR	784	24580740	24581630	890
EUR_291	0	EUR	784	25285126	25293981	8855
EUR_291	0	EUR	784	25498469	25501390	2921
EUR_291	0	EUR	784	26454217	26524700	70483
EUR_291	0	EUR	784	26798389	26801347	2958
EUR_291	0	EUR	784	26941352	26991485	50133
EUR_291	0	EUR	784	29365078	29432002	66924
EUR_291	0	EUR	784	31087987	31131774	43787
EUR_291	0	EUR	784	37727611	37779396	51785
EUR_291	0	EUR	784	40410992	40424856	13864
EUR_291	0	EUR	784	42430229	42456760	26531
EUR_291	0	EUR	784	53894510	53900048	5538
EUR_291	0	EUR	784	54680860	54904011	223151
EUR_291	0	EUR	784	57857678	57861351	3673
EUR_291	0	EUR	784	64496625	64519080	22455
EUR_291	0	EUR	784	68626746	68648432	21686
EUR_291	0	EUR	784	69023918	69060887	36969
EUR_291	0	EUR	784	73039375	73172795	133420
EUR_291	0	EUR	784	74871541	74894548	23007
EUR_291	0	EUR	784	75263541	75282527	18986
EUR_291	0	EUR	784	78816419	78881412	64993
EUR_291	0	EUR	784	81113251	81140731	27480
EUR_291	0	EUR	784	83886982	83921060	34078
EUR_291	0	EUR	784	87760040	87858554	98514
EUR_291	0	EUR	784	88320798	88321569	771
EUR_291	0	EUR	784	88527647	88551173	23526
EUR_291	0	EUR	784	88609381	88682270	72889
EUR_291	0	EUR	784	89037057	89081743	44686
EUR_291	0	EUR	784	90467547	90486618	19071
EUR_291	0	EUR	784	92006288	92056341	50053
EUR_291	0	EUR	784	92155254	92171686	16432
EUR_291	0	EUR	784	93553045	93655077	102032
EUR_291	0	EUR	784	94245701	94337048	91347
EUR_291	0	EUR	784	94348955	94385143	36188
EUR_291	0	EUR	784	94395991	94412962	16971
EUR_291	0	EUR	784	94473086	94544971	71885
EUR_291	0	EUR	784	94595895	94698014	102119
EUR_291	0	EUR	784	95774147	95844558	70411
EUR_291	0	EUR	784	96229638	96241778	12140
EUR_291	0	EUR	785	1330157	1385444	55287
EUR_291	0	EUR	785	2454787	2527168	72381
EUR_291	0	EUR	785	16362032	16402432	40400
EUR_291	0	EUR	785	21150173	21156082	5909
EUR_291	0	EUR	785	21200799	21216283	15484
EUR_291	0	EUR	785	23122511	23166919	44408
EUR_291	0	EUR	785	23752602	23877108	124506
EUR_291	0	EUR	785	24122637	24166883	44246
EUR_291	0	EUR	785	25140534	25305885	165351
EUR_291	0	EUR	785	26321560	26331325	9765
EUR_291	0	EUR	785	29510693	29579668	68975
EUR_291	0	EUR	785	31087987	31099584	11597
EUR_291	0	EUR	785	31233297	31314394	81097
EUR_291	0	EUR	785	31478668	31502542	23874
EUR_291	0	EUR	785	40861764	40989456	127692
EUR_291	0	EUR	785	49714605	49741250	26645
EUR_291	0	EUR	785	50097264	50097389	125
EUR_291	0	EUR	785	53821064	54034568	213504
EUR_291	0	EUR	785	54060304	54076786	16482
EUR_291	0	EUR	785	56378802	56393603	14801
EUR_291	0	EUR	785	59064557	59245738	181181
EUR_291	0	EUR	785	59674842	59696190	21348
EUR_291	0	EUR	785	63714218	63725197	10979
EUR_291	0	EUR	785	74410856	74438736	27880
EUR_291	0	EUR	785	78255010	78301884	46874
EUR_291	0	EUR	785	80897746	80899276	1530
EUR_291	0	EUR	785	80946931	81087964	141033
EUR_291	0	EUR	785	81088612	81129827	41215
EUR_291	0	EUR	785	84848072	84919115	71043
EUR_291	0	EUR	785	88221167	88242054	20887
EUR_291	0	EUR	785	88275443	88319207	43764
EUR_291	0	EUR	785	88527647	88610811	83164
EUR_291	0	EUR	785	88976048	89023617	47569
EUR_291	0	EUR	785	91026914	91107582	80668
EUR_291	0	EUR	785	95891667	95901699	10032
EUR_292	0	EUR	786	340121	359434	19313
EUR_292	0	EUR	786	1330157	1385444	55287
EUR_292	0	EUR	786	2984450	2997995	13545
EUR_292	0	EUR	786	5018475	5041230	22755
EUR_292	0	EUR	786	11778115	11795837	17722
EUR_292	0	EUR	786	12804205	12847009	42804
EUR_292	0	EUR	786	16362032	16402432	40400
EUR_292	0	EUR	786	17889447	17902017	12570
EUR_292	0	EUR	786	17997211	18041675	44464
EUR_292	0	EUR	786	21150173	21156082	5909
EUR_292	0	EUR	786	21200799	21216283	15484
EUR_292	0	EUR	786	22518171	22533171	15000
EUR_292	0	EUR	786	23095438	23113974	18536
EUR_292	0	EUR	786	23176150	23184805	8655
EUR_292	0	EUR	786	23432743	23471650	38907
EUR_292	0	EUR	786	23488326	23492190	3864
EUR_292	0	EUR	786	23721919	23725831	3912
EUR_292	0	EUR	786	24045382	24089668	44286
EUR_292	0	EUR	786	24892444	24906091	13647
EUR_292	0	EUR	786	30904434	30957155	52721
EUR_292	0	EUR	786	31098941	31127610	28669
EUR_292	0	EUR	786	31613742	31636518	22776
EUR_292	0	EUR	786	34136759	34182116	45357
EUR_292	0	EUR	786	39639062	39696725	57663
EUR_292	0	EUR	786	43359651	43413247	53596
EUR_292	0	EUR	786	43520906	43576329	55423
EUR_292	0	EUR	786	52224085	52231250	7165
EUR_292	0	EUR	786	54037247	54070402	33155
EUR_292	0	EUR	786	54225259	54396948	171689
EUR_292	0	EUR	786	54570690	54612977	42287
EUR_292	0	EUR	786	59173418	59289101	115683
EUR_292	0	EUR	786	68626746	68648432	21686
EUR_292	0	EUR	786	69023918	69060887	36969
EUR_292	0	EUR	786	73519049	73587814	68765
EUR_292	0	EUR	786	74055055	74094072	39017
EUR_292	0	EUR	786	74581736	74661574	79838
EUR_292	0	EUR	786	76566986	76594146	27160
EUR_292	0	EUR	786	76825105	76869710	44605
EUR_292	0	EUR	786	80874989	80917694	42705
EUR_292	0	EUR	786	80946931	80991209	44278
EUR_292	0	EUR	786	87512858	87546866	34008
EUR_292	0	EUR	786	88077880	88113143	35263
EUR_292	0	EUR	786	88781320	88912293	130973
EUR_292	0	EUR	786	89037352	89091247	53895
EUR_292	0	EUR	786	93145162	93146996	1834
EUR_292	0	EUR	786	93553045	93655077	102032
EUR_292	0	EUR	786	94297447	94357635	60188
EUR_292	0	EUR	787	340121	359434	19313
EUR_292	0	EUR	787	2524858	2666717	141859
EUR_292	0	EUR	787	9235548	9308590	73042
EUR_292	0	EUR	787	9356784	9420195	63411
EUR_292	0	EUR	787	14051019	14099119	48100
EUR_292	0	EUR	787	21150173	21156082	5909
EUR_292	0	EUR	787	22365602	22393602	28000
EUR_292	0	EUR	787	23648833	23651476	2643
EUR_292	0	EUR	787	24045382	24166883	121501
EUR_292	0	EUR	787	25264173	25276538	12365
EUR_292	0	EUR	787	26319359	26320890	1531
EUR_292	0	EUR	787	26473666	26491352	17686
EUR_292	0	EUR	787	26886230	26972181	85951
EUR_292	0	EUR	787	29306591	29365834	59243
EUR_292	0	EUR	787	31235544	31314394	78850
EUR_292	0	EUR	787	32057270	32084128	26858
EUR_292	0	EUR	787	33143811	33166924	23113
EUR_292	0	EUR	787	34880550	34926785	46235
EUR_292	0	EUR	787	40132875	40145306	12431
EUR_292	0	EUR	787	40410992	40424856	13864
EUR_292	0	EUR	787	41359664	41360462	798
EUR_292	0	EUR	787	42430229	42468277	38048
EUR_292	0	EUR	787	49828382	49856342	27960
EUR_292	0	EUR	787	49860683	49868492	7809
EUR_292	0	EUR	787	50097264	50097389	125
EUR_292	0	EUR	787	54113043	54177383	64340
EUR_292	0	EUR	787	63714218	63732455	18237
EUR_292	0	EUR	787	64496625	64519080	22455
EUR_292	0	EUR	787	69023918	69060887	36969
EUR_292	0	EUR	787	73519049	73587814	68765
EUR_292	0	EUR	787	74410856	74438736	27880
EUR_292	0	EUR	787	74871541	74894548	23007
EUR_292	0	EUR	787	76022322	76055308	32986
EUR_292	0	EUR	787	79883818	79933512	49694
EUR_292	0	EUR	787	80161288	80278256	116968
EUR_292	0	EUR	787	80520393	80530144	9751
EUR_292	0	EUR	787	83955315	83957574	2259
EUR_292	0	EUR	787	86916801	86926886	10085
EUR_292	0	EUR	787	88761110	88877947	116837
EUR_292	0	EUR	787	88984815	89081743	96928
EUR_292	0	EUR	787	89141128	89235318	94190
EUR_292	0	EUR	787	91087654	91097487	9833
EUR_292	0	EUR	787	93943380	94056780	113400
EUR_292	0	EUR	787	94273104	94325814	52710
EUR_292	0	EUR	787	94347548	94413385	65837
EUR_293	0	EUR	788	387573	401572	13999
EUR_293	0	EUR	788	1330157	1385444	55287
EUR_293	0	EUR	788	1762556	1775693	13137
EUR_293	0	EUR	788	4076140	4088141	12001
EUR_293	0	EUR	788	5121074	5123781	2707
EUR_293	0	EUR	788	8679492	8714283	34791
EUR_293	0	EUR	788	8783056	8928458	145402
EUR_293	0	EUR	788	12804205	12847009	42804
EUR_293	0	EUR	788	14051019	14108442	57423
EUR_293	0	EUR	788	16323977	16397990	74013
EUR_293	0	EUR	788	17749730	17804155	54425
EUR_293	0	EUR	788	22523307	22533171	9864
EUR_293	0	EUR	788	24045382	24166883	121501
EUR_293	0	EUR	788	24372241	24424495	52254
EUR_293	0	EUR	788	24516931	24581630	64699
EUR_293	0	EUR	788	25323974	25357719	33745
EUR_293	0	EUR	788	26049163	26167411	118248
EUR_293	0	EUR	788	26798389	26801347	2958
EUR_293	0	EUR	788	26941352	26991485	50133
EUR_293	0	EUR	788	27746608	27787460	40852
EUR_293	0	EUR	788	30917279	31034898	117619
EUR_293	0	EUR	788	31528053	31593163	65110
EUR_293	0	EUR	788	32862334	32871485	9151
EUR_293	0	EUR	788	33126757	33166924	40167
EUR_293	0	EUR	788	39639062	39696725	57663
EUR_293	0	EUR	788	43359651	43453960	94309
EUR_293	0	EUR	788	43538511	43576329	37818
EUR_293	0	EUR	788	54113043	54177383	64340
EUR_293	0	EUR	788	54631953	54720980	89027
EUR_293	0	EUR	788	56442176	56448072	5896
EUR_293	0	EUR	788	57803415	57806028	2613
EUR_293	0	EUR	788	59064557	59289101	224544
EUR_293	0	EUR	788	73628865	73634178	5313
EUR_293	0	EUR	788	77735282	77735979	697
EUR_293	0	EUR	788	85385813	85490844	105031
EUR_293	0	EUR	788	90159786	90243516	83730
EUR_293	0	EUR	788	91018779	91107582	88803
EUR_293	0	EUR	788	93680632	93680672	40
EUR_293	0	EUR	788	94306195	94418018	111823
EUR_293	0	EUR	788	94419260	94544971	125711
EUR_293	0	EUR	788	99230141	99279146	49005
EUR_293	0	EUR	789	2524858	2666717	141859
EUR_293	0	EUR	789	2984450	2997995	13545
EUR_293	0	EUR	789	9321331	9384265	62934
EUR_293	0	EUR	789	9431845	9449917	18072
EUR_293	0	EUR	789	16319606	16350015	30409
EUR_293	0	EUR	789	17889447	17902017	12570
EUR_293	0	EUR	789	18622886	18678327	55441
EUR_293	0	EUR	789	18743536	18844474	100938
EUR_293	0	EUR	789	22992959	23024189	31230
EUR_293	0	EUR	789	24076703	24094707	18004
EUR_293	0	EUR	789	24372241	24424495	52254
EUR_293	0	EUR	789	24516931	24581630	64699
EUR_293	0	EUR	789	25343770	25501390	157620
EUR_293	0	EUR	789	25741256	25777999	36743
EUR_293	0	EUR	789	26384189	26414390	30201
EUR_293	0	EUR	789	26477051	26529674	52623
EUR_293	0	EUR	789	29444267	29483168	38901
EUR_293	0	EUR	789	31087987	31138800	50813
EUR_293	0	EUR	789	31528053	31593163	65110
EUR_293	0	EUR	789	33143811	33166924	23113
EUR_293	0	EUR	789	36350791	36376380	25589
EUR_293	0	EUR	789	42525645	42532178	6533
EUR_293	0	EUR	789	43551091	43624720	73629
EUR_293	0	EUR	789	52224085	52231250	7165
EUR_293	0	EUR	789	53821064	54020486	199422
EUR_293	0	EUR	789	54403505	54460909	57404
EUR_293	0	EUR	789	54485671	54548846	63175
EUR_293	0	EUR	789	57227120	57291065	63945
EUR_293	0	EUR	789	71590090	71594997	4907
EUR_293	0	EUR	789	71722082	71732410	10328
EUR_293	0	EUR	789	72961212	73122070	160858
EUR_293	0	EUR	789	73519049	73527612	8563
EUR_293	0	EUR	789	73658302	73690740	32438
EUR_293	0	EUR	789	75110846	75118830	7984
EUR_293	0	EUR	789	75263541	75282527	18986
EUR_293	0	EUR	789	76843353	76869710	26357
EUR_293	0	EUR	789	77735282	77735979	697
EUR_293	0	EUR	789	79901897	79936163	34266
EUR_293	0	EUR	789	81113251	81119969	6718
EUR_293	0	EUR	789	83955315	83957574	2259
EUR_293	0	EUR	789	88224553	88317076	92523
EUR_293	0	EUR	789	88388547	88425276	36729
EUR_293	0	EUR	789	88781860	88877947	96087
EUR_293	0	EUR	789	90159786	90243516	83730
EUR_293	0	EUR	789	92062700	92125273	62573
EUR_293	0	EUR	789	93553045	93655077	102032
EUR_293	0	EUR	789	93680632	93680672	40
EUR_293	0	EUR	789	95418231	95445533	27302
EUR_294	0	EUR	790	2415974	2475854	59880
EUR_294	0	EUR	790	2695536	2854362	158826
EUR_294	0	EUR	790	14051019	14099119	48100
EUR_294	0	EUR	790	16286156	16286721	565
EUR_294	0	EUR	790	21150173	21156082	5909
EUR_294	0	EUR	790	21200799	21216283	15484
EUR_294	0	EUR	790	22365602	22393602	28000
EUR_294	0	EUR	790	22461319	22608307	146988
EUR_294	0	EUR	790	23780016	23797839	17823
EUR_294	0	EUR	790	23800188	23877108	76920
EUR_294	0	EUR	790	24892444	24894460	2016
EUR_294	0	EUR	790	25332662	25378298	45636
EUR_294	0	EUR	790	25847649	25855304	7655
EUR_294	0	EUR	790	26375604	26436121	60517
EUR_294	0	EUR	790	26580016	26580898	882
EUR_294	0	EUR	790	26886230	26991485	105255
EUR_294	0	EUR	790	27746608	27781338	34730
EUR_294	0	EUR	790	31233297	31314394	81097
EUR_294	0	EUR	790	31478668	31486281	7613
EUR_294	0	EUR	790	32731788	32855928	124140
EUR_294	0	EUR	790	33245767	33429152	183385
EUR_294	0	EUR	790	35281602	35413025	131423
EUR_294	0	EUR	790	38062578	38097333	34755
EUR_294	0	EUR	790	40410992	40424856	13864
EUR_294	0	EUR	790	49828382	49856342	27960
EUR_294	0	EUR	790	49860683	49868492	7809
EUR_294	0	EUR	790	54570690	54612977	42287
EUR_294	0	EUR	790	54663618	54667387	3769
EUR_294	0	EUR	790	57857678	57861351	3673
EUR_294	0	EUR	790	58093392	58136140	42748
EUR_294	0	EUR	790	58863206	58863428	222
EUR_294	0	EUR	790	63714218	63736721	22503
EUR_294	0	EUR	790	71722082	71732410	10328
EUR_294	0	EUR	790	72160732	72205102	44370
EUR_294	0	EUR	790	72388504	72398733	10229
EUR_294	0	EUR	790	72964182	73035038	70856
EUR_294	0	EUR	790	74410856	74438736	27880
EUR_294	0	EUR	790	75110846	75189189	78343
EUR_294	0	EUR	790	75886611	75915063	28452
EUR_294	0	EUR	790	76024488	76093521	69033
EUR_294	0	EUR	790	76502715	76594146	91431
EUR_294	0	EUR	790	79901897	79936163	34266
EUR_294	0	EUR	790	80161288	80278256	116968
EUR_294	0	EUR	790	80863277	80899276	35999
EUR_294	0	EUR	790	85520555	85554711	34156
EUR_294	0	EUR	790	87760040	87858554	98514
EUR_294	0	EUR	790	88307099	88333763	26664
EUR_294	0	EUR	790	88781860	88805716	23856
EUR_294	0	EUR	790	88876560	89001971	125411
EUR_294	0	EUR	790	89069223	89081743	12520
EUR_294	0	EUR	790	93130067	93146996	16929
EUR_294	0	EUR	790	94239181	94246784	7603
EUR_294	0	EUR	790	94347548	94418018	70470
EUR_294	0	EUR	790	94419260	94510654	91394
EUR_294	0	EUR	791	3963309	4031854	68545
EUR_294	0	EUR	791	5018475	5041230	22755
EUR_294	0	EUR	791	11532006	11542173	10167
EUR_294	0	EUR	791	12764351	12785371	21020
EUR_294	0	EUR	791	14051019	14108442	57423
EUR_294	0	EUR	791	16362032	16402432	40400
EUR_294	0	EUR	791	17889447	17902017	12570
EUR_294	0	EUR	791	21150173	21156082	5909
EUR_294	0	EUR	791	21200799	21216283	15484
EUR_294	0	EUR	791	23752602	23856810	104208
EUR_294	0	EUR	791	24513193	24581630	68437
EUR_294	0	EUR	791	26473666	26489805	16139
EUR_294	0	EUR	791	27837565	27974945	137380
EUR_294	0	EUR	791	31103212	31138800	35588
EUR_294	0	EUR	791	31528053	31593163	65110
EUR_294	0	EUR	791	32767431	32880042	112611
EUR_294	0	EUR	791	34133173	34182116	48943
EUR_294	0	EUR	791	40083840	40090192	6352
EUR_294	0	EUR	791	40947704	41087414	139710
EUR_294	0	EUR	791	42525645	42558825	33180
EUR_294	0	EUR	791	43359651	43453960	94309
EUR_294	0	EUR	791	50053800	50077224	23424
EUR_294	0	EUR	791	53926656	53973414	46758
EUR_294	0	EUR	791	54570690	54612977	42287
EUR_294	0	EUR	791	56378802	56448072	69270
EUR_294	0	EUR	791	58569405	58593792	24387
EUR_294	0	EUR	791	59319811	59341956	22145
EUR_294	0	EUR	791	64916050	64922329	6279
EUR_294	0	EUR	791	69827718	69827861	143
EUR_294	0	EUR	791	73039375	73160136	120761
EUR_294	0	EUR	791	73584558	73660589	76031
EUR_294	0	EUR	791	75110846	75189189	78343
EUR_294	0	EUR	791	79901897	79906325	4428
EUR_294	0	EUR	791	80238643	80278256	39613
EUR_294	0	EUR	791	81031954	81036282	4328
EUR_294	0	EUR	791	83955315	83957574	2259
EUR_294	0	EUR	791	89037057	89081743	44686
EUR_294	0	EUR	791	89989980	89998439	8459
EUR_294	0	EUR	791	91847626	91929323	81697
EUR_294	0	EUR	791	93553045	93567584	14539
EUR_294	0	EUR	791	93702886	93713967	11081
EUR_294	0	EUR	791	96116814	96220219	103405
EUR_294	0	EUR	791	99177558	99234126	56568
EUR_295	0	EUR	792	2524858	2666717	141859
EUR_295	0	EUR	792	5276650	5312534	35884
EUR_295	0	EUR	792	11731272	11801928	70656
EUR_295	0	EUR	792	14051019	14108442	57423
EUR_295	0	EUR	792	16234928	16286721	51793
EUR_295	0	EUR	792	18622886	18636940	14054
EUR_295	0	EUR	792	21246127	21282925	36798
EUR_295	0	EUR	792	22365602	22393602	28000
EUR_295	0	EUR	792	22519633	22532274	12641
EUR_295	0	EUR	792	22584599	22608307	23708
EUR_295	0	EUR	792	23122511	23173550	51039
EUR_295	0	EUR	792	23236907	23244178	7271
EUR_295	0	EUR	792	23765972	23789573	23601
EUR_295	0	EUR	792	23841523	23877108	35585
EUR_295	0	EUR	792	24892444	24906091	13647
EUR_295	0	EUR	792	25867195	25904509	37314
EUR_295	0	EUR	792	30904434	30907607	3173
EUR_295	0	EUR	792	31255290	31314394	59104
EUR_295	0	EUR	792	32667412	32736289	68877
EUR_295	0	EUR	792	33316683	33365746	49063
EUR_295	0	EUR	792	34880550	34926785	46235
EUR_295	0	EUR	792	35887157	35892995	5838
EUR_295	0	EUR	792	38062578	38097333	34755
EUR_295	0	EUR	792	39951760	40129961	178201
EUR_295	0	EUR	792	40572310	40602505	30195
EUR_295	0	EUR	792	41319133	41360462	41329
EUR_295	0	EUR	792	43359651	43400364	40713
EUR_295	0	EUR	792	43520906	43624720	103814
EUR_295	0	EUR	792	49828382	49856342	27960
EUR_295	0	EUR	792	49860683	49868492	7809
EUR_295	0	EUR	792	53847831	53859932	12101
EUR_295	0	EUR	792	53876467	54035252	158785
EUR_295	0	EUR	792	54327561	54397155	69594
EUR_295	0	EUR	792	57857678	57861351	3673
EUR_295	0	EUR	792	72964182	73132219	168037
EUR_295	0	EUR	792	73519049	73587814	68765
EUR_295	0	EUR	792	75166047	75182464	16417
EUR_295	0	EUR	792	75592795	75632489	39694
EUR_295	0	EUR	792	80161288	80278256	116968
EUR_295	0	EUR	792	88761110	88877947	116837
EUR_295	0	EUR	792	91074962	91107582	32620
EUR_295	0	EUR	792	91891040	91894135	3095
EUR_295	0	EUR	792	93992074	94020449	28375
EUR_295	0	EUR	792	94297447	94418018	120571
EUR_295	0	EUR	792	94419260	94479481	60221
EUR_295	0	EUR	793	2534489	2536319	1830
EUR_295	0	EUR	793	4076140	4130169	54029
EUR_295	0	EUR	793	5018475	5041230	22755
EUR_295	0	EUR	793	12804205	12847009	42804
EUR_295	0	EUR	793	13621609	13626532	4923
EUR_295	0	EUR	793	14053026	14108442	55416
EUR_295	0	EUR	793	16319606	16401162	81556
EUR_295	0	EUR	793	16416913	16454511	37598
EUR_295	0	EUR	793	18310807	18368143	57336
EUR_295	0	EUR	793	22502303	22543441	41138
EUR_295	0	EUR	793	23721919	23725831	3912
EUR_295	0	EUR	793	24621120	24737906	116786
EUR_295	0	EUR	793	24809049	24866754	57705
EUR_295	0	EUR	793	25343770	25501390	157620
EUR_295	0	EUR	793	25978368	25987107	8739
EUR_295	0	EUR	793	26403126	26429831	26705
EUR_295	0	EUR	793	27746608	27974945	228337
EUR_295	0	EUR	793	30904434	30907607	3173
EUR_295	0	EUR	793	31255290	31314394	59104
EUR_295	0	EUR	793	32824940	32828620	3680
EUR_295	0	EUR	793	32858056	32870350	12294
EUR_295	0	EUR	793	34904006	34926785	22779
EUR_295	0	EUR	793	41343966	41360462	16496
EUR_295	0	EUR	793	43359651	43471816	112165
EUR_295	0	EUR	793	52174352	52241942	67590
EUR_295	0	EUR	793	54037247	54070402	33155
EUR_295	0	EUR	793	54225259	54396948	171689
EUR_295	0	EUR	793	56378802	56448072	69270
EUR_295	0	EUR	793	75110846	75118830	7984
EUR_295	0	EUR	793	75263541	75282527	18986
EUR_295	0	EUR	793	88503129	88762816	259687
EUR_295	0	EUR	793	89356470	89389110	32640
EUR_295	0	EUR	793	92028660	92056341	27681
EUR_295	0	EUR	793	93800814	93869231	68417
EUR_295	0	EUR	793	94395991	94412962	16971
EUR_295	0	EUR	793	94473086	94544971	71885
EUR_295	0	EUR	793	96116814	96217388	100574
EUR_295	0	EUR	793	96266336	96333512	67176
EUR_296	0	EUR	794	1330157	1385444	55287
EUR_296	0	EUR	794	3890786	3910677	19891
EUR_296	0	EUR	794	11532006	11542173	10167
EUR_296	0	EUR	794	12804205	12847009	42804
EUR_296	0	EUR	794	13574314	13635433	61119
EUR_296	0	EUR	794	13640984	13678187	37203
EUR_296	0	EUR	794	16202082	16325554	123472
EUR_296	0	EUR	794	18100331	18140078	39747
EUR_296	0	EUR	794	18717757	18844474	126717
EUR_296	0	EUR	794	21246127	21282925	36798
EUR_296	0	EUR	794	23176150	23184805	8655
EUR_296	0	EUR	794	23427310	23492190	64880
EUR_296	0	EUR	794	23721919	23725831	3912
EUR_296	0	EUR	794	24123653	24166883	43230
EUR_296	0	EUR	794	25953989	25987107	33118
EUR_296	0	EUR	794	27746608	27808072	61464
EUR_296	0	EUR	794	29321833	29348593	26760
EUR_296	0	EUR	794	32781294	32880042	98748
EUR_296	0	EUR	794	34136759	34138136	1377
EUR_296	0	EUR	794	35887157	35892995	5838
EUR_296	0	EUR	794	43359651	43449383	89732
EUR_296	0	EUR	794	49720942	49741250	20308
EUR_296	0	EUR	794	49923584	49953714	30130
EUR_296	0	EUR	794	51971549	52007205	35656
EUR_296	0	EUR	794	54503155	54757478	254323
EUR_296	0	EUR	794	57803415	57806028	2613
EUR_296	0	EUR	794	59064557	59068204	3647
EUR_296	0	EUR	794	63714218	63732455	18237
EUR_296	0	EUR	794	64338347	64454545	116198
EUR_296	0	EUR	794	68626746	68648432	21686
EUR_296	0	EUR	794	72292367	72298050	5683
EUR_296	0	EUR	794	75263541	75282527	18986
EUR_296	0	EUR	794	76022322	76055308	32986
EUR_296	0	EUR	794	79082049	79134588	52539
EUR_296	0	EUR	794	88761110	89009551	248441
EUR_296	0	EUR	794	94040795	94056780	15985
EUR_296	0	EUR	794	94297447	94354033	56586
EUR_296	0	EUR	794	94355051	94527670	172619
EUR_296	0	EUR	795	399889	401572	1683
EUR_296	0	EUR	795	1322727	1329694	6967
EUR_296	0	EUR	795	4112155	4126878	14723
EUR_296	0	EUR	795	4129102	4130169	1067
EUR_296	0	EUR	795	5018475	5041230	22755
EUR_296	0	EUR	795	8662954	8682424	19470
EUR_296	0	EUR	795	9251276	9299543	48267
EUR_296	0	EUR	795	9413335	9449917	36582
EUR_296	0	EUR	795	13432461	13607135	174674
EUR_296	0	EUR	795	16223994	16240882	16888
EUR_296	0	EUR	795	16243211	16293593	50382
EUR_296	0	EUR	795	18310807	18352711	41904
EUR_296	0	EUR	795	21246127	21276019	29892
EUR_296	0	EUR	795	23752602	23856810	104208
EUR_296	0	EUR	795	24485266	24581630	96364
EUR_296	0	EUR	795	25867195	25906725	39530
EUR_296	0	EUR	795	31127142	31138800	11658
EUR_296	0	EUR	795	31567042	31593163	26121
EUR_296	0	EUR	795	32057270	32084128	26858
EUR_296	0	EUR	795	32824940	32828620	3680
EUR_296	0	EUR	795	32858056	32870350	12294
EUR_296	0	EUR	795	34139435	34182116	42681
EUR_296	0	EUR	795	35450233	35540040	89807
EUR_296	0	EUR	795	35771774	35849669	77895
EUR_296	0	EUR	795	37727611	37779396	51785
EUR_296	0	EUR	795	37847322	38097333	250011
EUR_296	0	EUR	795	39639062	39696725	57663
EUR_296	0	EUR	795	40919189	41024466	105277
EUR_296	0	EUR	795	42525645	42532178	6533
EUR_296	0	EUR	795	49714605	49741250	26645
EUR_296	0	EUR	795	54113043	54165941	52898
EUR_296	0	EUR	795	54344064	54362674	18610
EUR_296	0	EUR	795	56378802	56448072	69270
EUR_296	0	EUR	795	57242326	57259146	16820
EUR_296	0	EUR	795	58097270	58136140	38870
EUR_296	0	EUR	795	58863206	58863428	222
EUR_296	0	EUR	795	59464397	59522281	57884
EUR_296	0	EUR	795	59651751	59700527	48776
EUR_296	0	EUR	795	72288615	72298050	9435
EUR_296	0	EUR	795	74596535	74644598	48063
EUR_296	0	EUR	795	75617338	75632489	15151
EUR_296	0	EUR	795	76571079	76594146	23067
EUR_296	0	EUR	795	83382253	83384810	2557
EUR_296	0	EUR	795	88078757	88156291	77534
EUR_296	0	EUR	795	88200401	88319207	118806
EUR_296	0	EUR	795	88452177	88464514	12337
EUR_296	0	EUR	795	88476761	88537179	60418
EUR_296	0	EUR	795	89054631	89235318	180687
EUR_296	0	EUR	795	90153798	90243516	89718
EUR_296	0	EUR	795	91060676	91107582	46906
EUR_296	0	EUR	795	91891040	91902611	11571
EUR_296	0	EUR	795	93361912	93411339	49427
EUR_296	0	EUR	795	93943380	93998654	55274
EUR_296	0	EUR	795	94339994	94418018	78024
EUR_296	0	EUR	795	94419260	94544971	125711
EUR_296	0	EUR	795	96116814	96333512	216698
EUR_297	0	EUR	796	2474815	2585126	110311
EUR_297	0	EUR	796	4004059	4125657	121598
EUR_297	0	EUR	796	11703759	11708397	4638
EUR_297	0	EUR	796	12764351	12785371	21020
EUR_297	0	EUR	796	16234928	16286721	51793
EUR_297	0	EUR	796	17749730	17773100	23370
EUR_297	0	EUR	796	18717757	18844474	126717
EUR_297	0	EUR	796	21150173	21156082	5909
EUR_297	0	EUR	796	21200799	21216283	15484
EUR_297	0	EUR	796	21411240	21429464	18224
EUR_297	0	EUR	796	23176150	23184805	8655
EUR_297	0	EUR	796	25140534	25305885	165351
EUR_297	0	EUR	796	25455175	25501390	46215
EUR_297	0	EUR	796	25867195	25904509	37314
EUR_297	0	EUR	796	26908028	26991485	83457
EUR_297	0	EUR	796	28619504	28692721	73217
EUR_297	0	EUR	796	29373765	29390654	16889
EUR_297	0	EUR	796	31087987	31151086	63099
EUR_297	0	EUR	796	32770051	32870350	100299
EUR_297	0	EUR	796	37748178	37895954	147776
EUR_297	0	EUR	796	37989082	38011051	21969
EUR_297	0	EUR	796	40047500	40068128	20628
EUR_297	0	EUR	796	40919189	41024466	105277
EUR_297	0	EUR	796	43454755	43507455	52700
EUR_297	0	EUR	796	50186705	50211031	24326
EUR_297	0	EUR	796	53875418	53927676	52258
EUR_297	0	EUR	796	54123719	54150257	26538
EUR_297	0	EUR	796	54403505	54431022	27517
EUR_297	0	EUR	796	57857678	57861351	3673
EUR_297	0	EUR	796	59553546	59700527	146981
EUR_297	0	EUR	796	64372692	64406792	34100
EUR_297	0	EUR	796	68626746	68648432	21686
EUR_297	0	EUR	796	69827718	69827861	143
EUR_297	0	EUR	796	71722082	71732410	10328
EUR_297	0	EUR	796	73488506	73493473	4967
EUR_297	0	EUR	796	73599206	73660589	61383
EUR_297	0	EUR	796	74871541	74894548	23007
EUR_297	0	EUR	796	75522893	75592747	69854
EUR_297	0	EUR	796	76365488	76397099	31611
EUR_297	0	EUR	796	77733985	77735979	1994
EUR_297	0	EUR	796	79860282	79887044	26762
EUR_297	0	EUR	796	79901897	79903521	1624
EUR_297	0	EUR	796	79921893	79936163	14270
EUR_297	0	EUR	796	83955315	83957574	2259
EUR_297	0	EUR	796	84848072	84919115	71043
EUR_297	0	EUR	796	88221167	88242054	20887
EUR_297	0	EUR	796	88275443	88319207	43764
EUR_297	0	EUR	796	88527647	88610811	83164
EUR_297	0	EUR	796	88976048	89023617	47569
EUR_297	0	EUR	796	91026914	91107582	80668
EUR_297	0	EUR	796	95891667	95901699	10032
EUR_297	0	EUR	797	2454787	2527168	72381
EUR_297	0	EUR	797	9413335	9449917	36582
EUR_297	0	EUR	797	11703759	11708397	4638
EUR_297	0	EUR	797	16362032	16402432	40400
EUR_297	0	EUR	797	18100331	18140078	39747
EUR_297	0	EUR	797	18742110	18751123	9013
EUR_297	0	EUR	797	20981647	21202559	220912
EUR_297	0	EUR	797	21310174	21428203	118029
EUR_297	0	EUR	797	22519633	22533171	13538
EUR_297	0	EUR	797	22992959	23024189	31230
EUR_297	0	EUR	797	23432743	23480035	47292
EUR_297	0	EUR	797	23648833	23651476	2643
EUR_297	0	EUR	797	23841523	23859762	18239
EUR_297	0	EUR	797	25140534	25305885	165351
EUR_297	0	EUR	797	25455175	25501390	46215
EUR_297	0	EUR	797	25950286	25987107	36821
EUR_297	0	EUR	797	26048379	26143612	95233
EUR_297	0	EUR	797	29347606	29396432	48826
EUR_297	0	EUR	797	31090441	31109532	19091
EUR_297	0	EUR	797	35887157	35892995	5838
EUR_297	0	EUR	797	37727611	37861599	133988
EUR_297	0	EUR	797	39683574	39692065	8491
EUR_297	0	EUR	797	40003482	40145306	141824
EUR_297	0	EUR	797	43359651	43471816	112165
EUR_297	0	EUR	797	53821064	53859932	38868
EUR_297	0	EUR	797	54123719	54150257	26538
EUR_297	0	EUR	797	54403505	54431022	27517
EUR_297	0	EUR	797	54686744	54688209	1465
EUR_297	0	EUR	797	54714203	54889259	175056
EUR_297	0	EUR	797	57136159	57253147	116988
EUR_297	0	EUR	797	57264407	57291065	26658
EUR_297	0	EUR	797	57857678	57861351	3673
EUR_297	0	EUR	797	64338347	64458245	119898
EUR_297	0	EUR	797	69023918	69052189	28271
EUR_297	0	EUR	797	72964182	73031970	67788
EUR_297	0	EUR	797	73500653	73660589	159936
EUR_297	0	EUR	797	74092456	74139119	46663
EUR_297	0	EUR	797	75110846	75133281	22435
EUR_297	0	EUR	797	76133814	76143984	10170
EUR_297	0	EUR	797	76805591	76969243	163652
EUR_297	0	EUR	797	77880564	77881732	1168
EUR_297	0	EUR	797	79883818	79933512	49694
EUR_297	0	EUR	797	80213282	80278256	64974
EUR_297	0	EUR	797	80863277	80899276	35999
EUR_297	0	EUR	797	83533777	83550130	16353
EUR_297	0	EUR	797	83554127	83592822	38695
EUR_297	0	EUR	797	83955315	83957574	2259
EUR_297	0	EUR	797	87971258	87990554	19296
EUR_297	0	EUR	797	88219640	88263666	44026
EUR_297	0	EUR	797	88405406	88464514	59108
EUR_297	0	EUR	797	88612163	88762816	150653
EUR_297	0	EUR	797	88818076	88936674	118598
EUR_297	0	EUR	797	89037352	89235318	197966
EUR_297	0	EUR	797	92022074	92044148	22074
EUR_297	0	EUR	797	93361912	93411339	49427
EUR_297	0	EUR	797	93553045	93655077	102032
EUR_297	0	EUR	797	94290726	94303086	12360
EUR_297	0	EUR	797	95418231	95445533	27302
EUR_297	0	EUR	797	96229638	96241778	12140
EUR_298	0	EUR	798	340121	359434	19313
EUR_298	0	EUR	798	2695536	2814296	118760
EUR_298	0	EUR	798	5018475	5041230	22755
EUR_298	0	EUR	798	9235548	9270524	34976
EUR_298	0	EUR	798	11650195	11731498	81303
EUR_298	0	EUR	798	12764351	12845452	81101
EUR_298	0	EUR	798	18100331	18140078	39747
EUR_298	0	EUR	798	18716646	18844474	127828
EUR_298	0	EUR	798	21246127	21282925	36798
EUR_298	0	EUR	798	22279659	22313169	33510
EUR_298	0	EUR	798	22456611	22462305	5694
EUR_298	0	EUR	798	24045382	24166883	121501
EUR_298	0	EUR	798	24372241	24424495	52254
EUR_298	0	EUR	798	24516931	24581630	64699
EUR_298	0	EUR	798	24892444	24906091	13647
EUR_298	0	EUR	798	31087987	31109532	21545
EUR_298	0	EUR	798	31137232	31151086	13854
EUR_298	0	EUR	798	32862334	32871485	9151
EUR_298	0	EUR	798	33126757	33166924	40167
EUR_298	0	EUR	798	35771774	35849669	77895
EUR_298	0	EUR	798	40555384	40602505	47121
EUR_298	0	EUR	798	42525645	42532178	6533
EUR_298	0	EUR	798	51948707	51970395	21688
EUR_298	0	EUR	798	54503155	54577206	74051
EUR_298	0	EUR	798	57857678	57861351	3673
EUR_298	0	EUR	798	64496625	64519080	22455
EUR_298	0	EUR	798	69023918	69060887	36969
EUR_298	0	EUR	798	74871541	74894548	23007
EUR_298	0	EUR	798	75263541	75282527	18986
EUR_298	0	EUR	798	77733985	77735979	1994
EUR_298	0	EUR	798	78839770	78881412	41642
EUR_298	0	EUR	798	79860282	79894254	33972
EUR_298	0	EUR	798	80946931	81087964	141033
EUR_298	0	EUR	798	81088612	81190655	102043
EUR_298	0	EUR	798	83886982	83921060	34078
EUR_298	0	EUR	798	87665598	87707527	41929
EUR_298	0	EUR	798	88258345	88319207	60862
EUR_298	0	EUR	798	88527647	88554847	27200
EUR_298	0	EUR	798	88895018	89081743	186725
EUR_298	0	EUR	798	89455722	89465942	10220
EUR_298	0	EUR	798	90058636	90122299	63663
EUR_298	0	EUR	798	90699420	90755700	56280
EUR_298	0	EUR	798	94447447	94522438	74991
EUR_298	0	EUR	798	99230141	99279146	49005
EUR_298	0	EUR	799	1330157	1385444	55287
EUR_298	0	EUR	799	4076140	4088141	12001
EUR_298	0	EUR	799	5121074	5123781	2707
EUR_298	0	EUR	799	9235548	9308590	73042
EUR_298	0	EUR	799	9356784	9449917	93133
EUR_298	0	EUR	799	11806319	11814111	7792
EUR_298	0	EUR	799	16234928	16286721	51793
EUR_298	0	EUR	799	18100331	18140078	39747
EUR_298	0	EUR	799	21411240	21429464	18224
EUR_298	0	EUR	799	23120612	23120638	26
EUR_298	0	EUR	799	23427310	23445777	18467
EUR_298	0	EUR	799	23752602	23856810	104208
EUR_298	0	EUR	799	24892444	24894673	2229
EUR_298	0	EUR	799	25953989	25987107	33118
EUR_298	0	EUR	799	27820662	27974945	154283
EUR_298	0	EUR	799	29306780	29311528	4748
EUR_298	0	EUR	799	30904434	30927066	22632
EUR_298	0	EUR	799	31480032	31502542	22510
EUR_298	0	EUR	799	32081977	32141896	59919
EUR_298	0	EUR	799	33298309	33324776	26467
EUR_298	0	EUR	799	34151714	34182116	30402
EUR_298	0	EUR	799	37727611	37779396	51785
EUR_298	0	EUR	799	37847322	38097333	250011
EUR_298	0	EUR	799	39639062	39696725	57663
EUR_298	0	EUR	799	40919189	41024466	105277
EUR_298	0	EUR	799	42525645	42532178	6533
EUR_298	0	EUR	799	53961646	54076786	115140
EUR_298	0	EUR	799	69023918	69060887	36969
EUR_298	0	EUR	799	74871541	74894548	23007
EUR_298	0	EUR	799	75263541	75282527	18986
EUR_298	0	EUR	799	76566986	76594146	27160
EUR_298	0	EUR	799	80967828	81087964	120136
EUR_298	0	EUR	799	81088612	81229503	140891
EUR_298	0	EUR	799	86916801	86971491	54690
EUR_298	0	EUR	799	87385759	87389813	4054
EUR_298	0	EUR	799	87969149	87990554	21405
EUR_298	0	EUR	799	88821331	88877947	56616
EUR_298	0	EUR	799	90058636	90095537	36901
EUR_298	0	EUR	799	91068327	91107582	39255
EUR_298	0	EUR	799	92065436	92171686	106250
EUR_298	0	EUR	799	93361912	93411339	49427
EUR_298	0	EUR	799	94395991	94412962	16971
EUR_298	0	EUR	799	94473086	94544971	71885
EUR_299	0	EUR	800	2415974	2527168	111194
EUR_299	0	EUR	800	2540949	2643426	102477
EUR_299	0	EUR	800	2813723	2921372	107649
EUR_299	0	EUR	800	5276650	5312534	35884
EUR_299	0	EUR	800	12831243	12847009	15766
EUR_299	0	EUR	800	13621609	13626532	4923
EUR_299	0	EUR	800	14053026	14108442	55416
EUR_299	0	EUR	800	16319606	16401162	81556
EUR_299	0	EUR	800	18081536	18107085	25549
EUR_299	0	EUR	800	22519633	22533171	13538
EUR_299	0	EUR	800	23648833	23651476	2643
EUR_299	0	EUR	800	24580740	24581630	890
EUR_299	0	EUR	800	24892444	24906091	13647
EUR_299	0	EUR	800	25343770	25501390	157620
EUR_299	0	EUR	800	26473666	26489805	16139
EUR_299	0	EUR	800	27746608	27759553	12945
EUR_299	0	EUR	800	29444267	29483168	38901
EUR_299	0	EUR	800	29541243	29579668	38425
EUR_299	0	EUR	800	30904434	31040753	136319
EUR_299	0	EUR	800	31235544	31240114	4570
EUR_299	0	EUR	800	32081977	32141896	59919
EUR_299	0	EUR	800	34889103	34926785	37682
EUR_299	0	EUR	800	37722669	37749485	26816
EUR_299	0	EUR	800	37809118	37815963	6845
EUR_299	0	EUR	800	37855802	37890590	34788
EUR_299	0	EUR	800	40410992	40421024	10032
EUR_299	0	EUR	800	43485261	43515922	30661
EUR_299	0	EUR	800	49714605	49781657	67052
EUR_299	0	EUR	800	53961646	54076786	115140
EUR_299	0	EUR	800	54686744	54688209	1465
EUR_299	0	EUR	800	54714203	54904011	189808
EUR_299	0	EUR	800	56378802	56448072	69270
EUR_299	0	EUR	800	57712252	57806900	94648
EUR_299	0	EUR	800	59441578	59522281	80703
EUR_299	0	EUR	800	63714218	63755889	41671
EUR_299	0	EUR	800	71670386	71678663	8277
EUR_299	0	EUR	800	72160732	72164596	3864
EUR_299	0	EUR	800	72388504	72398733	10229
EUR_299	0	EUR	800	74410856	74438736	27880
EUR_299	0	EUR	800	74871541	74894548	23007
EUR_299	0	EUR	800	81113251	81189650	76399
EUR_299	0	EUR	800	83533777	83550130	16353
EUR_299	0	EUR	800	83554127	83592822	38695
EUR_299	0	EUR	800	88126552	88260108	133556
EUR_299	0	EUR	800	88320798	88321569	771
EUR_299	0	EUR	800	88527647	88551173	23526
EUR_299	0	EUR	800	88609381	88682270	72889
EUR_299	0	EUR	800	89080522	89235318	154796
EUR_299	0	EUR	800	90058636	90121618	62982
EUR_299	0	EUR	800	91018779	91107582	88803
EUR_299	0	EUR	800	93553045	93607994	54949
EUR_299	0	EUR	800	93630747	93713967	83220
EUR_299	0	EUR	800	94239181	94337048	97867
EUR_299	0	EUR	800	94348955	94544971	196016
EUR_299	0	EUR	800	99256882	99280798	23916
EUR_299	0	EUR	801	2519034	2648737	129703
EUR_299	0	EUR	801	2996253	2997995	1742
EUR_299	0	EUR	801	8697921	8714283	16362
EUR_299	0	EUR	801	8783056	8849385	66329
EUR_299	0	EUR	801	11703759	11708397	4638
EUR_299	0	EUR	801	13076756	13125585	48829
EUR_299	0	EUR	801	13574314	13635433	61119
EUR_299	0	EUR	801	13640984	13678187	37203
EUR_299	0	EUR	801	17749730	17804155	54425
EUR_299	0	EUR	801	18787414	18806641	19227
EUR_299	0	EUR	801	21150173	21156082	5909
EUR_299	0	EUR	801	21200799	21216283	15484
EUR_299	0	EUR	801	22320042	22417821	97779
EUR_299	0	EUR	801	22454245	22608307	154062
EUR_299	0	EUR	801	23850473	23877108	26635
EUR_299	0	EUR	801	24081636	24094707	13071
EUR_299	0	EUR	801	24380643	24581630	200987
EUR_299	0	EUR	801	24892444	24906091	13647
EUR_299	0	EUR	801	29321833	29348593	26760
EUR_299	0	EUR	801	29569955	29579668	9713
EUR_299	0	EUR	801	31613742	31636518	22776
EUR_299	0	EUR	801	32824940	32871485	46545
EUR_299	0	EUR	801	37727446	37861599	134153
EUR_299	0	EUR	801	39664057	39692065	28008
EUR_299	0	EUR	801	40410992	40602505	191513
EUR_299	0	EUR	801	43359651	43453960	94309
EUR_299	0	EUR	801	49828382	49856342	27960
EUR_299	0	EUR	801	49860683	49868492	7809
EUR_299	0	EUR	801	50097264	50097389	125
EUR_299	0	EUR	801	54765460	54846996	81536
EUR_299	0	EUR	801	58093392	58136140	42748
EUR_299	0	EUR	801	59409355	59432970	23615
EUR_299	0	EUR	801	59500463	59522281	21818
EUR_299	0	EUR	801	59744029	59762964	18935
EUR_299	0	EUR	801	64410265	64473871	63606
EUR_299	0	EUR	801	69023918	69060887	36969
EUR_299	0	EUR	801	72964182	73025023	60841
EUR_299	0	EUR	801	74871541	74894548	23007
EUR_299	0	EUR	801	76022322	76055308	32986
EUR_299	0	EUR	801	76365488	76395555	30067
EUR_299	0	EUR	801	79082049	79134588	52539
EUR_299	0	EUR	801	87760040	87858554	98514
EUR_299	0	EUR	801	88527647	88537179	9532
EUR_299	0	EUR	801	90752295	90969654	217359
EUR_299	0	EUR	801	92006288	92056341	50053
EUR_299	0	EUR	801	93553045	93596203	43158
EUR_299	0	EUR	801	93607125	93647010	39885
EUR_299	0	EUR	801	93908281	93925519	17238
EUR_299	0	EUR	801	94005320	94105458	100138
EUR_299	0	EUR	801	94297447	94418018	120571
EUR_299	0	EUR	801	94419260	94442951	23691
EUR_299	0	EUR	801	94528754	94530882	2128
EUR_299	0	EUR	801	95315455	95445533	130078
EUR_299	0	EUR	801	96144084	96201851	57767
EUR_300	0	EUR	802	1762556	1775693	13137
EUR_300	0	EUR	802	2524858	2666717	141859
EUR_300	0	EUR	802	4076140	4130169	54029
EUR_300	0	EUR	802	8698156	8699527	1371
EUR_300	0	EUR	802	9235548	9270524	34976
EUR_300	0	EUR	802	17918899	18041675	122776
EUR_300	0	EUR	802	23752602	23856810	104208
EUR_300	0	EUR	802	24507871	24517101	9230
EUR_300	0	EUR	802	25151604	25305885	154281
EUR_300	0	EUR	802	29273800	29279379	5579
EUR_300	0	EUR	802	29378375	29432002	53627
EUR_300	0	EUR	802	30904434	31092945	188511
EUR_300	0	EUR	802	32057270	32141896	84626
EUR_300	0	EUR	802	32824940	32828620	3680
EUR_300	0	EUR	802	32858056	32870350	12294
EUR_300	0	EUR	802	35887157	35892995	5838
EUR_300	0	EUR	802	37727611	37757885	30274
EUR_300	0	EUR	802	40410992	40431907	20915
EUR_300	0	EUR	802	40545028	40602505	57477
EUR_300	0	EUR	802	41319133	41360462	41329
EUR_300	0	EUR	802	42430229	42432396	2167
EUR_300	0	EUR	802	43359651	43413247	53596
EUR_300	0	EUR	802	49741621	49846762	105141
EUR_300	0	EUR	802	50053800	50097389	43589
EUR_300	0	EUR	802	56433850	56448072	14222
EUR_300	0	EUR	802	57857678	57861351	3673
EUR_300	0	EUR	802	58863206	58863428	222
EUR_300	0	EUR	802	59724175	59737678	13503
EUR_300	0	EUR	802	64338347	64382745	44398
EUR_300	0	EUR	802	78831605	78886366	54761
EUR_300	0	EUR	802	79901897	79936163	34266
EUR_300	0	EUR	802	80238540	80278256	39716
EUR_300	0	EUR	802	80863277	80899276	35999
EUR_300	0	EUR	802	80946931	81087964	141033
EUR_300	0	EUR	802	81088612	81190655	102043
EUR_300	0	EUR	802	87665598	87721794	56196
EUR_300	0	EUR	802	88077880	88172209	94329
EUR_300	0	EUR	802	88212981	88333763	120782
EUR_300	0	EUR	802	88405406	88464514	59108
EUR_300	0	EUR	802	88476761	88537179	60418
EUR_300	0	EUR	802	88761110	88877947	116837
EUR_300	0	EUR	802	90159786	90243516	83730
EUR_300	0	EUR	802	91018779	91107582	88803
EUR_300	0	EUR	802	91900017	91902611	2594
EUR_300	0	EUR	802	93553045	93558539	5494
EUR_300	0	EUR	802	93943380	94056780	113400
EUR_300	0	EUR	802	94297447	94392780	95333
EUR_300	0	EUR	802	94451319	94506614	55295
EUR_300	0	EUR	803	343836	401572	57736
EUR_300	0	EUR	803	1229602	1329694	100092
EUR_300	0	EUR	803	2415974	2702115	286141
EUR_300	0	EUR	803	2947381	3048937	101556
EUR_300	0	EUR	803	3963320	4017634	54314
EUR_300	0	EUR	803	8712318	8714283	1965
EUR_300	0	EUR	803	11703759	11814111	110352
EUR_300	0	EUR	803	12804205	12847009	42804
EUR_300	0	EUR	803	13574314	13635433	61119
EUR_300	0	EUR	803	13640984	13678187	37203
EUR_300	0	EUR	803	16223994	16240882	16888
EUR_300	0	EUR	803	16243211	16250084	6873
EUR_300	0	EUR	803	16322068	16402432	80364
EUR_300	0	EUR	803	18310807	18368143	57336
EUR_300	0	EUR	803	23156936	23184805	27869
EUR_300	0	EUR	803	23648833	23651476	2643
EUR_300	0	EUR	803	24560850	24581630	20780
EUR_300	0	EUR	803	25285126	25305885	20759
EUR_300	0	EUR	803	25867195	25904509	37314
EUR_300	0	EUR	803	26319359	26331325	11966
EUR_300	0	EUR	803	26798389	26801347	2958
EUR_300	0	EUR	803	26941352	26991485	50133
EUR_300	0	EUR	803	31087987	31109532	21545
EUR_300	0	EUR	803	31137232	31151086	13854
EUR_300	0	EUR	803	32862334	32871485	9151
EUR_300	0	EUR	803	33126757	33166924	40167
EUR_300	0	EUR	803	40549617	40602505	52888
EUR_300	0	EUR	803	40919189	41024466	105277
EUR_300	0	EUR	803	42805387	42823699	18312
EUR_300	0	EUR	803	43576368	43624720	48352
EUR_300	0	EUR	803	53821064	53859932	38868
EUR_300	0	EUR	803	53920797	54020486	99689
EUR_300	0	EUR	803	54686744	54688209	1465
EUR_300	0	EUR	803	54714203	54904011	189808
EUR_300	0	EUR	803	57254822	57262845	8023
EUR_300	0	EUR	803	57712252	57806900	94648
EUR_300	0	EUR	803	59631177	59631623	446
EUR_300	0	EUR	803	64338347	64519080	180733
EUR_300	0	EUR	803	69048774	69068474	19700
EUR_300	0	EUR	803	70541408	70544348	2940
EUR_300	0	EUR	803	78263002	78301884	38882
EUR_300	0	EUR	803	83955315	83957574	2259
EUR_300	0	EUR	803	87533821	87546866	13045
EUR_300	0	EUR	803	89017110	89038093	20983
EUR_300	0	EUR	803	90153261	90211457	58196
EUR_300	0	EUR	803	93172929	93217584	44655
EUR_300	0	EUR	803	93877236	93921319	44083
EUR_300	0	EUR	803	95798227	95817637	19410
EUR_300	0	EUR	803	96116814	96126931	10117
EUR_300	0	EUR	803	96136238	96175807	39569
