name	time	pop	left	right	length
EUR_1	50000	EUR	18490232	18989792	499560
EUR_1	50000	EUR	65795515	65914179	118664
EUR_1	50000	EUR	78878597	79552411	673814
EUR_1	50000	EUR	98060996	99326901	1265905
EUR_1	50000	EUR	33719805	34580064	860259
EUR_1	50000	EUR	36031219	36842882	811663
EUR_1	50000	EUR	53446048	53773504	327456
EUR_1	50000	EUR	60564830	61077181	512351
EUR_1	50000	EUR	81588636	81853668	265032
EUR_2	50000	EUR	1644597	2564563	919966
EUR_2	50000	EUR	6852588	7294627	442039
EUR_2	50000	EUR	32141097	32278194	137097
EUR_2	50000	EUR	53446048	53773504	327456
EUR_2	50000	EUR	59031696	59148871	117175
EUR_2	50000	EUR	69346236	70876284	1530048
EUR_2	50000	EUR	2237901	2334690	96789
EUR_2	50000	EUR	12834788	13154318	319530
EUR_2	50000	EUR	19529742	19783966	254224
EUR_2	50000	EUR	24662397	25374589	712192
EUR_2	50000	EUR	90541322	90694613	153291
EUR_3	50000	EUR	20549377	20871441	322064
EUR_3	50000	EUR	32546422	33059919	513497
EUR_3	50000	EUR	52166713	52418095	251382
EUR_3	50000	EUR	2823983	2874343	50360
EUR_3	50000	EUR	19008045	19292371	284326
EUR_3	50000	EUR	31631287	32050859	419572
EUR_3	50000	EUR	71287082	72141420	854338
EUR_4	50000	EUR	7188561	7789627	601066
EUR_4	50000	EUR	8431415	8625598	194183
EUR_4	50000	EUR	54324248	54800018	475770
EUR_4	50000	EUR	56643677	56993948	350271
EUR_4	50000	EUR	71894175	72359992	465817
EUR_4	50000	EUR	81569018	84140044	2571026
EUR_4	50000	EUR	42354196	42672949	318753
EUR_4	50000	EUR	55752772	56650346	897574
EUR_4	50000	EUR	70119979	70928174	808195
EUR_5	50000	EUR	2823983	2874343	50360
EUR_5	50000	EUR	19008045	19292371	284326
EUR_5	50000	EUR	31271798	31925553	653755
EUR_5	50000	EUR	59358602	59536453	177851
EUR_5	50000	EUR	93405752	93469186	63434
EUR_5	50000	EUR	3438658	3825022	386364
EUR_5	50000	EUR	9253222	9861294	608072
EUR_5	50000	EUR	16741997	17064508	322511
EUR_5	50000	EUR	57988115	58056151	68036
EUR_6	50000	EUR	1542208	2150661	608453
EUR_6	50000	EUR	49360583	49632193	271610
EUR_6	50000	EUR	19529742	20077459	547717
EUR_6	50000	EUR	64365318	65400112	1034794
EUR_6	50000	EUR	81743006	81833293	90287
EUR_6	50000	EUR	84423784	84449000	25216
EUR_6	50000	EUR	85413755	86861695	1447940
EUR_7	50000	EUR	87198423	87206061	7638
EUR_7	50000	EUR	4108206	5133534	1025328
EUR_7	50000	EUR	27031442	27808842	777400
EUR_7	50000	EUR	32141097	32278194	137097
EUR_7	50000	EUR	57055122	57273245	218123
EUR_7	50000	EUR	69782341	72359992	2577651
EUR_7	50000	EUR	87405174	87685864	280690
EUR_7	50000	EUR	93517572	93826229	308657
EUR_8	50000	EUR	1451759	1493925	42166
EUR_8	50000	EUR	38737316	38795578	58262
EUR_8	50000	EUR	44829116	45579208	750092
EUR_8	50000	EUR	81588636	81750335	161699
EUR_8	50000	EUR	12718856	13184339	465483
EUR_8	50000	EUR	17744234	20196095	2451861
EUR_8	50000	EUR	33719805	34580064	860259
EUR_8	50000	EUR	36031219	36842882	811663
EUR_9	50000	EUR	9559016	9926482	367466
EUR_9	50000	EUR	55353825	55562893	209068
EUR_9	50000	EUR	94650055	95508445	858390
EUR_9	50000	EUR	3390177	4022652	632475
EUR_9	50000	EUR	65507215	67223964	1716749
EUR_9	50000	EUR	82933483	83801380	867897
EUR_10	50000	EUR	66945	245941	178996
EUR_10	50000	EUR	1624075	2334690	710615
EUR_10	50000	EUR	31536432	31896882	360450
EUR_10	50000	EUR	41178130	41681027	502897
EUR_10	50000	EUR	53685967	53879502	193535
EUR_10	50000	EUR	60039225	60580957	541732
EUR_10	50000	EUR	52439184	52745021	305837
EUR_10	50000	EUR	91333470	91908013	574543
EUR_11	40000	EUR	155275	338303	183028
EUR_11	40000	EUR	1761181	2087490	326309
EUR_11	40000	EUR	7329777	7588642	258865
EUR_11	40000	EUR	7601523	7789627	188104
EUR_11	40000	EUR	7789898	7812066	22168
EUR_11	40000	EUR	30003900	30042531	38631
EUR_11	40000	EUR	34277334	34321371	44037
EUR_11	40000	EUR	50474891	50635937	161046
EUR_11	40000	EUR	60077031	60093244	16213
EUR_11	40000	EUR	60317037	60557522	240485
EUR_11	40000	EUR	66939478	67223964	284486
EUR_11	40000	EUR	70105372	70201407	96035
EUR_11	40000	EUR	79144851	79154790	9939
EUR_11	40000	EUR	83289710	83521474	231764
EUR_11	40000	EUR	95123536	95161593	38057
EUR_11	40000	EUR	97321829	97392053	70224
EUR_11	40000	EUR	6583779	6615557	31778
EUR_11	40000	EUR	7380163	7465838	85675
EUR_11	40000	EUR	8967321	9013330	46009
EUR_11	40000	EUR	35010859	35167128	156269
EUR_11	40000	EUR	35903403	35937596	34193
EUR_11	40000	EUR	42455133	42493555	38422
EUR_11	40000	EUR	49292384	49807100	514716
EUR_11	40000	EUR	78953619	79552411	598792
EUR_11	40000	EUR	97276022	97294291	18269
EUR_12	40000	EUR	19692865	19743357	50492
EUR_12	40000	EUR	33322418	33823016	500598
EUR_12	40000	EUR	34155827	34199650	43823
EUR_12	40000	EUR	41178130	41517701	339571
EUR_12	40000	EUR	41836692	41847372	10680
EUR_12	40000	EUR	58884785	59073802	189017
EUR_12	40000	EUR	82124914	82445610	320696
EUR_12	40000	EUR	85006299	85190560	184261
EUR_12	40000	EUR	186664	1240732	1054068
EUR_12	40000	EUR	3402262	3432033	29771
EUR_12	40000	EUR	8479126	8724374	245248
EUR_12	40000	EUR	14626221	14770729	144508
EUR_12	40000	EUR	16370454	16757433	386979
EUR_12	40000	EUR	18340131	18414139	74008
EUR_12	40000	EUR	19494421	19603980	109559
EUR_12	40000	EUR	19948283	19994902	46619
EUR_12	40000	EUR	21005288	21327685	322397
EUR_12	40000	EUR	32183068	32278194	95126
EUR_12	40000	EUR	33652710	33654397	1687
EUR_12	40000	EUR	42570331	42581257	10926
EUR_12	40000	EUR	52511931	52745021	233090
EUR_12	40000	EUR	57694610	58236716	542106
EUR_12	40000	EUR	60273143	60526755	253612
EUR_12	40000	EUR	67881162	67916085	34923
EUR_12	40000	EUR	70508217	71263561	755344
EUR_12	40000	EUR	91333470	91426486	93016
EUR_12	40000	EUR	94420091	94505273	85182
EUR_12	40000	EUR	98580704	99157762	577058
EUR_12	40000	EUR	99279494	99397710	118216
EUR_13	40000	EUR	2823983	2874343	50360
EUR_13	40000	EUR	2976688	3633949	657261
EUR_13	40000	EUR	21093473	21363806	270333
EUR_13	40000	EUR	56422019	56631318	209299
EUR_13	40000	EUR	60039225	60229263	190038
EUR_13	40000	EUR	81579283	81683767	104484
EUR_13	40000	EUR	82207042	82497769	290727
EUR_13	40000	EUR	83535170	83595037	59867
EUR_13	40000	EUR	94929756	95161593	231837
EUR_13	40000	EUR	97321829	97392053	70224
EUR_13	40000	EUR	982163	1034789	52626
EUR_13	40000	EUR	7263485	7447504	184019
EUR_13	40000	EUR	9089745	9184321	94576
EUR_13	40000	EUR	36834755	36842882	8127
EUR_13	40000	EUR	48160214	48561786	401572
EUR_13	40000	EUR	49890098	49930050	39952
EUR_13	40000	EUR	50799357	51223299	423942
EUR_13	40000	EUR	56205625	56698672	493047
EUR_13	40000	EUR	57694610	58145361	450751
EUR_13	40000	EUR	60944291	61077181	132890
EUR_13	40000	EUR	67276558	67607566	331008
EUR_13	40000	EUR	97671733	97677718	5985
EUR_13	40000	EUR	99435176	99504684	69508
EUR_14	40000	EUR	7106350	7124531	18181
EUR_14	40000	EUR	8069883	8187332	117449
EUR_14	40000	EUR	16246612	16853858	607246
EUR_14	40000	EUR	19692865	19743357	50492
EUR_14	40000	EUR	34457616	34615301	157685
EUR_14	40000	EUR	34758072	35249422	491350
EUR_14	40000	EUR	36258736	36397343	138607
EUR_14	40000	EUR	42325382	42611830	286448
EUR_14	40000	EUR	44879087	45000269	121182
EUR_14	40000	EUR	52728566	52745021	16455
EUR_14	40000	EUR	57555097	57825705	270608
EUR_14	40000	EUR	70119979	70206901	86922
EUR_14	40000	EUR	83535170	83595037	59867
EUR_14	40000	EUR	90643101	90694613	51512
EUR_14	40000	EUR	99633336	99715506	82170
EUR_14	40000	EUR	6994360	7157330	162970
EUR_14	40000	EUR	20133400	20157102	23702
EUR_14	40000	EUR	33493724	33907895	414171
EUR_14	40000	EUR	34433894	35002923	569029
EUR_14	40000	EUR	41178130	41304295	126165
EUR_14	40000	EUR	56954709	57075882	121173
EUR_14	40000	EUR	60039225	60302928	263703
EUR_14	40000	EUR	66939478	67223964	284486
EUR_14	40000	EUR	69959691	70009272	49581
EUR_14	40000	EUR	78813158	78903305	90147
EUR_14	40000	EUR	81734020	81968917	234897
EUR_14	40000	EUR	99579957	99664291	84334
EUR_15	40000	EUR	449325	821799	372474
EUR_15	40000	EUR	1120082	1240732	120650
EUR_15	40000	EUR	3402262	3432033	29771
EUR_15	40000	EUR	7733166	7812066	78900
EUR_15	40000	EUR	31317696	31484769	167073
EUR_15	40000	EUR	32551593	32767766	216173
EUR_15	40000	EUR	33138317	33290559	152242
EUR_15	40000	EUR	34795983	35249422	453439
EUR_15	40000	EUR	45168700	45489952	321252
EUR_15	40000	EUR	48273203	48924337	651134
EUR_15	40000	EUR	52327278	52417652	90374
EUR_15	40000	EUR	66061294	66090240	28946
EUR_15	40000	EUR	78617258	78873143	255885
EUR_15	40000	EUR	3466549	3710367	243818
EUR_15	40000	EUR	8479126	8562555	83429
EUR_15	40000	EUR	23077256	23129639	52383
EUR_15	40000	EUR	29983092	30061781	78689
EUR_15	40000	EUR	31620662	31693446	72784
EUR_15	40000	EUR	32633156	32767766	134610
EUR_15	40000	EUR	33306288	33713284	406996
EUR_15	40000	EUR	35093561	35112980	19419
EUR_15	40000	EUR	44896429	45041077	144648
EUR_15	40000	EUR	48160214	48924337	764123
EUR_15	40000	EUR	52327278	52417652	90374
EUR_15	40000	EUR	66061294	66090240	28946
EUR_15	40000	EUR	85518067	85559052	40985
EUR_16	40000	EUR	2197269	2643756	446487
EUR_16	40000	EUR	2681277	2690457	9180
EUR_16	40000	EUR	3466549	3792074	325525
EUR_16	40000	EUR	19974425	20157102	182677
EUR_16	40000	EUR	32344998	32350543	5545
EUR_16	40000	EUR	52084796	52582641	497845
EUR_16	40000	EUR	67276558	67607566	331008
EUR_16	40000	EUR	69671162	69858128	186966
EUR_16	40000	EUR	81579283	81683767	104484
EUR_16	40000	EUR	91579231	91595303	16072
EUR_16	40000	EUR	1603873	1650206	46333
EUR_16	40000	EUR	2197269	2354747	157478
EUR_16	40000	EUR	19691460	19848176	156716
EUR_16	40000	EUR	32341136	32767766	426630
EUR_16	40000	EUR	33138317	33290559	152242
EUR_16	40000	EUR	36706687	37323104	616417
EUR_16	40000	EUR	44896429	45041077	144648
EUR_16	40000	EUR	48160214	48404781	244567
EUR_16	40000	EUR	79063846	79084555	20709
EUR_16	40000	EUR	82092534	82359074	266540
EUR_16	40000	EUR	82448196	82497769	49573
EUR_17	40000	EUR	1603873	1650206	46333
EUR_17	40000	EUR	2197269	2354747	157478
EUR_17	40000	EUR	15268570	15356892	88322
EUR_17	40000	EUR	32341136	32767766	426630
EUR_17	40000	EUR	41284698	41336191	51493
EUR_17	40000	EUR	44794675	44883644	88969
EUR_17	40000	EUR	67059249	67340350	281101
EUR_17	40000	EUR	69959691	70009272	49581
EUR_17	40000	EUR	71904304	72017618	113314
EUR_17	40000	EUR	82369906	82399086	29180
EUR_17	40000	EUR	82935294	83015744	80450
EUR_17	40000	EUR	87773888	87974770	200882
EUR_17	40000	EUR	88329307	88367384	38077
EUR_17	40000	EUR	99380026	99397710	17684
EUR_17	40000	EUR	1288422	1532301	243879
EUR_17	40000	EUR	16370454	16517893	147439
EUR_17	40000	EUR	23077256	23129639	52383
EUR_17	40000	EUR	32036755	32213106	176351
EUR_17	40000	EUR	52084796	52582641	497845
EUR_17	40000	EUR	56205625	56698672	493047
EUR_17	40000	EUR	66939478	67223964	284486
EUR_17	40000	EUR	69959691	70009272	49581
EUR_18	40000	EUR	45203325	45330185	126860
EUR_18	40000	EUR	48360235	48397442	37207
EUR_18	40000	EUR	48759833	48891674	131841
EUR_18	40000	EUR	59358602	59536453	177851
EUR_18	40000	EUR	66415252	66473007	57755
EUR_18	40000	EUR	70105372	70201407	96035
EUR_18	40000	EUR	85006299	85190560	184261
EUR_18	40000	EUR	91784887	91908013	123126
EUR_18	40000	EUR	1761181	2087490	326309
EUR_18	40000	EUR	7329777	7588642	258865
EUR_18	40000	EUR	7601523	7789627	188104
EUR_18	40000	EUR	7789898	7812066	22168
EUR_18	40000	EUR	19028853	19939674	910821
EUR_18	40000	EUR	31536432	31896882	360450
EUR_18	40000	EUR	35226840	35262119	35279
EUR_18	40000	EUR	41178130	41273702	95572
EUR_18	40000	EUR	41458952	41475759	16807
EUR_18	40000	EUR	41597742	41681027	83285
EUR_18	40000	EUR	45146327	45158604	12277
EUR_18	40000	EUR	45570613	45779079	208466
EUR_18	40000	EUR	60039225	60302928	263703
EUR_18	40000	EUR	65485272	65615238	129966
EUR_18	40000	EUR	70747212	70938141	190929
EUR_18	40000	EUR	78826314	78841506	15192
EUR_18	40000	EUR	82242704	82324939	82235
EUR_18	40000	EUR	83535170	83595037	59867
EUR_18	40000	EUR	85099222	85342815	243593
EUR_18	40000	EUR	98005455	98669429	663974
EUR_19	40000	EUR	183927	195953	12026
EUR_19	40000	EUR	2919352	3032735	113383
EUR_19	40000	EUR	14878301	14880612	2311
EUR_19	40000	EUR	18340131	18380945	40814
EUR_19	40000	EUR	41280592	41327192	46600
EUR_19	40000	EUR	45628417	45676615	48198
EUR_19	40000	EUR	48358044	48404781	46737
EUR_19	40000	EUR	53081133	53101280	20147
EUR_19	40000	EUR	56589208	56676204	86996
EUR_19	40000	EUR	70196013	70382252	186239
EUR_19	40000	EUR	80357099	80602497	245398
EUR_19	40000	EUR	1542208	1631243	89035
EUR_19	40000	EUR	7422026	7675588	253562
EUR_19	40000	EUR	10452353	10657939	205586
EUR_19	40000	EUR	16133844	16666843	532999
EUR_19	40000	EUR	56205625	56412551	206926
EUR_19	40000	EUR	57310753	57471256	160503
EUR_19	40000	EUR	57978255	58119001	140746
EUR_19	40000	EUR	59358602	59536453	177851
EUR_19	40000	EUR	83535170	83595037	59867
EUR_19	40000	EUR	85099222	85559052	459830
EUR_19	40000	EUR	99633336	99715506	82170
EUR_20	40000	EUR	19824010	19838993	14983
EUR_20	40000	EUR	19865578	20196095	330517
EUR_20	40000	EUR	34087926	34199650	111724
EUR_20	40000	EUR	37003107	37323104	319997
EUR_20	40000	EUR	41625661	41681027	55366
EUR_20	40000	EUR	48440860	48504561	63701
EUR_20	40000	EUR	56659028	56698672	39644
EUR_20	40000	EUR	83535170	83595037	59867
EUR_20	40000	EUR	86826545	86914928	88383
EUR_20	40000	EUR	96728452	97001676	273224
EUR_20	40000	EUR	6802510	6811003	8493
EUR_20	40000	EUR	7635385	7789627	154242
EUR_20	40000	EUR	19197681	19292371	94690
EUR_20	40000	EUR	32131811	32338906	207095
EUR_20	40000	EUR	32870126	32971366	101240
EUR_20	40000	EUR	34433894	34440231	6337
EUR_20	40000	EUR	41458952	41475759	16807
EUR_20	40000	EUR	41597742	41668074	70332
EUR_20	40000	EUR	47735036	48010617	275581
EUR_20	40000	EUR	65485272	65615238	129966
EUR_20	40000	EUR	79063846	79084555	20709
EUR_20	40000	EUR	82464526	82465515	989
EUR_20	40000	EUR	91667508	91726086	58578
EUR_20	40000	EUR	93365979	93420034	54055
EUR_20	40000	EUR	97671733	97677718	5985
EUR_20	40000	EUR	98580704	98850042	269338
EUR_20	40000	EUR	99495094	99576805	81711
EUR_21	30000	EUR	1188294	1568163	379869
EUR_21	30000	EUR	3635056	3661250	26194
EUR_21	30000	EUR	7083406	7157330	73924
EUR_21	30000	EUR	12910215	12940413	30198
EUR_21	30000	EUR	13015487	13184339	168852
EUR_21	30000	EUR	32299403	32319559	20156
EUR_21	30000	EUR	45177323	45315287	137964
EUR_21	30000	EUR	48360235	48397442	37207
EUR_21	30000	EUR	58884785	58943349	58564
EUR_21	30000	EUR	65485272	65615238	129966
EUR_21	30000	EUR	65677442	65693696	16254
EUR_21	30000	EUR	66850941	67005747	154806
EUR_21	30000	EUR	67125002	67340350	215348
EUR_21	30000	EUR	78681890	78706760	24870
EUR_21	30000	EUR	78826314	78841506	15192
EUR_21	30000	EUR	83126041	83164021	37980
EUR_21	30000	EUR	90643101	90694613	51512
EUR_21	30000	EUR	91667508	91709808	42300
EUR_21	30000	EUR	92894451	93062450	167999
EUR_21	30000	EUR	99304510	99352586	48076
EUR_21	30000	EUR	3294990	3738932	443942
EUR_21	30000	EUR	6994360	7069150	74790
EUR_21	30000	EUR	16133844	16141980	8136
EUR_21	30000	EUR	19204124	19297682	93558
EUR_21	30000	EUR	19343623	19525826	182203
EUR_21	30000	EUR	43245063	43754571	509508
EUR_21	30000	EUR	48648038	48782792	134754
EUR_21	30000	EUR	56285902	56301121	15219
EUR_21	30000	EUR	56593963	56676204	82241
EUR_21	30000	EUR	79212240	79271383	59143
EUR_21	30000	EUR	82659843	82732667	72824
EUR_21	30000	EUR	85089378	85190560	101182
EUR_21	30000	EUR	89112860	89289472	176612
EUR_22	30000	EUR	529304	821799	292495
EUR_22	30000	EUR	831163	1193517	362354
EUR_22	30000	EUR	2823983	2874343	50360
EUR_22	30000	EUR	2976688	3129786	153098
EUR_22	30000	EUR	7268890	7444390	175500
EUR_22	30000	EUR	15268570	15356892	88322
EUR_22	30000	EUR	16246612	16324947	78335
EUR_22	30000	EUR	19236260	19444712	208452
EUR_22	30000	EUR	19736300	20177391	441091
EUR_22	30000	EUR	31418549	31442444	23895
EUR_22	30000	EUR	33555868	33672330	116462
EUR_22	30000	EUR	34973338	35116089	142751
EUR_22	30000	EUR	41280592	41327192	46600
EUR_22	30000	EUR	41586314	41681027	94713
EUR_22	30000	EUR	52131714	52482721	351007
EUR_22	30000	EUR	60235523	60266502	30979
EUR_22	30000	EUR	60337282	60405974	68692
EUR_22	30000	EUR	71082622	71263561	180939
EUR_22	30000	EUR	81402768	81515940	113172
EUR_22	30000	EUR	82659843	82732667	72824
EUR_22	30000	EUR	85042608	85263524	220916
EUR_22	30000	EUR	85427054	85559052	131998
EUR_22	30000	EUR	89558335	89600117	41782
EUR_22	30000	EUR	89942056	89968908	26852
EUR_22	30000	EUR	93036335	93224014	187679
EUR_22	30000	EUR	93365979	93420034	54055
EUR_22	30000	EUR	98757837	98796010	38173
EUR_22	30000	EUR	765101	802492	37391
EUR_22	30000	EUR	1051429	1240732	189303
EUR_22	30000	EUR	7268890	7444390	175500
EUR_22	30000	EUR	7549489	7614045	64556
EUR_22	30000	EUR	8826503	8928424	101921
EUR_22	30000	EUR	19433185	19436972	3787
EUR_22	30000	EUR	19532548	19668854	136306
EUR_22	30000	EUR	20032235	20196095	163860
EUR_22	30000	EUR	24359852	24545857	186005
EUR_22	30000	EUR	47735036	47797327	62291
EUR_22	30000	EUR	48432391	48463340	30949
EUR_22	30000	EUR	49576498	49608883	32385
EUR_22	30000	EUR	52447643	52573920	126277
EUR_22	30000	EUR	60944291	61077181	132890
EUR_22	30000	EUR	70816814	70909673	92859
EUR_22	30000	EUR	71270923	71342228	71305
EUR_22	30000	EUR	71394194	71454322	60128
EUR_22	30000	EUR	97324781	97334875	10094
EUR_23	30000	EUR	856553	894641	38088
EUR_23	30000	EUR	982163	1034789	52626
EUR_23	30000	EUR	2787510	2905256	117746
EUR_23	30000	EUR	3315345	3361610	46265
EUR_23	30000	EUR	6732811	6747303	14492
EUR_23	30000	EUR	9863180	9895720	32540
EUR_23	30000	EUR	10643509	10697984	54475
EUR_23	30000	EUR	34801962	34899881	97919
EUR_23	30000	EUR	45177323	45315287	137964
EUR_23	30000	EUR	48203618	48397442	193824
EUR_23	30000	EUR	56954709	57084783	130074
EUR_23	30000	EUR	66850941	67005747	154806
EUR_23	30000	EUR	67125002	67201093	76091
EUR_23	30000	EUR	71413976	71454322	40346
EUR_23	30000	EUR	78813158	78903305	90147
EUR_23	30000	EUR	79182474	79271383	88909
EUR_23	30000	EUR	79525295	79545829	20534
EUR_23	30000	EUR	85540678	85559052	18374
EUR_23	30000	EUR	93015373	93224014	208641
EUR_23	30000	EUR	95395717	95533801	138084
EUR_23	30000	EUR	99098440	99198635	100195
EUR_23	30000	EUR	982163	1034789	52626
EUR_23	30000	EUR	3790953	3826448	35495
EUR_23	30000	EUR	14586202	14623385	37183
EUR_23	30000	EUR	16370454	16547328	176874
EUR_23	30000	EUR	19792475	19803372	10897
EUR_23	30000	EUR	32175477	32309203	133726
EUR_23	30000	EUR	32546422	32549426	3004
EUR_23	30000	EUR	42636856	42672949	36093
EUR_23	30000	EUR	42863627	42952354	88727
EUR_23	30000	EUR	44322094	44377977	55883
EUR_23	30000	EUR	85886159	85997548	111389
EUR_23	30000	EUR	89659092	89760481	101389
EUR_24	30000	EUR	600754	802492	201738
EUR_24	30000	EUR	1051429	1134236	82807
EUR_24	30000	EUR	7285890	7444390	158500
EUR_24	30000	EUR	19028853	19119243	90390
EUR_24	30000	EUR	29999510	30061781	62271
EUR_24	30000	EUR	36012355	36155026	142671
EUR_24	30000	EUR	44954736	45045358	90622
EUR_24	30000	EUR	52711151	52731110	19959
EUR_24	30000	EUR	94980195	95277967	297772
EUR_24	30000	EUR	95461014	95496972	35958
EUR_24	30000	EUR	98580704	98796010	215306
EUR_24	30000	EUR	99259148	99309052	49904
EUR_24	30000	EUR	1664395	1673494	9099
EUR_24	30000	EUR	6968853	7294627	325774
EUR_24	30000	EUR	10046202	10047941	1739
EUR_24	30000	EUR	10665738	10686787	21049
EUR_24	30000	EUR	16370454	16408891	38437
EUR_24	30000	EUR	19736300	19744385	8085
EUR_24	30000	EUR	31356895	31414107	57212
EUR_24	30000	EUR	32443203	32767766	324563
EUR_24	30000	EUR	33306288	33383081	76793
EUR_24	30000	EUR	34973338	35116089	142751
EUR_24	30000	EUR	36936037	36984241	48204
EUR_24	30000	EUR	47735036	47797327	62291
EUR_24	30000	EUR	49607146	49698362	91216
EUR_24	30000	EUR	60413365	60457084	43719
EUR_24	30000	EUR	78861510	78903305	41795
EUR_24	30000	EUR	79182474	79271383	88909
EUR_24	30000	EUR	80357099	80602497	245398
EUR_24	30000	EUR	82633504	82716576	83072
EUR_24	30000	EUR	90643101	90694613	51512
EUR_24	30000	EUR	92381507	92385296	3789
EUR_24	30000	EUR	98625926	98645877	19951
EUR_24	30000	EUR	98789285	98816945	27660
EUR_24	30000	EUR	99259148	99309052	49904
EUR_25	30000	EUR	3123264	3277495	154231
EUR_25	30000	EUR	3633836	3825022	191186
EUR_25	30000	EUR	7484795	7517216	32421
EUR_25	30000	EUR	8431415	8625598	194183
EUR_25	30000	EUR	15183335	15220027	36692
EUR_25	30000	EUR	16246612	16255638	9026
EUR_25	30000	EUR	19380328	19442215	61887
EUR_25	30000	EUR	20062562	20177391	114829
EUR_25	30000	EUR	32297178	32580742	283564
EUR_25	30000	EUR	34548811	34617430	68619
EUR_25	30000	EUR	44989994	45007205	17211
EUR_25	30000	EUR	51082638	51269825	187187
EUR_25	30000	EUR	56317871	56698672	380801
EUR_25	30000	EUR	66271113	66276560	5447
EUR_25	30000	EUR	66770704	66898413	127709
EUR_25	30000	EUR	83126041	83164021	37980
EUR_25	30000	EUR	84244698	84290090	45392
EUR_25	30000	EUR	85042608	85529026	486418
EUR_25	30000	EUR	91460158	91619607	159449
EUR_25	30000	EUR	91667508	91709808	42300
EUR_25	30000	EUR	99304510	99352586	48076
EUR_25	30000	EUR	3392407	3578206	185799
EUR_25	30000	EUR	9044003	9101753	57750
EUR_25	30000	EUR	15268570	15356892	88322
EUR_25	30000	EUR	17710833	17771299	60466
EUR_25	30000	EUR	25193603	25233137	39534
EUR_25	30000	EUR	32290010	32767766	477756
EUR_25	30000	EUR	35966677	35977443	10766
EUR_25	30000	EUR	44989994	45007205	17211
EUR_25	30000	EUR	52378937	52390984	12047
EUR_25	30000	EUR	52588606	52731110	142504
EUR_25	30000	EUR	66158676	66184604	25928
EUR_25	30000	EUR	66718672	66898413	179741
EUR_25	30000	EUR	79182474	79271383	88909
EUR_25	30000	EUR	93120987	93275476	154489
EUR_25	30000	EUR	97281793	97965839	684046
EUR_26	30000	EUR	3012618	3386212	373594
EUR_26	30000	EUR	3598460	3624998	26538
EUR_26	30000	EUR	12910215	13184339	274124
EUR_26	30000	EUR	14586202	14853891	267689
EUR_26	30000	EUR	18951402	19020063	68661
EUR_26	30000	EUR	32443203	32767766	324563
EUR_26	30000	EUR	33306288	33383081	76793
EUR_26	30000	EUR	34155827	34199650	43823
EUR_26	30000	EUR	41230329	41434636	204307
EUR_26	30000	EUR	42182363	42672949	490586
EUR_26	30000	EUR	44989994	45007205	17211
EUR_26	30000	EUR	48160214	48245201	84987
EUR_26	30000	EUR	49692230	49698362	6132
EUR_26	30000	EUR	50990120	51066845	76725
EUR_26	30000	EUR	61392863	61430504	37641
EUR_26	30000	EUR	82633504	82716576	83072
EUR_26	30000	EUR	95061017	95300815	239798
EUR_26	30000	EUR	98535023	98645877	110854
EUR_26	30000	EUR	99808840	99856573	47733
EUR_26	30000	EUR	822466	1208065	385599
EUR_26	30000	EUR	1477583	1546716	69133
EUR_26	30000	EUR	3316499	3351992	35493
EUR_26	30000	EUR	16133844	16194800	60956
EUR_26	30000	EUR	44953824	45041077	87253
EUR_26	30000	EUR	48360235	48397442	37207
EUR_26	30000	EUR	70119979	70142952	22973
EUR_26	30000	EUR	71394194	71454322	60128
EUR_26	30000	EUR	81582043	81589553	7510
EUR_26	30000	EUR	82238363	82245156	6793
EUR_26	30000	EUR	82436220	82572376	136156
EUR_26	30000	EUR	82683334	82850412	167078
EUR_26	30000	EUR	89659092	89742211	83119
EUR_26	30000	EUR	93036335	93224014	187679
EUR_26	30000	EUR	93365979	93420034	54055
EUR_26	30000	EUR	99098440	99223970	125530
EUR_26	30000	EUR	99704248	99715506	11258
EUR_26	30000	EUR	99965568	1e+08	34432
EUR_27	30000	EUR	559621	802492	242871
EUR_27	30000	EUR	7285890	7444390	158500
EUR_27	30000	EUR	16382131	16547328	165197
EUR_27	30000	EUR	19343202	19407151	63949
EUR_27	30000	EUR	35093561	35112980	19419
EUR_27	30000	EUR	35286679	35390337	103658
EUR_27	30000	EUR	56285902	56301121	15219
EUR_27	30000	EUR	56317131	56421005	103874
EUR_27	30000	EUR	66910347	67340350	430003
EUR_27	30000	EUR	79095120	79108911	13791
EUR_27	30000	EUR	81402768	81515940	113172
EUR_27	30000	EUR	85886159	85917767	31608
EUR_27	30000	EUR	89659092	89680141	21049
EUR_27	30000	EUR	90643101	90694613	51512
EUR_27	30000	EUR	93015373	93224014	208641
EUR_27	30000	EUR	93365979	93394087	28108
EUR_27	30000	EUR	99098440	99223970	125530
EUR_27	30000	EUR	99704248	99715506	11258
EUR_27	30000	EUR	99983354	99997613	14259
EUR_27	30000	EUR	783187	821799	38612
EUR_27	30000	EUR	831163	1193517	362354
EUR_27	30000	EUR	2823983	2874343	50360
EUR_27	30000	EUR	2976688	3129786	153098
EUR_27	30000	EUR	7423463	7444390	20927
EUR_27	30000	EUR	7609853	7614045	4192
EUR_27	30000	EUR	19028853	19100805	71952
EUR_27	30000	EUR	19736300	19744385	8085
EUR_27	30000	EUR	36012355	36088827	76472
EUR_27	30000	EUR	36611105	36763251	152146
EUR_27	30000	EUR	45177323	45315287	137964
EUR_27	30000	EUR	52511931	52745021	233090
EUR_27	30000	EUR	57856270	57916229	59959
EUR_27	30000	EUR	58065546	58236716	171170
EUR_27	30000	EUR	66850941	67005747	154806
EUR_27	30000	EUR	67125002	67201093	76091
EUR_27	30000	EUR	81700971	81757509	56538
EUR_27	30000	EUR	81814168	82083585	269417
EUR_27	30000	EUR	89558335	89600117	41782
EUR_27	30000	EUR	89942056	89968908	26852
EUR_27	30000	EUR	92381507	92385296	3789
EUR_27	30000	EUR	94980195	95277967	297772
EUR_27	30000	EUR	95461014	95531429	70415
EUR_28	30000	EUR	1542208	1586503	44295
EUR_28	30000	EUR	2877497	2905256	27759
EUR_28	30000	EUR	7356470	7392923	36453
EUR_28	30000	EUR	8479126	8724374	245248
EUR_28	30000	EUR	19028853	19578063	549210
EUR_28	30000	EUR	19948283	19950347	2064
EUR_28	30000	EUR	31356895	31414107	57212
EUR_28	30000	EUR	32443203	32767766	324563
EUR_28	30000	EUR	33306288	33383081	76793
EUR_28	30000	EUR	33712694	33907895	195201
EUR_28	30000	EUR	34565989	35134263	568274
EUR_28	30000	EUR	43245063	43495024	249961
EUR_28	30000	EUR	44989994	45007205	17211
EUR_28	30000	EUR	48759833	48891674	131841
EUR_28	30000	EUR	50402581	50517916	115335
EUR_28	30000	EUR	60235523	60262901	27378
EUR_28	30000	EUR	60302138	60422885	120747
EUR_28	30000	EUR	61392863	61410518	17655
EUR_28	30000	EUR	67048866	67099452	50586
EUR_28	30000	EUR	70507208	70549794	42586
EUR_28	30000	EUR	79095120	79108911	13791
EUR_28	30000	EUR	87929668	87967747	38079
EUR_28	30000	EUR	90643101	90694613	51512
EUR_28	30000	EUR	91429710	91502510	72800
EUR_28	30000	EUR	94451912	94465469	13557
EUR_28	30000	EUR	98093519	98364980	271461
EUR_28	30000	EUR	99533965	99715506	181541
EUR_28	30000	EUR	1120082	1240732	120650
EUR_28	30000	EUR	2197269	2223368	26099
EUR_28	30000	EUR	3616952	3621338	4386
EUR_28	30000	EUR	3742473	3822465	79992
EUR_28	30000	EUR	6965172	7106171	140999
EUR_28	30000	EUR	32297178	32596600	299422
EUR_28	30000	EUR	44879087	44887552	8465
EUR_28	30000	EUR	44989994	45007205	17211
EUR_28	30000	EUR	45517779	45537510	19731
EUR_28	30000	EUR	47923463	48189215	265752
EUR_28	30000	EUR	52511931	52546494	34563
EUR_28	30000	EUR	85006299	85067503	61204
EUR_28	30000	EUR	93120987	93275476	154489
EUR_29	30000	EUR	982163	1149476	167313
EUR_29	30000	EUR	1187958	1193517	5559
EUR_29	30000	EUR	2982946	3351992	369046
EUR_29	30000	EUR	20069593	20091458	21865
EUR_29	30000	EUR	30003900	30042531	38631
EUR_29	30000	EUR	31418549	31442444	23895
EUR_29	30000	EUR	42456346	42495915	39569
EUR_29	30000	EUR	50398943	50408102	9159
EUR_29	30000	EUR	51354054	51392499	38445
EUR_29	30000	EUR	52646363	52731110	84747
EUR_29	30000	EUR	55478933	55490413	11480
EUR_29	30000	EUR	56317871	56422085	104214
EUR_29	30000	EUR	58884785	58900981	16196
EUR_29	30000	EUR	59040321	59079044	38723
EUR_29	30000	EUR	59101641	59103725	2084
EUR_29	30000	EUR	61392863	61430504	37641
EUR_29	30000	EUR	81700971	81757509	56538
EUR_29	30000	EUR	81814168	82066663	252495
EUR_29	30000	EUR	85518067	85559052	40985
EUR_29	30000	EUR	91743941	91868736	124795
EUR_29	30000	EUR	97324781	97392053	67272
EUR_29	30000	EUR	99259148	99309052	49904
EUR_29	30000	EUR	3316499	3351661	35162
EUR_29	30000	EUR	3402262	3432033	29771
EUR_29	30000	EUR	6852588	6878942	26354
EUR_29	30000	EUR	11126190	11166735	40545
EUR_29	30000	EUR	44322094	44497168	175074
EUR_29	30000	EUR	44879087	45000269	121182
EUR_29	30000	EUR	50402581	50517916	115335
EUR_29	30000	EUR	57978255	58119001	140746
EUR_29	30000	EUR	59408692	59536453	127761
EUR_29	30000	EUR	60253489	60318571	65082
EUR_29	30000	EUR	65386956	65444502	57546
EUR_29	30000	EUR	65485272	65615238	129966
EUR_29	30000	EUR	66215742	66316543	100801
EUR_29	30000	EUR	66910347	66985885	75538
EUR_29	30000	EUR	81726873	81757509	30636
EUR_29	30000	EUR	81814168	81871938	57770
EUR_29	30000	EUR	82240215	82245156	4941
EUR_29	30000	EUR	82718561	83015744	297183
EUR_29	30000	EUR	83126041	83164021	37980
EUR_29	30000	EUR	89684423	89732559	48136
EUR_29	30000	EUR	99304510	99352586	48076
EUR_30	30000	EUR	1450448	1546716	96268
EUR_30	30000	EUR	7247034	7298925	51891
EUR_30	30000	EUR	15010093	15109113	99020
EUR_30	30000	EUR	19343202	19407151	63949
EUR_30	30000	EUR	23128968	23150410	21442
EUR_30	30000	EUR	41302914	41681027	378113
EUR_30	30000	EUR	52362966	52582641	219675
EUR_30	30000	EUR	52694749	52731110	36361
EUR_30	30000	EUR	56367043	56698672	331629
EUR_30	30000	EUR	58019801	58236716	216915
EUR_30	30000	EUR	66372328	66396255	23927
EUR_30	30000	EUR	67907875	67916085	8210
EUR_30	30000	EUR	70045927	70121614	75687
EUR_30	30000	EUR	78826314	78841506	15192
EUR_30	30000	EUR	90643101	90694613	51512
EUR_30	30000	EUR	92354903	92385296	30393
EUR_30	30000	EUR	99303539	99392605	89066
EUR_30	30000	EUR	982163	1008476	26313
EUR_30	30000	EUR	1011261	1149476	138215
EUR_30	30000	EUR	1187958	1193517	5559
EUR_30	30000	EUR	3790953	3826448	35495
EUR_30	30000	EUR	8826503	8928424	101921
EUR_30	30000	EUR	32443203	32767766	324563
EUR_30	30000	EUR	33306288	33383081	76793
EUR_30	30000	EUR	34973338	35116089	142751
EUR_30	30000	EUR	41302914	41345389	42475
EUR_30	30000	EUR	41352902	41569283	216381
EUR_30	30000	EUR	47923463	48189215	265752
EUR_30	30000	EUR	48759833	48891674	131841
EUR_30	30000	EUR	58990436	59110988	120552
EUR_30	30000	EUR	64963004	64963824	820
EUR_30	30000	EUR	82840135	83015744	175609
EUR_30	30000	EUR	84225779	84252060	26281
EUR_30	30000	EUR	85006299	85147241	140942
EUR_30	30000	EUR	89242332	89294203	51871
EUR_30	30000	EUR	93169369	93288388	119019
EUR_30	30000	EUR	99303539	99392605	89066
EUR_31	20000	EUR	278676	332390	53714
EUR_31	20000	EUR	1206118	1206788	670
EUR_31	20000	EUR	1293018	1404930	111912
EUR_31	20000	EUR	1868080	1906837	38757
EUR_31	20000	EUR	3012618	3063802	51184
EUR_31	20000	EUR	3273303	3299729	26426
EUR_31	20000	EUR	3536418	3570854	34436
EUR_31	20000	EUR	16133844	16141980	8136
EUR_31	20000	EUR	17875815	17927018	51203
EUR_31	20000	EUR	18507282	18660573	153291
EUR_31	20000	EUR	19028853	19261834	232981
EUR_31	20000	EUR	19692865	19743357	50492
EUR_31	20000	EUR	31356895	31414107	57212
EUR_31	20000	EUR	32299403	32300958	1555
EUR_31	20000	EUR	32443203	32574035	130832
EUR_31	20000	EUR	43245063	43246458	1395
EUR_31	20000	EUR	50473932	50517916	43984
EUR_31	20000	EUR	53316762	53404500	87738
EUR_31	20000	EUR	60039225	60192988	153763
EUR_31	20000	EUR	79326193	79420938	94745
EUR_31	20000	EUR	79508038	79532178	24140
EUR_31	20000	EUR	82633504	82716576	83072
EUR_31	20000	EUR	82959860	83015744	55884
EUR_31	20000	EUR	84244698	84279470	34772
EUR_31	20000	EUR	99813314	99881673	68359
EUR_31	20000	EUR	1161310	1181127	19817
EUR_31	20000	EUR	2850480	2905256	54776
EUR_31	20000	EUR	3486375	3590308	103933
EUR_31	20000	EUR	7040582	7157330	116748
EUR_31	20000	EUR	7484795	7614045	129250
EUR_31	20000	EUR	15268570	15356892	88322
EUR_31	20000	EUR	16353065	16373514	20449
EUR_31	20000	EUR	19390423	19407151	16728
EUR_31	20000	EUR	20096875	20177391	80516
EUR_31	20000	EUR	34433894	34434424	530
EUR_31	20000	EUR	36873693	36937256	63563
EUR_31	20000	EUR	41649386	41681027	31641
EUR_31	20000	EUR	59397484	59434986	37502
EUR_31	20000	EUR	60039225	60175838	136613
EUR_31	20000	EUR	60302138	60557522	255384
EUR_31	20000	EUR	70508217	70562508	54291
EUR_31	20000	EUR	70601849	70869212	267363
EUR_31	20000	EUR	79469065	79552411	83346
EUR_31	20000	EUR	81700971	81757509	56538
EUR_31	20000	EUR	81814168	81871938	57770
EUR_31	20000	EUR	85418677	85474058	55381
EUR_31	20000	EUR	89558335	89593721	35386
EUR_31	20000	EUR	89659092	89761001	101909
EUR_31	20000	EUR	91691763	91696746	4983
EUR_31	20000	EUR	94980195	95219891	239696
EUR_31	20000	EUR	99099431	99223970	124539
EUR_32	20000	EUR	186664	402922	216258
EUR_32	20000	EUR	459173	538194	79021
EUR_32	20000	EUR	982163	1008476	26313
EUR_32	20000	EUR	1011261	1149476	138215
EUR_32	20000	EUR	1160873	1208065	47192
EUR_32	20000	EUR	1382908	1552203	169295
EUR_32	20000	EUR	2976688	3351992	375304
EUR_32	20000	EUR	3811182	3822465	11283
EUR_32	20000	EUR	7271460	7395550	124090
EUR_32	20000	EUR	7423463	7444390	20927
EUR_32	20000	EUR	8479126	8681247	202121
EUR_32	20000	EUR	8836060	8841421	5361
EUR_32	20000	EUR	9089745	9104667	14922
EUR_32	20000	EUR	17875815	17927018	51203
EUR_32	20000	EUR	36456218	36471476	15258
EUR_32	20000	EUR	41302914	41304096	1182
EUR_32	20000	EUR	47967792	48023849	56057
EUR_32	20000	EUR	48648038	48687304	39266
EUR_32	20000	EUR	48816332	48891674	75342
EUR_32	20000	EUR	52511931	52546494	34563
EUR_32	20000	EUR	56658695	56676204	17509
EUR_32	20000	EUR	56996950	57009137	12187
EUR_32	20000	EUR	58145823	58236716	90893
EUR_32	20000	EUR	60454753	60457084	2331
EUR_32	20000	EUR	66061294	66090240	28946
EUR_32	20000	EUR	66494456	66620046	125590
EUR_32	20000	EUR	70508217	70611199	102982
EUR_32	20000	EUR	79095120	79108911	13791
EUR_32	20000	EUR	79251452	79366572	115120
EUR_32	20000	EUR	82080492	82083585	3093
EUR_32	20000	EUR	82576187	82716576	140389
EUR_32	20000	EUR	82934867	83015744	80877
EUR_32	20000	EUR	85042608	85495860	453252
EUR_32	20000	EUR	91812221	91819470	7249
EUR_32	20000	EUR	99132957	99146424	13467
EUR_32	20000	EUR	99542125	99585763	43638
EUR_32	20000	EUR	1080859	1193517	112658
EUR_32	20000	EUR	1478834	1523211	44377
EUR_32	20000	EUR	1868080	1906837	38757
EUR_32	20000	EUR	3684886	3706513	21627
EUR_32	20000	EUR	4258951	4412796	153845
EUR_32	20000	EUR	6732811	6747303	14492
EUR_32	20000	EUR	7299991	7309906	9915
EUR_32	20000	EUR	8431415	8441226	9811
EUR_32	20000	EUR	8877834	9033570	155736
EUR_32	20000	EUR	10749153	10795559	46406
EUR_32	20000	EUR	14850046	15049806	199760
EUR_32	20000	EUR	19065605	19139790	74185
EUR_32	20000	EUR	20106366	20177391	71025
EUR_32	20000	EUR	32299403	32319559	20156
EUR_32	20000	EUR	41665141	41681027	15886
EUR_32	20000	EUR	48654788	48709287	54499
EUR_32	20000	EUR	56346050	56669405	323355
EUR_32	20000	EUR	57988115	58068801	80686
EUR_32	20000	EUR	58917360	58995364	78004
EUR_32	20000	EUR	59028307	59110988	82681
EUR_32	20000	EUR	60425027	60457084	32057
EUR_32	20000	EUR	66910347	66960516	50169
EUR_32	20000	EUR	71242461	71359120	116659
EUR_32	20000	EUR	81402768	81515940	113172
EUR_32	20000	EUR	81967773	82083585	115812
EUR_32	20000	EUR	82576187	82716576	140389
EUR_32	20000	EUR	85042608	85442990	400382
EUR_32	20000	EUR	89558335	89600117	41782
EUR_32	20000	EUR	92381507	92385296	3789
EUR_32	20000	EUR	97321829	97378282	56453
EUR_33	20000	EUR	982163	1034789	52626
EUR_33	20000	EUR	1181129	1240732	59603
EUR_33	20000	EUR	3486375	3590308	103933
EUR_33	20000	EUR	7271460	7395550	124090
EUR_33	20000	EUR	7423463	7444390	20927
EUR_33	20000	EUR	8479126	8681247	202121
EUR_33	20000	EUR	13163085	13184339	21254
EUR_33	20000	EUR	14586202	14616963	30761
EUR_33	20000	EUR	16370454	16371547	1093
EUR_33	20000	EUR	16438218	16564941	126723
EUR_33	20000	EUR	16764327	16765195	868
EUR_33	20000	EUR	18507282	18612959	105677
EUR_33	20000	EUR	18951402	19020063	68661
EUR_33	20000	EUR	19343623	19525826	182203
EUR_33	20000	EUR	20168912	20177391	8479
EUR_33	20000	EUR	33866938	33907895	40957
EUR_33	20000	EUR	34155827	34199650	43823
EUR_33	20000	EUR	35002539	35041256	38717
EUR_33	20000	EUR	42821319	43042745	221426
EUR_33	20000	EUR	44896429	44993996	97567
EUR_33	20000	EUR	48360235	48397442	37207
EUR_33	20000	EUR	56346050	56655068	309018
EUR_33	20000	EUR	58884785	59110988	226203
EUR_33	20000	EUR	60253489	60318571	65082
EUR_33	20000	EUR	60451449	60457084	5635
EUR_33	20000	EUR	61392863	61417206	24343
EUR_33	20000	EUR	79259384	79271383	11999
EUR_33	20000	EUR	82384191	82401688	17497
EUR_33	20000	EUR	83535170	83566034	30864
EUR_33	20000	EUR	89558335	89600117	41782
EUR_33	20000	EUR	89942056	89968908	26852
EUR_33	20000	EUR	91689270	91709808	20538
EUR_33	20000	EUR	93015373	93095347	79974
EUR_33	20000	EUR	93120987	93130252	9265
EUR_33	20000	EUR	93658556	93687637	29081
EUR_33	20000	EUR	95465161	95481721	16560
EUR_33	20000	EUR	1161310	1181127	19817
EUR_33	20000	EUR	2282711	2354747	72036
EUR_33	20000	EUR	3684886	3706513	21627
EUR_33	20000	EUR	6951056	7294627	343571
EUR_33	20000	EUR	10749153	10795559	46406
EUR_33	20000	EUR	16466279	16520328	54049
EUR_33	20000	EUR	17875815	17927018	51203
EUR_33	20000	EUR	18257655	18263288	5633
EUR_33	20000	EUR	18962861	19020063	57202
EUR_33	20000	EUR	19745044	19779206	34162
EUR_33	20000	EUR	20003557	20177391	173834
EUR_33	20000	EUR	30016686	30042531	25845
EUR_33	20000	EUR	32131811	32338906	207095
EUR_33	20000	EUR	32579758	32763005	183247
EUR_33	20000	EUR	32870126	32971366	101240
EUR_33	20000	EUR	33472081	33495347	23266
EUR_33	20000	EUR	33886572	33900204	13632
EUR_33	20000	EUR	34155827	34199650	43823
EUR_33	20000	EUR	34760580	34807894	47314
EUR_33	20000	EUR	35123729	35161851	38122
EUR_33	20000	EUR	48358044	48393887	35843
EUR_33	20000	EUR	58019801	58236716	216915
EUR_33	20000	EUR	59515428	59536453	21025
EUR_33	20000	EUR	66499094	66620046	120952
EUR_33	20000	EUR	67159723	67187666	27943
EUR_33	20000	EUR	67276558	67408005	131447
EUR_33	20000	EUR	70530240	70733144	202904
EUR_33	20000	EUR	79283689	79491278	207589
EUR_33	20000	EUR	81700971	81757509	56538
EUR_33	20000	EUR	81814168	81871938	57770
EUR_33	20000	EUR	82698203	82716576	18373
EUR_33	20000	EUR	83454325	83547224	92899
EUR_33	20000	EUR	99340154	99392605	52451
EUR_33	20000	EUR	99597740	99617135	19395
EUR_33	20000	EUR	99704248	99715506	11258
EUR_34	20000	EUR	980545	983042	2497
EUR_34	20000	EUR	1081594	1120804	39210
EUR_34	20000	EUR	3684886	3706513	21627
EUR_34	20000	EUR	4258951	4412796	153845
EUR_34	20000	EUR	7285890	7338110	52220
EUR_34	20000	EUR	8877834	9033570	155736
EUR_34	20000	EUR	16246612	16324947	78335
EUR_34	20000	EUR	19630585	19657947	27362
EUR_34	20000	EUR	21093473	21193932	100459
EUR_34	20000	EUR	35903403	35937596	34193
EUR_34	20000	EUR	36563688	36579439	15751
EUR_34	20000	EUR	44922742	44929869	7127
EUR_34	20000	EUR	49686447	49698362	11915
EUR_34	20000	EUR	52344468	52374049	29581
EUR_34	20000	EUR	56337270	56422085	84815
EUR_34	20000	EUR	60571076	60847085	276009
EUR_34	20000	EUR	79529342	79552411	23069
EUR_34	20000	EUR	80532855	80552263	19408
EUR_34	20000	EUR	82436220	82572376	136156
EUR_34	20000	EUR	82683334	82850412	167078
EUR_34	20000	EUR	85160530	85495860	335330
EUR_34	20000	EUR	87896404	87967747	71343
EUR_34	20000	EUR	89659092	89761001	101909
EUR_34	20000	EUR	90682413	90694613	12200
EUR_34	20000	EUR	94980195	95082994	102799
EUR_34	20000	EUR	1187573	1193517	5944
EUR_34	20000	EUR	2837849	2839560	1711
EUR_34	20000	EUR	3472162	3822465	350303
EUR_34	20000	EUR	10559032	10642628	83596
EUR_34	20000	EUR	10812468	10830251	17783
EUR_34	20000	EUR	14586202	14623403	37201
EUR_34	20000	EUR	15131356	15172325	40969
EUR_34	20000	EUR	19236260	19444712	208452
EUR_34	20000	EUR	19974425	20157102	182677
EUR_34	20000	EUR	32175477	32309203	133726
EUR_34	20000	EUR	33657848	33669252	11404
EUR_34	20000	EUR	34333561	34343939	10378
EUR_34	20000	EUR	35903403	35937596	34193
EUR_34	20000	EUR	36668091	36675113	7022
EUR_34	20000	EUR	43448444	43495024	46580
EUR_34	20000	EUR	52511931	52546494	34563
EUR_34	20000	EUR	55478933	55490413	11480
EUR_34	20000	EUR	56438557	56457263	18706
EUR_34	20000	EUR	57002459	57102787	100328
EUR_34	20000	EUR	57310753	57366806	56053
EUR_34	20000	EUR	59397484	59434986	37502
EUR_34	20000	EUR	60426930	60454332	27402
EUR_34	20000	EUR	66061294	66090240	28946
EUR_34	20000	EUR	66910347	67173048	262701
EUR_34	20000	EUR	70004307	70009272	4965
EUR_34	20000	EUR	85322882	85342815	19933
EUR_34	20000	EUR	89558335	89600117	41782
EUR_34	20000	EUR	89758766	89761001	2235
EUR_34	20000	EUR	95399383	95426293	26910
EUR_34	20000	EUR	99704248	99715506	11258
EUR_35	20000	EUR	499863	609014	109151
EUR_35	20000	EUR	1382908	1549301	166393
EUR_35	20000	EUR	1868080	1906837	38757
EUR_35	20000	EUR	2197269	2223368	26099
EUR_35	20000	EUR	2877497	2905256	27759
EUR_35	20000	EUR	3199669	3334608	134939
EUR_35	20000	EUR	7285890	7338110	52220
EUR_35	20000	EUR	8530872	8625598	94726
EUR_35	20000	EUR	10812468	10830251	17783
EUR_35	20000	EUR	19032758	19139790	107032
EUR_35	20000	EUR	19630585	19654215	23630
EUR_35	20000	EUR	20003819	20157102	153283
EUR_35	20000	EUR	30016686	30042531	25845
EUR_35	20000	EUR	32175477	32309203	133726
EUR_35	20000	EUR	36474197	36519208	45011
EUR_35	20000	EUR	36626060	36984241	358181
EUR_35	20000	EUR	41178130	41221059	42929
EUR_35	20000	EUR	43245063	43343367	98304
EUR_35	20000	EUR	44989994	45007205	17211
EUR_35	20000	EUR	49607146	49698362	91216
EUR_35	20000	EUR	56602155	56698672	96517
EUR_35	20000	EUR	56966549	57009137	42588
EUR_35	20000	EUR	65661197	65664434	3237
EUR_35	20000	EUR	67159723	67187666	27943
EUR_35	20000	EUR	67276558	67408005	131447
EUR_35	20000	EUR	67549952	67607566	57614
EUR_35	20000	EUR	70004307	70009272	4965
EUR_35	20000	EUR	70188223	70211790	23567
EUR_35	20000	EUR	78734876	78747316	12440
EUR_35	20000	EUR	78861510	78903305	41795
EUR_35	20000	EUR	79238306	79271383	33077
EUR_35	20000	EUR	79447008	79552411	105403
EUR_35	20000	EUR	81402768	81515940	113172
EUR_35	20000	EUR	84238411	84252060	13649
EUR_35	20000	EUR	85029423	85147241	117818
EUR_35	20000	EUR	89558335	89600117	41782
EUR_35	20000	EUR	91688443	91694947	6504
EUR_35	20000	EUR	91882426	91908013	25587
EUR_35	20000	EUR	94980195	95277967	297772
EUR_35	20000	EUR	99303539	99392605	89066
EUR_35	20000	EUR	99813314	99984726	171412
EUR_35	20000	EUR	1161310	1181127	19817
EUR_35	20000	EUR	3019853	3374276	354423
EUR_35	20000	EUR	3396867	3582819	185952
EUR_35	20000	EUR	3790953	3826448	35495
EUR_35	20000	EUR	10681365	10720946	39581
EUR_35	20000	EUR	10749153	10795559	46406
EUR_35	20000	EUR	16370454	16371547	1093
EUR_35	20000	EUR	16438218	16564941	126723
EUR_35	20000	EUR	18507282	18660573	153291
EUR_35	20000	EUR	19067739	19323620	255881
EUR_35	20000	EUR	19623556	19668854	45298
EUR_35	20000	EUR	32175477	32179918	4441
EUR_35	20000	EUR	35115895	35203216	87321
EUR_35	20000	EUR	41416776	41431694	14918
EUR_35	20000	EUR	42566068	42581257	15189
EUR_35	20000	EUR	45494244	45516351	22107
EUR_35	20000	EUR	47923463	48189215	265752
EUR_35	20000	EUR	53575871	53642452	66581
EUR_35	20000	EUR	56346050	56669405	323355
EUR_35	20000	EUR	56954709	57084783	130074
EUR_35	20000	EUR	58192568	58236716	44148
EUR_35	20000	EUR	66856055	66985885	129830
EUR_35	20000	EUR	67338551	67607566	269015
EUR_35	20000	EUR	69866716	69968902	102186
EUR_35	20000	EUR	82080492	82083585	3093
EUR_35	20000	EUR	82462526	82499742	37216
EUR_35	20000	EUR	82633504	82651919	18415
EUR_35	20000	EUR	83454325	83547224	92899
EUR_35	20000	EUR	92354903	92385296	30393
EUR_35	20000	EUR	95452104	95533801	81697
EUR_35	20000	EUR	96509826	96742144	232318
EUR_35	20000	EUR	99592355	99715506	123151
EUR_36	20000	EUR	1047633	1193517	145884
EUR_36	20000	EUR	2976688	3207981	231293
EUR_36	20000	EUR	3495502	3590308	94806
EUR_36	20000	EUR	3635056	3642579	7523
EUR_36	20000	EUR	3803877	3822465	18588
EUR_36	20000	EUR	7100116	7142898	42782
EUR_36	20000	EUR	10690096	10697984	7888
EUR_36	20000	EUR	17641535	17771299	129764
EUR_36	20000	EUR	19028853	19119243	90390
EUR_36	20000	EUR	19380328	19442215	61887
EUR_36	20000	EUR	19792475	19803372	10897
EUR_36	20000	EUR	31418549	31432364	13815
EUR_36	20000	EUR	32175477	32179918	4441
EUR_36	20000	EUR	33574614	33907895	333281
EUR_36	20000	EUR	36008481	36095343	86862
EUR_36	20000	EUR	36668091	36675113	7022
EUR_36	20000	EUR	56346050	56442568	96518
EUR_36	20000	EUR	56455034	56511339	56305
EUR_36	20000	EUR	56647869	56698672	50803
EUR_36	20000	EUR	66928149	67340350	412201
EUR_36	20000	EUR	70188223	70207808	19585
EUR_36	20000	EUR	82016051	82083585	67534
EUR_36	20000	EUR	82576187	82590158	13971
EUR_36	20000	EUR	82959860	83015744	55884
EUR_36	20000	EUR	95399383	95426293	26910
EUR_36	20000	EUR	96509826	96742144	232318
EUR_36	20000	EUR	98535023	98645877	110854
EUR_36	20000	EUR	1753052	1779619	26567
EUR_36	20000	EUR	2823983	2874343	50360
EUR_36	20000	EUR	3116644	3518836	402192
EUR_36	20000	EUR	6875207	7000601	125394
EUR_36	20000	EUR	7271460	7395550	124090
EUR_36	20000	EUR	7423463	7444390	20927
EUR_36	20000	EUR	8479126	8681247	202121
EUR_36	20000	EUR	8836060	8841421	5361
EUR_36	20000	EUR	9089745	9104667	14922
EUR_36	20000	EUR	19736300	20177391	441091
EUR_36	20000	EUR	30016686	30042531	25845
EUR_36	20000	EUR	32299403	32319559	20156
EUR_36	20000	EUR	33554925	33628750	73825
EUR_36	20000	EUR	35123729	35161851	38122
EUR_36	20000	EUR	45187253	45194828	7575
EUR_36	20000	EUR	49607146	49664984	57838
EUR_36	20000	EUR	50473932	50483606	9674
EUR_36	20000	EUR	52544603	52582641	38038
EUR_36	20000	EUR	52694749	52731110	36361
EUR_36	20000	EUR	56455034	56536698	81664
EUR_36	20000	EUR	58019801	58236716	216915
EUR_36	20000	EUR	59364412	59536453	172041
EUR_36	20000	EUR	66770704	66818294	47590
EUR_36	20000	EUR	78734876	78747316	12440
EUR_36	20000	EUR	79222705	79271383	48678
EUR_36	20000	EUR	80357099	80358802	1703
EUR_36	20000	EUR	82064858	82087552	22694
EUR_36	20000	EUR	82576187	82716576	140389
EUR_36	20000	EUR	82934867	83015744	80877
EUR_36	20000	EUR	89558335	89703066	144731
EUR_36	20000	EUR	92285154	92304766	19612
EUR_36	20000	EUR	95395717	95403617	7900
EUR_36	20000	EUR	97281793	97491937	210144
EUR_36	20000	EUR	99540802	99639506	98704
EUR_37	20000	EUR	247042	395335	148293
EUR_37	20000	EUR	754530	769049	14519
EUR_37	20000	EUR	2787510	2905256	117746
EUR_37	20000	EUR	3737345	3822465	85120
EUR_37	20000	EUR	7285890	7384499	98609
EUR_37	20000	EUR	10681365	10720946	39581
EUR_37	20000	EUR	10749153	10795559	46406
EUR_37	20000	EUR	17875815	17927018	51203
EUR_37	20000	EUR	19247134	19407151	160017
EUR_37	20000	EUR	21093473	21220760	127287
EUR_37	20000	EUR	32175477	32294968	119491
EUR_37	20000	EUR	41352902	41381534	28632
EUR_37	20000	EUR	41560941	41681027	120086
EUR_37	20000	EUR	48358044	48404781	46737
EUR_37	20000	EUR	51056715	51066845	10130
EUR_37	20000	EUR	53316762	53404500	87738
EUR_37	20000	EUR	56602535	56698672	96137
EUR_37	20000	EUR	60413365	60417758	4393
EUR_37	20000	EUR	66850941	66977162	126221
EUR_37	20000	EUR	71150972	71263561	112589
EUR_37	20000	EUR	81689821	81693416	3595
EUR_37	20000	EUR	85029423	85147241	117818
EUR_37	20000	EUR	95119217	95300815	181598
EUR_37	20000	EUR	95340281	95373783	33502
EUR_37	20000	EUR	95461014	95496972	35958
EUR_37	20000	EUR	97281793	97314868	33075
EUR_37	20000	EUR	97473401	97557354	83953
EUR_37	20000	EUR	99259148	99301587	42439
EUR_37	20000	EUR	600754	746730	145976
EUR_37	20000	EUR	1593085	1596131	3046
EUR_37	20000	EUR	1895950	2108713	212763
EUR_37	20000	EUR	2197269	2246295	49026
EUR_37	20000	EUR	2837849	2839560	1711
EUR_37	20000	EUR	3472162	3822465	350303
EUR_37	20000	EUR	7247034	7352828	105794
EUR_37	20000	EUR	10623618	10626406	2788
EUR_37	20000	EUR	19201729	19407151	205422
EUR_37	20000	EUR	19736300	20004443	268143
EUR_37	20000	EUR	23077256	23091932	14676
EUR_37	20000	EUR	32623192	32767766	144574
EUR_37	20000	EUR	33574614	33727450	152836
EUR_37	20000	EUR	34342584	34449791	107207
EUR_37	20000	EUR	45055797	45067243	11446
EUR_37	20000	EUR	47999655	48059468	59813
EUR_37	20000	EUR	48654788	48782792	128004
EUR_37	20000	EUR	48885950	48891674	5724
EUR_37	20000	EUR	49686447	49698362	11915
EUR_37	20000	EUR	59449144	59536453	87309
EUR_37	20000	EUR	67072065	67110807	38742
EUR_37	20000	EUR	70004307	70009272	4965
EUR_37	20000	EUR	78813158	78855950	42792
EUR_37	20000	EUR	78889907	78903305	13398
EUR_37	20000	EUR	79111577	79183236	71659
EUR_37	20000	EUR	79283689	79366572	82883
EUR_37	20000	EUR	82385253	82516673	131420
EUR_37	20000	EUR	82659843	82684458	24615
EUR_37	20000	EUR	83003249	83015744	12495
EUR_37	20000	EUR	85029423	85147241	117818
EUR_37	20000	EUR	89942056	89968908	26852
EUR_37	20000	EUR	91705647	91709808	4161
EUR_37	20000	EUR	99542125	99585763	43638
EUR_38	20000	EUR	1664395	1673494	9099
EUR_38	20000	EUR	2976688	3270160	293472
EUR_38	20000	EUR	3328707	3825022	496315
EUR_38	20000	EUR	7100116	7126278	26162
EUR_38	20000	EUR	7285890	7444390	158500
EUR_38	20000	EUR	8877834	9033570	155736
EUR_38	20000	EUR	13163085	13184339	21254
EUR_38	20000	EUR	32175477	32309203	133726
EUR_38	20000	EUR	36685026	36799457	114431
EUR_38	20000	EUR	36936037	36984241	48204
EUR_38	20000	EUR	41178130	41221059	42929
EUR_38	20000	EUR	41398261	41408428	10167
EUR_38	20000	EUR	41567652	41681027	113375
EUR_38	20000	EUR	60571076	60879947	308871
EUR_38	20000	EUR	70508217	70509937	1720
EUR_38	20000	EUR	70595371	70733144	137773
EUR_38	20000	EUR	79127546	79183236	55690
EUR_38	20000	EUR	81402768	81515940	113172
EUR_38	20000	EUR	82238363	82245156	6793
EUR_38	20000	EUR	87906544	87974770	68226
EUR_38	20000	EUR	91375278	91696322	321044
EUR_38	20000	EUR	96509826	96511423	1597
EUR_38	20000	EUR	1382908	1552203	169295
EUR_38	20000	EUR	3038298	3277495	239197
EUR_38	20000	EUR	4258951	4412796	153845
EUR_38	20000	EUR	7327093	7343690	16597
EUR_38	20000	EUR	10749153	10795559	46406
EUR_38	20000	EUR	18962861	19020063	57202
EUR_38	20000	EUR	20003819	20157102	153283
EUR_38	20000	EUR	41302914	41304096	1182
EUR_38	20000	EUR	44988065	45067243	79178
EUR_38	20000	EUR	48358044	48393887	35843
EUR_38	20000	EUR	52344468	52374049	29581
EUR_38	20000	EUR	55478933	55490413	11480
EUR_38	20000	EUR	79182474	79271383	88909
EUR_38	20000	EUR	81471610	81515940	44330
EUR_38	20000	EUR	85074649	85097712	23063
EUR_38	20000	EUR	85886159	85925897	39738
EUR_38	20000	EUR	89558335	89600117	41782
EUR_38	20000	EUR	95222998	95234688	11690
EUR_38	20000	EUR	99476532	99715506	238974
EUR_39	20000	EUR	294963	360476	65513
EUR_39	20000	EUR	991447	1124226	132779
EUR_39	20000	EUR	1895950	2150661	254711
EUR_39	20000	EUR	3012618	3286475	273857
EUR_39	20000	EUR	3316499	3351992	35493
EUR_39	20000	EUR	3570215	3571572	1357
EUR_39	20000	EUR	4258951	4412796	153845
EUR_39	20000	EUR	17875815	17927018	51203
EUR_39	20000	EUR	18999038	19139790	140752
EUR_39	20000	EUR	31418549	31442444	23895
EUR_39	20000	EUR	32299403	32319559	20156
EUR_39	20000	EUR	33652710	33654397	1687
EUR_39	20000	EUR	35136263	35157524	21261
EUR_39	20000	EUR	41304634	41336191	31557
EUR_39	20000	EUR	43448444	43495024	46580
EUR_39	20000	EUR	45518747	45762645	243898
EUR_39	20000	EUR	58884785	59110988	226203
EUR_39	20000	EUR	66856055	66960977	104922
EUR_39	20000	EUR	70004307	70009272	4965
EUR_39	20000	EUR	72264646	72357928	93282
EUR_39	20000	EUR	78813158	78903305	90147
EUR_39	20000	EUR	79182474	79271383	88909
EUR_39	20000	EUR	80357099	80426471	69372
EUR_39	20000	EUR	82506043	82572376	66333
EUR_39	20000	EUR	82683334	82711423	28089
EUR_39	20000	EUR	84244698	84290090	45392
EUR_39	20000	EUR	85006299	85147241	140942
EUR_39	20000	EUR	85523737	85529026	5289
EUR_39	20000	EUR	89558335	89600117	41782
EUR_39	20000	EUR	89758766	89761001	2235
EUR_39	20000	EUR	96688206	96742144	53938
EUR_39	20000	EUR	99476532	99715506	238974
EUR_39	20000	EUR	982163	1034789	52626
EUR_39	20000	EUR	1181129	1240732	59603
EUR_39	20000	EUR	7247034	7290142	43108
EUR_39	20000	EUR	7423463	7444390	20927
EUR_39	20000	EUR	31418549	31442444	23895
EUR_39	20000	EUR	32175477	32179918	4441
EUR_39	20000	EUR	33440393	33495347	54954
EUR_39	20000	EUR	35093561	35112980	19419
EUR_39	20000	EUR	35173911	35203216	29305
EUR_39	20000	EUR	42325382	42442844	117462
EUR_39	20000	EUR	43481608	43494178	12570
EUR_39	20000	EUR	48360235	48384935	24700
EUR_39	20000	EUR	49580431	49608883	28452
EUR_39	20000	EUR	53081133	53101280	20147
EUR_39	20000	EUR	53316762	53336041	19279
EUR_39	20000	EUR	56346050	56473093	127043
EUR_39	20000	EUR	56602535	56619608	17073
EUR_39	20000	EUR	60548697	60633643	84946
EUR_39	20000	EUR	66061294	66090240	28946
EUR_39	20000	EUR	66910347	67340350	430003
EUR_39	20000	EUR	70508217	70509937	1720
EUR_39	20000	EUR	79182474	79271383	88909
EUR_39	20000	EUR	84225779	84252060	26281
EUR_39	20000	EUR	85006299	85021747	15448
EUR_39	20000	EUR	87773888	87967747	193859
EUR_39	20000	EUR	89725515	89761001	35486
EUR_39	20000	EUR	94980195	95237753	257558
EUR_39	20000	EUR	99099431	99223970	124539
EUR_39	20000	EUR	99808840	99847705	38865
EUR_40	20000	EUR	900240	925320	25080
EUR_40	20000	EUR	1378334	1458599	80265
EUR_40	20000	EUR	1542208	1596131	53923
EUR_40	20000	EUR	2877497	2905256	27759
EUR_40	20000	EUR	3402262	3421554	19292
EUR_40	20000	EUR	3571215	3815990	244775
EUR_40	20000	EUR	7271460	7403713	132253
EUR_40	20000	EUR	8706590	8722903	16313
EUR_40	20000	EUR	8727732	8988757	261025
EUR_40	20000	EUR	15183335	15220027	36692
EUR_40	20000	EUR	19359412	19407151	47739
EUR_40	20000	EUR	25058259	25066628	8369
EUR_40	20000	EUR	25083188	25170422	87234
EUR_40	20000	EUR	35175474	35206137	30663
EUR_40	20000	EUR	36685026	36799457	114431
EUR_40	20000	EUR	36936037	36984241	48204
EUR_40	20000	EUR	42566068	42572084	6016
EUR_40	20000	EUR	42904426	43019273	114847
EUR_40	20000	EUR	45440280	45616366	176086
EUR_40	20000	EUR	47812256	47849685	37429
EUR_40	20000	EUR	48654788	48782792	128004
EUR_40	20000	EUR	48885950	48891674	5724
EUR_40	20000	EUR	52344468	52374049	29581
EUR_40	20000	EUR	52727511	52731110	3599
EUR_40	20000	EUR	56337270	56422085	84815
EUR_40	20000	EUR	56585051	56606246	21195
EUR_40	20000	EUR	70530240	70733144	202904
EUR_40	20000	EUR	78734876	78747316	12440
EUR_40	20000	EUR	82840135	82915453	75318
EUR_40	20000	EUR	91346960	91452363	105403
EUR_40	20000	EUR	92381507	92385296	3789
EUR_40	20000	EUR	93585500	93601439	15939
EUR_40	20000	EUR	95214308	95300815	86507
EUR_40	20000	EUR	95340281	95373783	33502
EUR_40	20000	EUR	95461014	95496972	35958
EUR_40	20000	EUR	1000120	1124329	124209
EUR_40	20000	EUR	1206118	1206788	670
EUR_40	20000	EUR	1293018	1532301	239283
EUR_40	20000	EUR	3092371	3326576	234205
EUR_40	20000	EUR	3486375	3590308	103933
EUR_40	20000	EUR	4316460	4412796	96336
EUR_40	20000	EUR	6852588	6927970	75382
EUR_40	20000	EUR	7484795	7564059	79264
EUR_40	20000	EUR	8970704	9009449	38745
EUR_40	20000	EUR	11134496	11166735	32239
EUR_40	20000	EUR	15183335	15220027	36692
EUR_40	20000	EUR	17641535	17662551	21016
EUR_40	20000	EUR	17875815	17927018	51203
EUR_40	20000	EUR	19974425	20157102	182677
EUR_40	20000	EUR	34433894	34495384	61490
EUR_40	20000	EUR	44879087	45000269	121182
EUR_40	20000	EUR	48792486	48891674	99188
EUR_40	20000	EUR	51232009	51249792	17783
EUR_40	20000	EUR	57787174	57825705	38531
EUR_40	20000	EUR	59364412	59536453	172041
EUR_40	20000	EUR	60454753	60457084	2331
EUR_40	20000	EUR	66061294	66090240	28946
EUR_40	20000	EUR	67072065	67110807	38742
EUR_40	20000	EUR	67530921	67551055	20134
EUR_40	20000	EUR	72239621	72247602	7981
EUR_40	20000	EUR	79326193	79502100	175907
EUR_40	20000	EUR	82064858	82087552	22694
EUR_40	20000	EUR	82576187	82716576	140389
EUR_40	20000	EUR	82934867	83015744	80877
EUR_40	20000	EUR	91688443	91694947	6504
EUR_40	20000	EUR	93220569	93224014	3445
EUR_40	20000	EUR	93643279	93803230	159951
EUR_40	20000	EUR	95119217	95128884	9667
EUR_40	20000	EUR	97281793	97491937	210144
EUR_40	20000	EUR	99540802	99639506	98704
EUR_41	10000	EUR	730747	774133	43386
EUR_41	10000	EUR	1092856	1106052	13196
EUR_41	10000	EUR	1323879	1458599	134720
EUR_41	10000	EUR	1542208	1575396	33188
EUR_41	10000	EUR	1773640	1837067	63427
EUR_41	10000	EUR	1895950	1943779	47829
EUR_41	10000	EUR	2976688	3185521	208833
EUR_41	10000	EUR	7100116	7142898	42782
EUR_41	10000	EUR	7285890	7312341	26451
EUR_41	10000	EUR	8873516	8928424	54908
EUR_41	10000	EUR	19630585	19657947	27362
EUR_41	10000	EUR	31356895	31361543	4648
EUR_41	10000	EUR	32546422	32549426	3004
EUR_41	10000	EUR	35119601	35214677	95076
EUR_41	10000	EUR	36552709	36579439	26730
EUR_41	10000	EUR	43339196	43484312	145116
EUR_41	10000	EUR	43486350	43495024	8674
EUR_41	10000	EUR	44988065	45067243	79178
EUR_41	10000	EUR	45695997	45762645	66648
EUR_41	10000	EUR	48360235	48384935	24700
EUR_41	10000	EUR	53429545	53464647	35102
EUR_41	10000	EUR	56422019	56456281	34262
EUR_41	10000	EUR	57988115	58068801	80686
EUR_41	10000	EUR	60413365	60457084	43719
EUR_41	10000	EUR	60628049	60633643	5594
EUR_41	10000	EUR	66856055	66985885	129830
EUR_41	10000	EUR	69866716	69868345	1629
EUR_41	10000	EUR	70613465	70632799	19334
EUR_41	10000	EUR	79259384	79271383	11999
EUR_41	10000	EUR	81726873	81736500	9627
EUR_41	10000	EUR	82238363	82245156	6793
EUR_41	10000	EUR	82436220	82527279	91059
EUR_41	10000	EUR	82538351	82572376	34025
EUR_41	10000	EUR	89558335	89600117	41782
EUR_41	10000	EUR	91812221	91819470	7249
EUR_41	10000	EUR	93015373	93084994	69621
EUR_41	10000	EUR	186664	335563	148899
EUR_41	10000	EUR	1187573	1193517	5944
EUR_41	10000	EUR	2976688	3129749	153061
EUR_41	10000	EUR	3396867	3451603	54736
EUR_41	10000	EUR	3570215	3571572	1357
EUR_41	10000	EUR	3667391	3706513	39122
EUR_41	10000	EUR	3721616	3822465	100849
EUR_41	10000	EUR	4316460	4326054	9594
EUR_41	10000	EUR	8873516	8928424	54908
EUR_41	10000	EUR	10760924	10795559	34635
EUR_41	10000	EUR	15268570	15340436	71866
EUR_41	10000	EUR	16255343	16255638	295
EUR_41	10000	EUR	16272182	16303094	30912
EUR_41	10000	EUR	21114661	21117867	3206
EUR_41	10000	EUR	36552709	36579439	26730
EUR_41	10000	EUR	36943790	36966163	22373
EUR_41	10000	EUR	42378979	42419138	40159
EUR_41	10000	EUR	47923463	48097073	173610
EUR_41	10000	EUR	56358922	56532652	173730
EUR_41	10000	EUR	60548697	60555706	7009
EUR_41	10000	EUR	66910347	66956380	46033
EUR_41	10000	EUR	79474336	79552411	78075
EUR_41	10000	EUR	82436220	82499742	63522
EUR_41	10000	EUR	82633504	82716576	83072
EUR_41	10000	EUR	85250587	85441761	191174
EUR_41	10000	EUR	87773888	87795218	21330
EUR_41	10000	EUR	89558335	89600117	41782
EUR_41	10000	EUR	89942056	89968908	26852
EUR_41	10000	EUR	93015373	93084994	69621
EUR_41	10000	EUR	95022438	95027446	5008
EUR_41	10000	EUR	95399383	95426293	26910
EUR_41	10000	EUR	99530633	99715506	184873
EUR_41	10000	EUR	99884254	99899617	15363
EUR_42	10000	EUR	980545	983042	2497
EUR_42	10000	EUR	1081594	1120804	39210
EUR_42	10000	EUR	2023093	2070833	47740
EUR_42	10000	EUR	2976688	3351992	375304
EUR_42	10000	EUR	3570215	3571572	1357
EUR_42	10000	EUR	3729376	3767957	38581
EUR_42	10000	EUR	4316460	4412796	96336
EUR_42	10000	EUR	8431415	8462772	31357
EUR_42	10000	EUR	8844974	8988757	143783
EUR_42	10000	EUR	15139564	15166529	26965
EUR_42	10000	EUR	16246612	16255638	9026
EUR_42	10000	EUR	16272182	16303094	30912
EUR_42	10000	EUR	19745044	19779206	34162
EUR_42	10000	EUR	20003557	20177391	173834
EUR_42	10000	EUR	31458660	31476899	18239
EUR_42	10000	EUR	34155827	34199650	43823
EUR_42	10000	EUR	35380728	35390337	9609
EUR_42	10000	EUR	41178130	41271125	92995
EUR_42	10000	EUR	41665141	41681027	15886
EUR_42	10000	EUR	43245063	43263827	18764
EUR_42	10000	EUR	43320030	43495024	174994
EUR_42	10000	EUR	44459488	44474348	14860
EUR_42	10000	EUR	47999655	48059468	59813
EUR_42	10000	EUR	48794732	48891674	96942
EUR_42	10000	EUR	52354087	52373324	19237
EUR_42	10000	EUR	56423226	56570099	146873
EUR_42	10000	EUR	60548697	60555706	7009
EUR_42	10000	EUR	66061294	66090240	28946
EUR_42	10000	EUR	66494456	66560664	66208
EUR_42	10000	EUR	66984170	67340350	356180
EUR_42	10000	EUR	69866716	69909880	43164
EUR_42	10000	EUR	81402768	81451486	48718
EUR_42	10000	EUR	82436220	82482721	46501
EUR_42	10000	EUR	89758766	89761001	2235
EUR_42	10000	EUR	90682413	90694613	12200
EUR_42	10000	EUR	91404138	91452363	48225
EUR_42	10000	EUR	93254504	93275476	20972
EUR_42	10000	EUR	95055908	95082994	27086
EUR_42	10000	EUR	577424	609014	31590
EUR_42	10000	EUR	982163	1008476	26313
EUR_42	10000	EUR	1011261	1085505	74244
EUR_42	10000	EUR	1090756	1266258	175502
EUR_42	10000	EUR	2976688	3129749	153061
EUR_42	10000	EUR	3222243	3280806	58563
EUR_42	10000	EUR	4359650	4412796	53146
EUR_42	10000	EUR	8431415	8462772	31357
EUR_42	10000	EUR	14586202	14590162	3960
EUR_42	10000	EUR	16246612	16303041	56429
EUR_42	10000	EUR	16592249	16664436	72187
EUR_42	10000	EUR	19736300	19830798	94498
EUR_42	10000	EUR	32175477	32252839	77362
EUR_42	10000	EUR	32735904	32745150	9246
EUR_42	10000	EUR	34433894	34495384	61490
EUR_42	10000	EUR	35055953	35214677	158724
EUR_42	10000	EUR	53575871	53714402	138531
EUR_42	10000	EUR	56602535	56657479	54944
EUR_42	10000	EUR	67159723	67187666	27943
EUR_42	10000	EUR	67276558	67408005	131447
EUR_42	10000	EUR	78734876	78747316	12440
EUR_42	10000	EUR	78953619	79366572	412953
EUR_42	10000	EUR	81409963	81468934	58971
EUR_42	10000	EUR	82841050	83015744	174694
EUR_42	10000	EUR	84225779	84252060	26281
EUR_42	10000	EUR	89558335	89600117	41782
EUR_42	10000	EUR	91375278	91696322	321044
EUR_42	10000	EUR	93250902	93275476	24574
EUR_42	10000	EUR	93643279	93803230	159951
EUR_42	10000	EUR	98607589	98645877	38288
EUR_42	10000	EUR	99609401	99664291	54890
EUR_42	10000	EUR	99808840	99847705	38865
EUR_43	10000	EUR	1080859	1193517	112658
EUR_43	10000	EUR	1478834	1523211	44377
EUR_43	10000	EUR	2976688	3019751	43063
EUR_43	10000	EUR	3441533	3441853	320
EUR_43	10000	EUR	3511197	3590308	79111
EUR_43	10000	EUR	7355966	7444390	88424
EUR_43	10000	EUR	8431415	8462576	31161
EUR_43	10000	EUR	15183335	15220027	36692
EUR_43	10000	EUR	18637982	18660573	22591
EUR_43	10000	EUR	19191008	19287853	96845
EUR_43	10000	EUR	19433185	19436972	3787
EUR_43	10000	EUR	19532548	19535611	3063
EUR_43	10000	EUR	19974425	20157102	182677
EUR_43	10000	EUR	33886572	33907895	21323
EUR_43	10000	EUR	34704553	34725043	20490
EUR_43	10000	EUR	35055953	35161248	105295
EUR_43	10000	EUR	35353983	35390337	36354
EUR_43	10000	EUR	47923463	48189215	265752
EUR_43	10000	EUR	48648038	48651741	3703
EUR_43	10000	EUR	48759833	48890256	130423
EUR_43	10000	EUR	58032752	58041411	8659
EUR_43	10000	EUR	60297755	60344148	46393
EUR_43	10000	EUR	60628049	60633643	5594
EUR_43	10000	EUR	65661197	65664434	3237
EUR_43	10000	EUR	66998030	67296566	298536
EUR_43	10000	EUR	69959618	69968902	9284
EUR_43	10000	EUR	70647240	70689978	42738
EUR_43	10000	EUR	78826314	78841506	15192
EUR_43	10000	EUR	81700971	81757509	56538
EUR_43	10000	EUR	81814168	82026126	211958
EUR_43	10000	EUR	82840135	82876517	36382
EUR_43	10000	EUR	90678791	90694613	15822
EUR_43	10000	EUR	91488729	91581405	92676
EUR_43	10000	EUR	91812221	91819470	7249
EUR_43	10000	EUR	93015373	93084994	69621
EUR_43	10000	EUR	98789285	98816945	27660
EUR_43	10000	EUR	547015	609014	61999
EUR_43	10000	EUR	1323879	1458599	134720
EUR_43	10000	EUR	2823983	2867170	43187
EUR_43	10000	EUR	3096445	3129786	33341
EUR_43	10000	EUR	3176333	3438847	262514
EUR_43	10000	EUR	3626640	3815944	189304
EUR_43	10000	EUR	7100116	7142898	42782
EUR_43	10000	EUR	8431415	8462772	31357
EUR_43	10000	EUR	8877834	9033570	155736
EUR_43	10000	EUR	14998007	15083355	85348
EUR_43	10000	EUR	16370454	16408891	38437
EUR_43	10000	EUR	16533029	16584779	51750
EUR_43	10000	EUR	17752821	17771299	18478
EUR_43	10000	EUR	18507282	18660573	153291
EUR_43	10000	EUR	19236260	19246110	9850
EUR_43	10000	EUR	19664660	19779206	114546
EUR_43	10000	EUR	31458660	31476899	18239
EUR_43	10000	EUR	36685026	36701133	16107
EUR_43	10000	EUR	41302914	41304096	1182
EUR_43	10000	EUR	42434180	42468677	34497
EUR_43	10000	EUR	53327088	53392114	65026
EUR_43	10000	EUR	56337270	56422085	84815
EUR_43	10000	EUR	69959691	70010468	50777
EUR_43	10000	EUR	81750815	81757509	6694
EUR_43	10000	EUR	81814168	81856606	42438
EUR_43	10000	EUR	87898363	87974770	76407
EUR_43	10000	EUR	89145004	89151330	6326
EUR_43	10000	EUR	91375278	91696322	321044
EUR_43	10000	EUR	93015373	93084994	69621
EUR_43	10000	EUR	95407458	95431258	23800
EUR_43	10000	EUR	99540802	99639506	98704
EUR_44	10000	EUR	223591	254684	31093
EUR_44	10000	EUR	412113	418947	6834
EUR_44	10000	EUR	980545	983042	2497
EUR_44	10000	EUR	1081594	1120804	39210
EUR_44	10000	EUR	3037257	3129749	92492
EUR_44	10000	EUR	3396867	3582819	185952
EUR_44	10000	EUR	3790953	3826448	35495
EUR_44	10000	EUR	6915640	6927970	12330
EUR_44	10000	EUR	8967321	9013330	46009
EUR_44	10000	EUR	16257486	16324947	67461
EUR_44	10000	EUR	19028853	19129178	100325
EUR_44	10000	EUR	19807957	19838993	31036
EUR_44	10000	EUR	19865578	19871020	5442
EUR_44	10000	EUR	20173953	20196095	22142
EUR_44	10000	EUR	31660889	31830949	170060
EUR_44	10000	EUR	32175477	32294968	119491
EUR_44	10000	EUR	32619676	32630721	11045
EUR_44	10000	EUR	36361073	36519208	158135
EUR_44	10000	EUR	36896742	36907882	11140
EUR_44	10000	EUR	43359647	43386168	26521
EUR_44	10000	EUR	44896429	45041077	144648
EUR_44	10000	EUR	66910347	66960516	50169
EUR_44	10000	EUR	70188223	70211790	23567
EUR_44	10000	EUR	70647240	70689978	42738
EUR_44	10000	EUR	71042150	71050814	8664
EUR_44	10000	EUR	71242461	71278921	36460
EUR_44	10000	EUR	78826314	78841506	15192
EUR_44	10000	EUR	79451135	79536134	84999
EUR_44	10000	EUR	81855367	81856606	1239
EUR_44	10000	EUR	83454325	83547224	92899
EUR_44	10000	EUR	85006299	85022197	15898
EUR_44	10000	EUR	89558335	89600117	41782
EUR_44	10000	EUR	89942056	89968908	26852
EUR_44	10000	EUR	91619716	91685112	65396
EUR_44	10000	EUR	91685512	91709808	24296
EUR_44	10000	EUR	95022438	95027446	5008
EUR_44	10000	EUR	97384296	97392053	7757
EUR_44	10000	EUR	98197423	98239509	42086
EUR_44	10000	EUR	98535023	98623839	88816
EUR_44	10000	EUR	433602	533076	99474
EUR_44	10000	EUR	2282711	2354747	72036
EUR_44	10000	EUR	3123264	3135851	12587
EUR_44	10000	EUR	7311035	7444390	133355
EUR_44	10000	EUR	14586202	14616963	30761
EUR_44	10000	EUR	15139564	15166529	26965
EUR_44	10000	EUR	19630585	19657947	27362
EUR_44	10000	EUR	19724264	19779206	54942
EUR_44	10000	EUR	19829397	19838993	9596
EUR_44	10000	EUR	19865578	19871020	5442
EUR_44	10000	EUR	20003557	20014128	10571
EUR_44	10000	EUR	30016686	30042531	25845
EUR_44	10000	EUR	31660889	31830949	170060
EUR_44	10000	EUR	32175477	32294968	119491
EUR_44	10000	EUR	32546422	32549426	3004
EUR_44	10000	EUR	33554925	33743699	188774
EUR_44	10000	EUR	34704553	34725043	20490
EUR_44	10000	EUR	41561641	41605833	44192
EUR_44	10000	EUR	42887794	42889249	1455
EUR_44	10000	EUR	49686447	49698362	11915
EUR_44	10000	EUR	50402581	50432831	30250
EUR_44	10000	EUR	53316762	53404500	87738
EUR_44	10000	EUR	56346050	56423333	77283
EUR_44	10000	EUR	56438557	56457263	18706
EUR_44	10000	EUR	56954709	57084783	130074
EUR_44	10000	EUR	66185633	66199431	13798
EUR_44	10000	EUR	66770704	66818294	47590
EUR_44	10000	EUR	66910347	66956380	46033
EUR_44	10000	EUR	79189815	79192580	2765
EUR_44	10000	EUR	81412372	81473563	61191
EUR_44	10000	EUR	85427054	85442056	15002
EUR_44	10000	EUR	85518750	85559052	40302
EUR_44	10000	EUR	93220569	93224014	3445
EUR_44	10000	EUR	95340281	95373783	33502
EUR_44	10000	EUR	99540802	99639506	98704
EUR_45	10000	EUR	454672	538194	83522
EUR_45	10000	EUR	1187573	1193517	5944
EUR_45	10000	EUR	3210653	3335219	124566
EUR_45	10000	EUR	3684886	3706513	21627
EUR_45	10000	EUR	7271460	7305845	34385
EUR_45	10000	EUR	7423463	7444390	20927
EUR_45	10000	EUR	7571897	7614045	42148
EUR_45	10000	EUR	8967321	9013330	46009
EUR_45	10000	EUR	9863180	9949611	86431
EUR_45	10000	EUR	14586202	14674916	88714
EUR_45	10000	EUR	18962861	19020063	57202
EUR_45	10000	EUR	19630585	19657947	27362
EUR_45	10000	EUR	19724264	19779206	54942
EUR_45	10000	EUR	20155073	20196095	41022
EUR_45	10000	EUR	24452192	24527742	75550
EUR_45	10000	EUR	30016686	30042531	25845
EUR_45	10000	EUR	31362334	31414107	51773
EUR_45	10000	EUR	32175477	32254183	78706
EUR_45	10000	EUR	32299403	32300958	1555
EUR_45	10000	EUR	32680460	32767766	87306
EUR_45	10000	EUR	35100774	35112980	12206
EUR_45	10000	EUR	44991814	45007205	15391
EUR_45	10000	EUR	45034982	45045358	10376
EUR_45	10000	EUR	48358044	48404781	46737
EUR_45	10000	EUR	56346050	56363867	17817
EUR_45	10000	EUR	56423226	56457263	34037
EUR_45	10000	EUR	56639608	56698672	59064
EUR_45	10000	EUR	56954709	57084783	130074
EUR_45	10000	EUR	60548697	60633643	84946
EUR_45	10000	EUR	66787594	66818294	30700
EUR_45	10000	EUR	70119979	70214124	94145
EUR_45	10000	EUR	70712440	70768469	56029
EUR_45	10000	EUR	78734876	78747316	12440
EUR_45	10000	EUR	79389052	79498919	109867
EUR_45	10000	EUR	81433691	81515940	82249
EUR_45	10000	EUR	81743887	81757509	13622
EUR_45	10000	EUR	81814168	81856606	42438
EUR_45	10000	EUR	82436220	82572376	136156
EUR_45	10000	EUR	82683334	82850412	167078
EUR_45	10000	EUR	82934867	83015744	80877
EUR_45	10000	EUR	84225779	84252060	26281
EUR_45	10000	EUR	85886159	85888167	2008
EUR_45	10000	EUR	94980195	95082994	102799
EUR_45	10000	EUR	99259148	99309052	49904
EUR_45	10000	EUR	99896793	99959275	62482
EUR_45	10000	EUR	735778	856793	121015
EUR_45	10000	EUR	1092856	1106052	13196
EUR_45	10000	EUR	1323879	1417007	93128
EUR_45	10000	EUR	1773640	1837067	63427
EUR_45	10000	EUR	1895950	1943779	47829
EUR_45	10000	EUR	3012618	3027029	14411
EUR_45	10000	EUR	3330740	3375407	44667
EUR_45	10000	EUR	6852588	6920135	67547
EUR_45	10000	EUR	7285890	7338110	52220
EUR_45	10000	EUR	8830982	8872441	41459
EUR_45	10000	EUR	9089745	9104667	14922
EUR_45	10000	EUR	14586202	14616963	30761
EUR_45	10000	EUR	17641535	17757633	116098
EUR_45	10000	EUR	17875815	17927018	51203
EUR_45	10000	EUR	18543057	18660573	117516
EUR_45	10000	EUR	19191008	19336768	145760
EUR_45	10000	EUR	19360499	19374548	14049
EUR_45	10000	EUR	20003557	20122144	118587
EUR_45	10000	EUR	23077256	23091932	14676
EUR_45	10000	EUR	30016686	30027821	11135
EUR_45	10000	EUR	32546422	32549426	3004
EUR_45	10000	EUR	36012355	36025293	12938
EUR_45	10000	EUR	36552709	36579439	26730
EUR_45	10000	EUR	41302914	41304096	1182
EUR_45	10000	EUR	43245063	43263827	18764
EUR_45	10000	EUR	44988065	45067243	79178
EUR_45	10000	EUR	47967792	48023849	56057
EUR_45	10000	EUR	48759833	48891674	131841
EUR_45	10000	EUR	56358922	56698672	339750
EUR_45	10000	EUR	59397484	59434986	37502
EUR_45	10000	EUR	60039225	60127183	87958
EUR_45	10000	EUR	60302138	60309656	7518
EUR_45	10000	EUR	71281498	71570198	288700
EUR_45	10000	EUR	72242581	72318801	76220
EUR_45	10000	EUR	80532855	80542475	9620
EUR_45	10000	EUR	81402768	81515940	113172
EUR_45	10000	EUR	81967773	82020179	52406
EUR_45	10000	EUR	82703092	82716576	13484
EUR_45	10000	EUR	82934867	83015744	80877
EUR_45	10000	EUR	89758766	89761001	2235
EUR_45	10000	EUR	91346960	91452363	105403
EUR_45	10000	EUR	92354903	92380512	25609
EUR_45	10000	EUR	93223845	93275476	51631
EUR_45	10000	EUR	95022438	95027446	5008
EUR_45	10000	EUR	95399383	95426293	26910
EUR_45	10000	EUR	97383224	97392053	8829
EUR_46	10000	EUR	754530	882764	128234
EUR_46	10000	EUR	1140343	1149476	9133
EUR_46	10000	EUR	1161080	1193517	32437
EUR_46	10000	EUR	2282711	2298513	15802
EUR_46	10000	EUR	2976688	3019751	43063
EUR_46	10000	EUR	3536418	3625436	89018
EUR_46	10000	EUR	6895161	6983517	88356
EUR_46	10000	EUR	7247034	7352828	105794
EUR_46	10000	EUR	7364568	7395550	30982
EUR_46	10000	EUR	7423463	7444390	20927
EUR_46	10000	EUR	8967321	9013330	46009
EUR_46	10000	EUR	16477443	16564941	87498
EUR_46	10000	EUR	17641535	17757633	116098
EUR_46	10000	EUR	17875815	17927018	51203
EUR_46	10000	EUR	19243625	19444712	201087
EUR_46	10000	EUR	20016631	20157102	140471
EUR_46	10000	EUR	21093473	21184308	90835
EUR_46	10000	EUR	31418549	31432364	13815
EUR_46	10000	EUR	32175477	32179918	4441
EUR_46	10000	EUR	33652710	33654397	1687
EUR_46	10000	EUR	33886572	33907895	21323
EUR_46	10000	EUR	35123729	35161851	38122
EUR_46	10000	EUR	36456218	36593647	137429
EUR_46	10000	EUR	41302914	41304096	1182
EUR_46	10000	EUR	56423226	56457263	34037
EUR_46	10000	EUR	56681247	56694506	13259
EUR_46	10000	EUR	56954709	57084783	130074
EUR_46	10000	EUR	58032752	58041411	8659
EUR_46	10000	EUR	58884785	59110988	226203
EUR_46	10000	EUR	59465551	59480634	15083
EUR_46	10000	EUR	60253489	60311705	58216
EUR_46	10000	EUR	66770704	66818294	47590
EUR_46	10000	EUR	70508217	70509937	1720
EUR_46	10000	EUR	71242461	71263307	20846
EUR_46	10000	EUR	79283689	79366572	82883
EUR_46	10000	EUR	81904023	81932143	28120
EUR_46	10000	EUR	82238363	82245156	6793
EUR_46	10000	EUR	82436220	82563112	126892
EUR_46	10000	EUR	83470310	83547224	76914
EUR_46	10000	EUR	91505715	91685112	179397
EUR_46	10000	EUR	91685512	91709808	24296
EUR_46	10000	EUR	98789285	98816945	27660
EUR_46	10000	EUR	99099431	99114971	15540
EUR_46	10000	EUR	700406	736181	35775
EUR_46	10000	EUR	741806	746730	4924
EUR_46	10000	EUR	3136195	3286475	150280
EUR_46	10000	EUR	3316499	3351992	35493
EUR_46	10000	EUR	4258951	4323587	64636
EUR_46	10000	EUR	8873516	8928424	54908
EUR_46	10000	EUR	15183335	15215902	32567
EUR_46	10000	EUR	19236260	19246110	9850
EUR_46	10000	EUR	19630585	19657947	27362
EUR_46	10000	EUR	19724264	19779206	54942
EUR_46	10000	EUR	27432526	27501911	69385
EUR_46	10000	EUR	30016686	30042531	25845
EUR_46	10000	EUR	32175477	32309203	133726
EUR_46	10000	EUR	33554925	33743699	188774
EUR_46	10000	EUR	34182739	34199650	16911
EUR_46	10000	EUR	36668091	36675113	7022
EUR_46	10000	EUR	44879087	44961223	82136
EUR_46	10000	EUR	45490603	45616366	125763
EUR_46	10000	EUR	48885950	48891674	5724
EUR_46	10000	EUR	52511931	52546494	34563
EUR_46	10000	EUR	56366343	56431835	65492
EUR_46	10000	EUR	56438557	56449574	11017
EUR_46	10000	EUR	56866421	56922359	55938
EUR_46	10000	EUR	57832440	57844990	12550
EUR_46	10000	EUR	60039225	60127183	87958
EUR_46	10000	EUR	60302138	60466731	164593
EUR_46	10000	EUR	61392863	61397987	5124
EUR_46	10000	EUR	66061294	66090240	28946
EUR_46	10000	EUR	66494456	66560664	66208
EUR_46	10000	EUR	66984170	67208520	224350
EUR_46	10000	EUR	67276558	67376666	100108
EUR_46	10000	EUR	70004307	70009272	4965
EUR_46	10000	EUR	79263187	79271383	8196
EUR_46	10000	EUR	82238363	82245156	6793
EUR_46	10000	EUR	82436220	82527279	91059
EUR_46	10000	EUR	82538351	82572376	34025
EUR_46	10000	EUR	85380637	85471098	90461
EUR_46	10000	EUR	89561784	89600117	38333
EUR_46	10000	EUR	89942056	89968908	26852
EUR_46	10000	EUR	91505715	91685112	179397
EUR_46	10000	EUR	91685512	91709808	24296
EUR_46	10000	EUR	93245992	93275476	29484
EUR_46	10000	EUR	98197423	98310034	112611
EUR_47	10000	EUR	700406	714528	14122
EUR_47	10000	EUR	982163	1008476	26313
EUR_47	10000	EUR	1011261	1085505	74244
EUR_47	10000	EUR	1090756	1266258	175502
EUR_47	10000	EUR	2787510	2841626	54116
EUR_47	10000	EUR	3180984	3438847	257863
EUR_47	10000	EUR	3536418	3611602	75184
EUR_47	10000	EUR	7423463	7444390	20927
EUR_47	10000	EUR	8431415	8462772	31357
EUR_47	10000	EUR	10690096	10691746	1650
EUR_47	10000	EUR	16251298	16324947	73649
EUR_47	10000	EUR	19091921	19139790	47869
EUR_47	10000	EUR	19297247	19304962	7715
EUR_47	10000	EUR	19623556	19668854	45298
EUR_47	10000	EUR	33886572	33907895	21323
EUR_47	10000	EUR	34155827	34171887	16060
EUR_47	10000	EUR	35176621	35214677	38056
EUR_47	10000	EUR	36012355	36025293	12938
EUR_47	10000	EUR	36552709	36579439	26730
EUR_47	10000	EUR	42566068	42581257	15189
EUR_47	10000	EUR	47967792	48023849	56057
EUR_47	10000	EUR	56356651	56422085	65434
EUR_47	10000	EUR	59517573	59536453	18880
EUR_47	10000	EUR	60253489	60318571	65082
EUR_47	10000	EUR	60451449	60457084	5635
EUR_47	10000	EUR	60596138	60633643	37505
EUR_47	10000	EUR	65661197	65664434	3237
EUR_47	10000	EUR	71281498	71413825	132327
EUR_47	10000	EUR	79182474	79271383	88909
EUR_47	10000	EUR	81402768	81416199	13431
EUR_47	10000	EUR	84225779	84252060	26281
EUR_47	10000	EUR	93254504	93270480	15976
EUR_47	10000	EUR	95428311	95488102	59791
EUR_47	10000	EUR	429223	538194	108971
EUR_47	10000	EUR	991447	1020999	29552
EUR_47	10000	EUR	1081594	1120804	39210
EUR_47	10000	EUR	1753052	1779619	26567
EUR_47	10000	EUR	3287689	3423567	135878
EUR_47	10000	EUR	7100116	7142898	42782
EUR_47	10000	EUR	7285890	7312341	26451
EUR_47	10000	EUR	8647888	8722903	75015
EUR_47	10000	EUR	8727732	8821493	93761
EUR_47	10000	EUR	15268570	15356892	88322
EUR_47	10000	EUR	19204124	19290144	86020
EUR_47	10000	EUR	19820758	19838993	18235
EUR_47	10000	EUR	19865578	19871020	5442
EUR_47	10000	EUR	20003557	20014128	10571
EUR_47	10000	EUR	20191471	20196095	4624
EUR_47	10000	EUR	32648371	32763079	114708
EUR_47	10000	EUR	33440393	33495347	54954
EUR_47	10000	EUR	43446058	43489575	43517
EUR_47	10000	EUR	48013365	48026059	12694
EUR_47	10000	EUR	48654788	48782792	128004
EUR_47	10000	EUR	48885950	48891674	5724
EUR_47	10000	EUR	50473723	50517916	44193
EUR_47	10000	EUR	53575871	53714402	138531
EUR_47	10000	EUR	56602535	56657479	54944
EUR_47	10000	EUR	57787174	57825705	38531
EUR_47	10000	EUR	58884785	58943349	58564
EUR_47	10000	EUR	67530921	67551055	20134
EUR_47	10000	EUR	69959691	70010468	50777
EUR_47	10000	EUR	82436220	82572376	136156
EUR_47	10000	EUR	82683334	82850412	167078
EUR_47	10000	EUR	82934867	83015744	80877
EUR_47	10000	EUR	85029423	85145607	116184
EUR_47	10000	EUR	85427054	85442056	15002
EUR_47	10000	EUR	85518750	85559052	40302
EUR_47	10000	EUR	85886159	85917767	31608
EUR_47	10000	EUR	93015373	93133795	118422
EUR_47	10000	EUR	94980195	95082994	102799
EUR_47	10000	EUR	95399383	95471081	71698
EUR_47	10000	EUR	95479126	95496972	17846
EUR_48	10000	EUR	754530	856793	102263
EUR_48	10000	EUR	1076391	1138741	62350
EUR_48	10000	EUR	1416635	1473702	57067
EUR_48	10000	EUR	1882061	1906837	24776
EUR_48	10000	EUR	1947564	2108713	161149
EUR_48	10000	EUR	2197269	2246295	49026
EUR_48	10000	EUR	2837849	2839560	1711
EUR_48	10000	EUR	3330740	3375407	44667
EUR_48	10000	EUR	6852588	6862349	9761
EUR_48	10000	EUR	7285890	7384499	98609
EUR_48	10000	EUR	7484795	7614045	129250
EUR_48	10000	EUR	9058908	9101753	42845
EUR_48	10000	EUR	19191008	19287853	96845
EUR_48	10000	EUR	19433185	19436972	3787
EUR_48	10000	EUR	19532548	19535611	3063
EUR_48	10000	EUR	19974425	20157102	182677
EUR_48	10000	EUR	31458660	31476899	18239
EUR_48	10000	EUR	36361073	36519208	158135
EUR_48	10000	EUR	47923463	47990229	66766
EUR_48	10000	EUR	50413644	50432831	19187
EUR_48	10000	EUR	56652533	56698672	46139
EUR_48	10000	EUR	57787174	57825705	38531
EUR_48	10000	EUR	59425991	59439453	13462
EUR_48	10000	EUR	60596138	60633643	37505
EUR_48	10000	EUR	61392863	61429915	37052
EUR_48	10000	EUR	67530921	67541344	10423
EUR_48	10000	EUR	69959618	69968902	9284
EUR_48	10000	EUR	71082622	71226334	143712
EUR_48	10000	EUR	72239621	72247602	7981
EUR_48	10000	EUR	79259384	79271383	11999
EUR_48	10000	EUR	81904023	81932143	28120
EUR_48	10000	EUR	84244698	84290090	45392
EUR_48	10000	EUR	85029423	85145607	116184
EUR_48	10000	EUR	85427054	85442056	15002
EUR_48	10000	EUR	85518750	85559052	40302
EUR_48	10000	EUR	87773888	87795218	21330
EUR_48	10000	EUR	91505715	91632485	126770
EUR_48	10000	EUR	91667508	91709808	42300
EUR_48	10000	EUR	92381507	92385296	3789
EUR_48	10000	EUR	95340281	95373783	33502
EUR_48	10000	EUR	95461014	95496972	35958
EUR_48	10000	EUR	99145421	99157935	12514
EUR_48	10000	EUR	99168845	99223970	55125
EUR_48	10000	EUR	99813314	99881673	68359
EUR_48	10000	EUR	765101	802492	37391
EUR_48	10000	EUR	898536	925320	26784
EUR_48	10000	EUR	1115395	1120804	5409
EUR_48	10000	EUR	1875538	1906837	31299
EUR_48	10000	EUR	2004216	2069051	64835
EUR_48	10000	EUR	3330740	3375407	44667
EUR_48	10000	EUR	3570215	3571572	1357
EUR_48	10000	EUR	3667391	3706513	39122
EUR_48	10000	EUR	3721616	3822465	100849
EUR_48	10000	EUR	7484795	7564059	79264
EUR_48	10000	EUR	14908749	14946157	37408
EUR_48	10000	EUR	15183335	15210745	27410
EUR_48	10000	EUR	19243625	19444712	201087
EUR_48	10000	EUR	19820758	19838993	18235
EUR_48	10000	EUR	19865578	19871020	5442
EUR_48	10000	EUR	20003557	20014128	10571
EUR_48	10000	EUR	32175477	32179369	3892
EUR_48	10000	EUR	33554925	33720789	165864
EUR_48	10000	EUR	43060750	43064538	3788
EUR_48	10000	EUR	49689638	49698362	8724
EUR_48	10000	EUR	56602155	56639139	36984
EUR_48	10000	EUR	57988115	58068801	80686
EUR_48	10000	EUR	66923088	67002781	79693
EUR_48	10000	EUR	67338551	67607566	269015
EUR_48	10000	EUR	70045927	70083443	37516
EUR_48	10000	EUR	70928350	71050814	122464
EUR_48	10000	EUR	71242461	71278921	36460
EUR_48	10000	EUR	78734876	78747316	12440
EUR_48	10000	EUR	79283689	79366572	82883
EUR_48	10000	EUR	81726873	81757509	30636
EUR_48	10000	EUR	81814168	81856606	42438
EUR_49	10000	EUR	412113	538194	126081
EUR_49	10000	EUR	754530	882764	128234
EUR_49	10000	EUR	1140343	1149476	9133
EUR_49	10000	EUR	1161080	1193517	32437
EUR_49	10000	EUR	1753052	1779619	26567
EUR_49	10000	EUR	3249559	3286475	36916
EUR_49	10000	EUR	3316499	3351992	35493
EUR_49	10000	EUR	3645899	3706513	60614
EUR_49	10000	EUR	7100116	7142898	42782
EUR_49	10000	EUR	8830982	8872441	41459
EUR_49	10000	EUR	16255343	16255638	295
EUR_49	10000	EUR	16272182	16303094	30912
EUR_49	10000	EUR	18962861	19020063	57202
EUR_49	10000	EUR	19630585	19657947	27362
EUR_49	10000	EUR	19724264	19779206	54942
EUR_49	10000	EUR	20155073	20196095	41022
EUR_49	10000	EUR	27432526	27501911	69385
EUR_49	10000	EUR	30016686	30042531	25845
EUR_49	10000	EUR	32175477	32188981	13504
EUR_49	10000	EUR	35100774	35112980	12206
EUR_49	10000	EUR	45721329	45762645	41316
EUR_49	10000	EUR	48654788	48782792	128004
EUR_49	10000	EUR	48885950	48891674	5724
EUR_49	10000	EUR	56346050	56442568	96518
EUR_49	10000	EUR	56455034	56511339	56305
EUR_49	10000	EUR	56647869	56698672	50803
EUR_49	10000	EUR	57787174	57825705	38531
EUR_49	10000	EUR	66770704	66842322	71618
EUR_49	10000	EUR	66965773	66968165	2392
EUR_49	10000	EUR	66970662	67089701	119039
EUR_49	10000	EUR	70712856	71050814	337958
EUR_49	10000	EUR	71242461	71278921	36460
EUR_49	10000	EUR	81402768	81515940	113172
EUR_49	10000	EUR	82579505	82590158	10653
EUR_49	10000	EUR	85029423	85043402	13979
EUR_49	10000	EUR	91492814	91567995	75181
EUR_49	10000	EUR	95340281	95373783	33502
EUR_49	10000	EUR	735778	856793	121015
EUR_49	10000	EUR	1187573	1193517	5944
EUR_49	10000	EUR	3199669	3334608	134939
EUR_49	10000	EUR	3805373	3826448	21075
EUR_49	10000	EUR	7285890	7286386	496
EUR_49	10000	EUR	8431415	8462772	31357
EUR_49	10000	EUR	8967321	9013330	46009
EUR_49	10000	EUR	16592249	16615016	22767
EUR_49	10000	EUR	19091921	19139790	47869
EUR_49	10000	EUR	19249126	19271411	22285
EUR_49	10000	EUR	19888581	20177391	288810
EUR_49	10000	EUR	33706075	33759355	53280
EUR_49	10000	EUR	35176621	35214677	38056
EUR_49	10000	EUR	41178130	41261196	83066
EUR_49	10000	EUR	48742096	48782792	40696
EUR_49	10000	EUR	48885950	48891674	5724
EUR_49	10000	EUR	56602535	56619608	17073
EUR_49	10000	EUR	60608959	60633643	24684
EUR_49	10000	EUR	66856055	66985885	129830
EUR_49	10000	EUR	67338551	67607566	269015
EUR_49	10000	EUR	71467759	71570198	102439
EUR_49	10000	EUR	72251865	72335196	83331
EUR_49	10000	EUR	79182474	79271383	88909
EUR_49	10000	EUR	80357099	80365770	8671
EUR_49	10000	EUR	81471610	81515940	44330
EUR_49	10000	EUR	81967773	82083585	115812
EUR_49	10000	EUR	82935424	83015744	80320
EUR_49	10000	EUR	83535170	83547669	12499
EUR_49	10000	EUR	85033513	85147241	113728
EUR_49	10000	EUR	85523737	85529026	5289
EUR_49	10000	EUR	91460158	91619607	159449
EUR_49	10000	EUR	91667508	91709808	42300
EUR_49	10000	EUR	94980195	95044432	64237
EUR_49	10000	EUR	95207807	95219891	12084
EUR_49	10000	EUR	99091618	99125781	34163
EUR_49	10000	EUR	99960270	1e+08	39730
EUR_50	10000	EUR	730747	774133	43386
EUR_50	10000	EUR	1767611	1797088	29477
EUR_50	10000	EUR	3441533	3441853	320
EUR_50	10000	EUR	3511197	3590308	79111
EUR_50	10000	EUR	7285890	7286386	496
EUR_50	10000	EUR	8431415	8606780	175365
EUR_50	10000	EUR	8613334	8625598	12264
EUR_50	10000	EUR	19745044	19779206	34162
EUR_50	10000	EUR	20003557	20177391	173834
EUR_50	10000	EUR	31418549	31432364	13815
EUR_50	10000	EUR	32175477	32294968	119491
EUR_50	10000	EUR	32735904	32767766	31862
EUR_50	10000	EUR	33476796	33495347	18551
EUR_50	10000	EUR	33886572	33900204	13632
EUR_50	10000	EUR	35055953	35161248	105295
EUR_50	10000	EUR	36552709	36579439	26730
EUR_50	10000	EUR	36943790	36984241	40451
EUR_50	10000	EUR	45002283	45041077	38794
EUR_50	10000	EUR	49580431	49608883	28452
EUR_50	10000	EUR	56358922	56636994	278072
EUR_50	10000	EUR	69866716	69941210	74494
EUR_50	10000	EUR	70712856	71050814	337958
EUR_50	10000	EUR	71242461	71278921	36460
EUR_50	10000	EUR	80532855	80542475	9620
EUR_50	10000	EUR	81402768	81515940	113172
EUR_50	10000	EUR	82926436	83015744	89308
EUR_50	10000	EUR	83535170	83547669	12499
EUR_50	10000	EUR	91505715	91651395	145680
EUR_50	10000	EUR	91667508	91709808	42300
EUR_50	10000	EUR	93189890	93288388	98498
EUR_50	10000	EUR	93748506	93803230	54724
EUR_50	10000	EUR	95395717	95533801	138084
EUR_50	10000	EUR	420559	538194	117635
EUR_50	10000	EUR	1206118	1206788	670
EUR_50	10000	EUR	1293018	1359421	66403
EUR_50	10000	EUR	2004216	2087490	83274
EUR_50	10000	EUR	2880200	2905256	25056
EUR_50	10000	EUR	3191230	3265817	74587
EUR_50	10000	EUR	3536418	3625436	89018
EUR_50	10000	EUR	7299991	7309906	9915
EUR_50	10000	EUR	7423463	7444390	20927
EUR_50	10000	EUR	8579030	8586444	7414
EUR_50	10000	EUR	8836060	8841421	5361
EUR_50	10000	EUR	9096920	9101753	4833
EUR_50	10000	EUR	10749153	10864287	115134
EUR_50	10000	EUR	16592249	16616711	24462
EUR_50	10000	EUR	19623556	19668854	45298
EUR_50	10000	EUR	32175477	32179918	4441
EUR_50	10000	EUR	34704553	34725043	20490
EUR_50	10000	EUR	35055953	35214677	158724
EUR_50	10000	EUR	36668091	36675113	7022
EUR_50	10000	EUR	44879087	44887552	8465
EUR_50	10000	EUR	44989994	45007205	17211
EUR_50	10000	EUR	45166868	45194828	27960
EUR_50	10000	EUR	48075025	48163869	88844
EUR_50	10000	EUR	52370423	52374049	3626
EUR_50	10000	EUR	52727511	52731110	3599
EUR_50	10000	EUR	56652533	56698672	46139
EUR_50	10000	EUR	59101641	59110988	9347
EUR_50	10000	EUR	59468985	59536453	67468
EUR_50	10000	EUR	66770704	66818294	47590
EUR_50	10000	EUR	69959691	70010468	50777
EUR_50	10000	EUR	79182474	79271383	88909
EUR_50	10000	EUR	80357099	80358802	1703
EUR_50	10000	EUR	91382694	91397246	14552
EUR_50	10000	EUR	93402423	93420034	17611
EUR_50	10000	EUR	98535023	98536519	1496
EUR_51	0	EUR	1092856	1106052	13196
EUR_51	0	EUR	1370605	1381856	11251
EUR_51	0	EUR	1556187	1697654	141467
EUR_51	0	EUR	3340703	3423567	82864
EUR_51	0	EUR	6852588	6872205	19617
EUR_51	0	EUR	6994360	7157330	162970
EUR_51	0	EUR	16370454	16371547	1093
EUR_51	0	EUR	19091921	19139790	47869
EUR_51	0	EUR	19204124	19290144	86020
EUR_51	0	EUR	21093473	21101019	7546
EUR_51	0	EUR	31426914	31460819	33905
EUR_51	0	EUR	32175477	32179369	3892
EUR_51	0	EUR	32870126	32897096	26970
EUR_51	0	EUR	34178918	34199650	20732
EUR_51	0	EUR	35093561	35097333	3772
EUR_51	0	EUR	36456218	36465603	9385
EUR_51	0	EUR	36685026	36799457	114431
EUR_51	0	EUR	41302914	41349452	46538
EUR_51	0	EUR	42378979	42419138	40159
EUR_51	0	EUR	45721329	45762645	41316
EUR_51	0	EUR	52534493	52540095	5602
EUR_51	0	EUR	56337270	56422085	84815
EUR_51	0	EUR	56602535	56667953	65418
EUR_51	0	EUR	56954709	56975216	20507
EUR_51	0	EUR	57988115	58068801	80686
EUR_51	0	EUR	58884785	58943349	58564
EUR_51	0	EUR	59430786	59434986	4200
EUR_51	0	EUR	66856055	66960977	104922
EUR_51	0	EUR	67216325	67340350	124025
EUR_51	0	EUR	78734876	78747316	12440
EUR_51	0	EUR	81967773	81982595	14822
EUR_51	0	EUR	82576187	82586994	10807
EUR_51	0	EUR	91606400	91693315	86915
EUR_51	0	EUR	91695703	91696746	1043
EUR_51	0	EUR	94980195	95082994	102799
EUR_51	0	EUR	99960270	1e+08	39730
EUR_51	0	EUR	547015	609014	61999
EUR_51	0	EUR	3136195	3286475	150280
EUR_51	0	EUR	3396867	3451603	54736
EUR_51	0	EUR	3645899	3706513	60614
EUR_51	0	EUR	7285890	7286386	496
EUR_51	0	EUR	14586202	14616963	30761
EUR_51	0	EUR	15268570	15273162	4592
EUR_51	0	EUR	16279447	16303094	23647
EUR_51	0	EUR	17875815	17912880	37065
EUR_51	0	EUR	19067739	19187354	119615
EUR_51	0	EUR	19207099	19345535	138436
EUR_51	0	EUR	19532548	19535611	3063
EUR_51	0	EUR	19687582	19760571	72989
EUR_51	0	EUR	21093473	21210826	117353
EUR_51	0	EUR	31356895	31414107	57212
EUR_51	0	EUR	32601531	32667002	65471
EUR_51	0	EUR	35115895	35203216	87321
EUR_51	0	EUR	41284698	41336191	51493
EUR_51	0	EUR	42408822	42442844	34022
EUR_51	0	EUR	48396498	48397442	944
EUR_51	0	EUR	48654788	48782792	128004
EUR_51	0	EUR	48885950	48891674	5724
EUR_51	0	EUR	49686447	49698362	11915
EUR_51	0	EUR	50402581	50413755	11174
EUR_51	0	EUR	52533712	52540095	6383
EUR_51	0	EUR	56422019	56455214	33195
EUR_51	0	EUR	56505854	56692033	186179
EUR_51	0	EUR	57988115	58068801	80686
EUR_51	0	EUR	66185633	66262090	76457
EUR_51	0	EUR	66770704	66818294	47590
EUR_51	0	EUR	69866716	69922357	55641
EUR_51	0	EUR	70508217	70509937	1720
EUR_51	0	EUR	71258872	71263561	4689
EUR_51	0	EUR	79182474	79271383	88909
EUR_51	0	EUR	79385783	79532633	146850
EUR_51	0	EUR	80357099	80365770	8671
EUR_51	0	EUR	80575631	80582023	6392
EUR_51	0	EUR	81967773	81984844	17071
EUR_51	0	EUR	82436220	82446826	10606
EUR_51	0	EUR	89967022	89968908	1886
EUR_51	0	EUR	91375278	91618360	243082
EUR_51	0	EUR	91882426	91908013	25587
EUR_51	0	EUR	93663451	93782427	118976
EUR_51	0	EUR	94980195	95082994	102799
EUR_51	0	EUR	95399383	95471081	71698
EUR_51	0	EUR	95479126	95496972	17846
EUR_51	0	EUR	98789285	98816945	27660
EUR_51	0	EUR	99099431	99114971	15540
EUR_52	0	EUR	420559	538194	117635
EUR_52	0	EUR	1343969	1359421	15452
EUR_52	0	EUR	2023093	2064315	41222
EUR_52	0	EUR	2865264	2905256	39992
EUR_52	0	EUR	3486375	3519762	33387
EUR_52	0	EUR	3757073	3767957	10884
EUR_52	0	EUR	7285890	7286386	496
EUR_52	0	EUR	9092026	9101753	9727
EUR_52	0	EUR	14998007	15083355	85348
EUR_52	0	EUR	17641535	17657278	15743
EUR_52	0	EUR	18999038	19041492	42454
EUR_52	0	EUR	19124526	19139790	15264
EUR_52	0	EUR	19204124	19290144	86020
EUR_52	0	EUR	31426914	31474283	47369
EUR_52	0	EUR	32679415	32767766	88351
EUR_52	0	EUR	32957231	32961396	4165
EUR_52	0	EUR	33652710	33654397	1687
EUR_52	0	EUR	36552709	36579439	26730
EUR_52	0	EUR	36644731	36797963	153232
EUR_52	0	EUR	41178130	41271125	92995
EUR_52	0	EUR	41341058	41349452	8394
EUR_52	0	EUR	43422627	43456607	33980
EUR_52	0	EUR	48846263	48878213	31950
EUR_52	0	EUR	52354087	52373324	19237
EUR_52	0	EUR	56358922	56393300	34378
EUR_52	0	EUR	56564954	56570099	5145
EUR_52	0	EUR	59465551	59536453	70902
EUR_52	0	EUR	60039225	60042325	3100
EUR_52	0	EUR	60596138	60633643	37505
EUR_52	0	EUR	70508217	70622534	114317
EUR_52	0	EUR	79182474	79268825	86351
EUR_52	0	EUR	81412372	81447297	34925
EUR_52	0	EUR	82839573	82850412	10839
EUR_52	0	EUR	82934867	83015744	80877
EUR_52	0	EUR	91375278	91619607	244329
EUR_52	0	EUR	91667508	91709808	42300
EUR_52	0	EUR	93643279	93660792	17513
EUR_52	0	EUR	95022438	95027446	5008
EUR_52	0	EUR	95399383	95481721	82338
EUR_52	0	EUR	96515348	96675925	160577
EUR_52	0	EUR	547015	609014	61999
EUR_52	0	EUR	1450448	1600893	150445
EUR_52	0	EUR	3123264	3135851	12587
EUR_52	0	EUR	3140856	3286475	145619
EUR_52	0	EUR	3396867	3451603	54736
EUR_52	0	EUR	3570215	3571572	1357
EUR_52	0	EUR	3667391	3706513	39122
EUR_52	0	EUR	3721616	3822465	100849
EUR_52	0	EUR	4316460	4326054	9594
EUR_52	0	EUR	6852588	6927970	75382
EUR_52	0	EUR	8647888	8722903	75015
EUR_52	0	EUR	8727732	8821493	93761
EUR_52	0	EUR	10747602	10772273	24671
EUR_52	0	EUR	16353065	16362325	9260
EUR_52	0	EUR	17641535	17757633	116098
EUR_52	0	EUR	17875815	17927018	51203
EUR_52	0	EUR	19204124	19290144	86020
EUR_52	0	EUR	19630585	19657947	27362
EUR_52	0	EUR	20003557	20055312	51755
EUR_52	0	EUR	32957729	32971366	13637
EUR_52	0	EUR	41284698	41336191	51493
EUR_52	0	EUR	44879087	45000269	121182
EUR_52	0	EUR	47967792	48023849	56057
EUR_52	0	EUR	48846263	48891674	45411
EUR_52	0	EUR	50402581	50517916	115335
EUR_52	0	EUR	55535416	55625946	90530
EUR_52	0	EUR	56652533	56698672	46139
EUR_52	0	EUR	60039225	60127183	87958
EUR_52	0	EUR	60302138	60311204	9066
EUR_52	0	EUR	66499094	66551382	52288
EUR_52	0	EUR	67166972	67204343	37371
EUR_52	0	EUR	89570744	89600117	29373
EUR_52	0	EUR	90682413	90694613	12200
EUR_52	0	EUR	93158921	93182825	23904
EUR_52	0	EUR	93220569	93224014	3445
EUR_52	0	EUR	95026341	95082994	56653
EUR_52	0	EUR	95450713	95533801	83088
EUR_52	0	EUR	99091618	99127820	36202
EUR_53	0	EUR	573224	609014	35790
EUR_53	0	EUR	1597354	1697654	100300
EUR_53	0	EUR	2976688	2997419	20731
EUR_53	0	EUR	3012618	3423567	410949
EUR_53	0	EUR	7027399	7157330	129931
EUR_53	0	EUR	8938770	8971330	32560
EUR_53	0	EUR	16255343	16255638	295
EUR_53	0	EUR	16272182	16303094	30912
EUR_53	0	EUR	18588806	18660573	71767
EUR_53	0	EUR	19028853	19122892	94039
EUR_53	0	EUR	19191008	19207072	16064
EUR_53	0	EUR	19281937	19345535	63598
EUR_53	0	EUR	19532548	19535611	3063
EUR_53	0	EUR	19687582	19760571	72989
EUR_53	0	EUR	32175477	32309203	133726
EUR_53	0	EUR	32546422	32549426	3004
EUR_53	0	EUR	33554925	33743699	188774
EUR_53	0	EUR	43392913	43484312	91399
EUR_53	0	EUR	43530541	43543865	13324
EUR_53	0	EUR	48785543	48891674	106131
EUR_53	0	EUR	56609674	56698258	88584
EUR_53	0	EUR	66185633	66199431	13798
EUR_53	0	EUR	66910347	66968165	57818
EUR_53	0	EUR	71143812	71158531	14719
EUR_53	0	EUR	79182474	79271383	88909
EUR_53	0	EUR	80532855	80552263	19408
EUR_53	0	EUR	82935424	83015744	80320
EUR_53	0	EUR	84225779	84252060	26281
EUR_53	0	EUR	85006299	85024076	17777
EUR_53	0	EUR	89558335	89600117	41782
EUR_53	0	EUR	90682413	90694613	12200
EUR_53	0	EUR	91505168	91619607	114439
EUR_53	0	EUR	91667508	91709808	42300
EUR_53	0	EUR	93220569	93224014	3445
EUR_53	0	EUR	95022438	95027446	5008
EUR_53	0	EUR	98789285	98816945	27660
EUR_53	0	EUR	99091618	99154807	63189
EUR_53	0	EUR	99212268	99219956	7688
EUR_53	0	EUR	1187573	1193517	5944
EUR_53	0	EUR	3329529	3351992	22463
EUR_53	0	EUR	3396867	3451603	54736
EUR_53	0	EUR	4359650	4404229	44579
EUR_53	0	EUR	7247034	7352828	105794
EUR_53	0	EUR	7364568	7395550	30982
EUR_53	0	EUR	7423463	7444390	20927
EUR_53	0	EUR	10692087	10697984	5897
EUR_53	0	EUR	15139564	15166529	26965
EUR_53	0	EUR	15268570	15356892	88322
EUR_53	0	EUR	16277605	16324947	47342
EUR_53	0	EUR	19236260	19246110	9850
EUR_53	0	EUR	19739034	19760571	21537
EUR_53	0	EUR	20003557	20055312	51755
EUR_53	0	EUR	21093473	21220760	127287
EUR_53	0	EUR	30016686	30027821	11135
EUR_53	0	EUR	32175477	32210551	35074
EUR_53	0	EUR	32679415	32767766	88351
EUR_53	0	EUR	32957231	32961396	4165
EUR_53	0	EUR	33554925	33743699	188774
EUR_53	0	EUR	36805638	36819785	14147
EUR_53	0	EUR	41284698	41336191	51493
EUR_53	0	EUR	43482358	43495024	12666
EUR_53	0	EUR	43506939	43543865	36926
EUR_53	0	EUR	44988065	45056500	68435
EUR_53	0	EUR	45695997	45712193	16196
EUR_53	0	EUR	47967792	48023849	56057
EUR_53	0	EUR	49686843	49698362	11519
EUR_53	0	EUR	52511931	52546494	34563
EUR_53	0	EUR	56652533	56698672	46139
EUR_53	0	EUR	66215742	66316543	100801
EUR_53	0	EUR	67159723	67187666	27943
EUR_53	0	EUR	67276558	67408005	131447
EUR_53	0	EUR	71148065	71263561	115496
EUR_53	0	EUR	79182474	79271383	88909
EUR_53	0	EUR	85436539	85462224	25685
EUR_53	0	EUR	89558335	89600117	41782
EUR_53	0	EUR	89942056	89968908	26852
EUR_53	0	EUR	91346960	91452363	105403
EUR_53	0	EUR	91695703	91696746	1043
EUR_53	0	EUR	93186259	93219993	33734
EUR_53	0	EUR	96509826	96637247	127421
EUR_53	0	EUR	99091618	99127820	36202
EUR_54	0	EUR	1382908	1465074	82166
EUR_54	0	EUR	3153316	3181804	28488
EUR_54	0	EUR	3684886	3706513	21627
EUR_54	0	EUR	6889715	7000601	110886
EUR_54	0	EUR	8431415	8493985	62570
EUR_54	0	EUR	8830982	8872441	41459
EUR_54	0	EUR	10760924	10784726	23802
EUR_54	0	EUR	10812468	10830251	17783
EUR_54	0	EUR	14635880	14714249	78369
EUR_54	0	EUR	18651919	18660573	8654
EUR_54	0	EUR	19091921	19139790	47869
EUR_54	0	EUR	19741384	19760571	19187
EUR_54	0	EUR	31426914	31460819	33905
EUR_54	0	EUR	32249701	32274754	25053
EUR_54	0	EUR	32546422	32549426	3004
EUR_54	0	EUR	32680460	32767766	87306
EUR_54	0	EUR	33886572	33900204	13632
EUR_54	0	EUR	35088103	35212715	124612
EUR_54	0	EUR	36626060	36801917	175857
EUR_54	0	EUR	43417730	43484312	66582
EUR_54	0	EUR	44988065	45056500	68435
EUR_54	0	EUR	48654788	48782792	128004
EUR_54	0	EUR	48885950	48891674	5724
EUR_54	0	EUR	50402581	50427423	24842
EUR_54	0	EUR	56358922	56393300	34378
EUR_54	0	EUR	56602535	56667953	65418
EUR_54	0	EUR	57988115	58068801	80686
EUR_54	0	EUR	66967487	66994117	26630
EUR_54	0	EUR	67159723	67187666	27943
EUR_54	0	EUR	67276558	67376666	100108
EUR_54	0	EUR	70004307	70009272	4965
EUR_54	0	EUR	70791569	70881782	90213
EUR_54	0	EUR	71147984	71151709	3725
EUR_54	0	EUR	78734876	78747316	12440
EUR_54	0	EUR	81471610	81515940	44330
EUR_54	0	EUR	82064858	82087552	22694
EUR_54	0	EUR	82633504	82716576	83072
EUR_54	0	EUR	91375278	91619607	244329
EUR_54	0	EUR	91667508	91709808	42300
EUR_54	0	EUR	95001847	95082994	81147
EUR_54	0	EUR	208647	246551	37904
EUR_54	0	EUR	1410548	1552203	141655
EUR_54	0	EUR	1753052	1779619	26567
EUR_54	0	EUR	1936741	1943779	7038
EUR_54	0	EUR	3304989	3351992	47003
EUR_54	0	EUR	3370889	3375407	4518
EUR_54	0	EUR	6994360	7128121	133761
EUR_54	0	EUR	7285890	7301300	15410
EUR_54	0	EUR	7484795	7614045	129250
EUR_54	0	EUR	8431415	8462772	31357
EUR_54	0	EUR	8846191	8957562	111371
EUR_54	0	EUR	10625902	10660183	34281
EUR_54	0	EUR	14586202	14590162	3960
EUR_54	0	EUR	15183335	15196543	13208
EUR_54	0	EUR	16370454	16371547	1093
EUR_54	0	EUR	19091921	19139790	47869
EUR_54	0	EUR	19204124	19290144	86020
EUR_54	0	EUR	30016686	30042531	25845
EUR_54	0	EUR	31426914	31460819	33905
EUR_54	0	EUR	32744330	32763079	18749
EUR_54	0	EUR	35055953	35214677	158724
EUR_54	0	EUR	41284698	41336191	51493
EUR_54	0	EUR	43359647	43495024	135377
EUR_54	0	EUR	43506939	43543865	36926
EUR_54	0	EUR	44991814	45007205	15391
EUR_54	0	EUR	45034982	45045358	10376
EUR_54	0	EUR	48654788	48782792	128004
EUR_54	0	EUR	56724373	56728303	3930
EUR_54	0	EUR	58032752	58041411	8659
EUR_54	0	EUR	59397484	59434986	37502
EUR_54	0	EUR	60039225	60103598	64373
EUR_54	0	EUR	60235523	60241966	6443
EUR_54	0	EUR	65485272	65524873	39601
EUR_54	0	EUR	66910347	66960516	50169
EUR_54	0	EUR	67343411	67376666	33255
EUR_54	0	EUR	70004307	70009272	4965
EUR_54	0	EUR	70508217	70756598	248381
EUR_54	0	EUR	79182474	79271383	88909
EUR_54	0	EUR	79529342	79552411	23069
EUR_54	0	EUR	81402768	81414246	11478
EUR_54	0	EUR	81967773	81982595	14822
EUR_54	0	EUR	85322882	85342815	19933
EUR_54	0	EUR	89942056	89945180	3124
EUR_54	0	EUR	91362036	91647536	285500
EUR_54	0	EUR	93217929	93288388	70459
EUR_55	0	EUR	186664	270189	83525
EUR_55	0	EUR	920604	923302	2698
EUR_55	0	EUR	1140343	1149476	9133
EUR_55	0	EUR	1161080	1167690	6610
EUR_55	0	EUR	1187958	1193517	5559
EUR_55	0	EUR	1868080	1906837	38757
EUR_55	0	EUR	2850480	2905256	54776
EUR_55	0	EUR	3279048	3351992	72944
EUR_55	0	EUR	3370889	3375407	4518
EUR_55	0	EUR	3494873	3554025	59152
EUR_55	0	EUR	7100116	7142898	42782
EUR_55	0	EUR	8647888	8722903	75015
EUR_55	0	EUR	8727732	8821493	93761
EUR_55	0	EUR	8873516	8928424	54908
EUR_55	0	EUR	14600033	14668827	68794
EUR_55	0	EUR	16472977	16500698	27721
EUR_55	0	EUR	19664660	19779206	114546
EUR_55	0	EUR	20003557	20080205	76648
EUR_55	0	EUR	24452192	24527742	75550
EUR_55	0	EUR	32725605	32737266	11661
EUR_55	0	EUR	35055953	35214677	158724
EUR_55	0	EUR	36668091	36675113	7022
EUR_55	0	EUR	43261516	43263827	2311
EUR_55	0	EUR	43320030	43407842	87812
EUR_55	0	EUR	43505036	43543865	38829
EUR_55	0	EUR	48846263	48891674	45411
EUR_55	0	EUR	52354087	52373324	19237
EUR_55	0	EUR	53403934	53404500	566
EUR_55	0	EUR	56422019	56455214	33195
EUR_55	0	EUR	56500954	56569797	68843
EUR_55	0	EUR	57912996	57988983	75987
EUR_55	0	EUR	58051662	58068801	17139
EUR_55	0	EUR	59101641	59110988	9347
EUR_55	0	EUR	59535842	59536453	611
EUR_55	0	EUR	60302138	60350832	48694
EUR_55	0	EUR	60655062	60668986	13924
EUR_55	0	EUR	66856055	66914817	58762
EUR_55	0	EUR	79182474	79271383	88909
EUR_55	0	EUR	84225779	84252060	26281
EUR_55	0	EUR	85093352	85145489	52137
EUR_55	0	EUR	89558335	89600117	41782
EUR_55	0	EUR	89758766	89761001	2235
EUR_55	0	EUR	91689593	91709808	20215
EUR_55	0	EUR	94980195	95082994	102799
EUR_55	0	EUR	95450713	95451773	1060
EUR_55	0	EUR	96515348	96599473	84125
EUR_55	0	EUR	98197423	98310034	112611
EUR_55	0	EUR	99091618	99154807	63189
EUR_55	0	EUR	99573515	99639506	65991
EUR_55	0	EUR	420559	538194	117635
EUR_55	0	EUR	1370605	1381856	11251
EUR_55	0	EUR	1556187	1697654	141467
EUR_55	0	EUR	1753052	1779619	26567
EUR_55	0	EUR	3330740	3375407	44667
EUR_55	0	EUR	3684886	3706513	21627
EUR_55	0	EUR	7311035	7444390	133355
EUR_55	0	EUR	8761529	8988757	227228
EUR_55	0	EUR	15061174	15085934	24760
EUR_55	0	EUR	16370454	16371547	1093
EUR_55	0	EUR	19191008	19345535	154527
EUR_55	0	EUR	19521714	19569969	48255
EUR_55	0	EUR	19640097	19657947	17850
EUR_55	0	EUR	19724264	19768805	44541
EUR_55	0	EUR	20003557	20091402	87845
EUR_55	0	EUR	21160155	21220760	60605
EUR_55	0	EUR	27472162	27501911	29749
EUR_55	0	EUR	41302914	41304096	1182
EUR_55	0	EUR	42984510	43042745	58235
EUR_55	0	EUR	44879087	44887552	8465
EUR_55	0	EUR	47960163	47990229	30066
EUR_55	0	EUR	48654788	48782792	128004
EUR_55	0	EUR	48885950	48891674	5724
EUR_55	0	EUR	52344468	52374049	29581
EUR_55	0	EUR	55535416	55543524	8108
EUR_55	0	EUR	56337270	56422085	84815
EUR_55	0	EUR	56602535	56667953	65418
EUR_55	0	EUR	56954709	56975216	20507
EUR_55	0	EUR	60089257	60192988	103731
EUR_55	0	EUR	60302138	60448388	146250
EUR_55	0	EUR	60608959	60633643	24684
EUR_55	0	EUR	66900632	66935894	35262
EUR_55	0	EUR	70004307	70009272	4965
EUR_55	0	EUR	71147984	71263561	115577
EUR_55	0	EUR	79176952	79183236	6284
EUR_55	0	EUR	79326193	79552411	226218
EUR_55	0	EUR	80532855	80542475	9620
EUR_55	0	EUR	85322882	85342815	19933
EUR_55	0	EUR	89589448	89600117	10669
EUR_55	0	EUR	90682413	90694613	12200
EUR_55	0	EUR	93220569	93224014	3445
EUR_55	0	EUR	95026341	95082994	56653
EUR_56	0	EUR	547015	609014	61999
EUR_56	0	EUR	1450448	1600893	150445
EUR_56	0	EUR	3027159	3314876	287717
EUR_56	0	EUR	3330740	3423567	92827
EUR_56	0	EUR	3570215	3571572	1357
EUR_56	0	EUR	3684886	3706513	21627
EUR_56	0	EUR	3801898	3822465	20567
EUR_56	0	EUR	6852588	6872205	19617
EUR_56	0	EUR	7311035	7444390	133355
EUR_56	0	EUR	8967321	9010147	42826
EUR_56	0	EUR	16255343	16255638	295
EUR_56	0	EUR	16272182	16303094	30912
EUR_56	0	EUR	17641535	17771299	129764
EUR_56	0	EUR	19191008	19287853	96845
EUR_56	0	EUR	19433185	19436972	3787
EUR_56	0	EUR	19532548	19535611	3063
EUR_56	0	EUR	19703800	19760571	56771
EUR_56	0	EUR	20003557	20091402	87845
EUR_56	0	EUR	31650111	31716492	66381
EUR_56	0	EUR	35055953	35214677	158724
EUR_56	0	EUR	41525752	41593912	68160
EUR_56	0	EUR	43469761	43484312	14551
EUR_56	0	EUR	48846263	48891674	45411
EUR_56	0	EUR	50402581	50432831	30250
EUR_56	0	EUR	56337270	56422085	84815
EUR_56	0	EUR	56602535	56627535	25000
EUR_56	0	EUR	56966549	57009137	42588
EUR_56	0	EUR	60253489	60311705	58216
EUR_56	0	EUR	60449548	60465746	16198
EUR_56	0	EUR	61392863	61422685	29822
EUR_56	0	EUR	66207357	66262090	54733
EUR_56	0	EUR	66910347	66911181	834
EUR_56	0	EUR	66921545	66968165	46620
EUR_56	0	EUR	67166972	67204343	37371
EUR_56	0	EUR	82238363	82245156	6793
EUR_56	0	EUR	82436220	82527279	91059
EUR_56	0	EUR	82538351	82572376	34025
EUR_56	0	EUR	82730154	82732667	2513
EUR_56	0	EUR	85436539	85462224	25685
EUR_56	0	EUR	93015373	93025237	9864
EUR_56	0	EUR	95179435	95220633	41198
EUR_56	0	EUR	208647	271559	62912
EUR_56	0	EUR	1140343	1149476	9133
EUR_56	0	EUR	1161080	1167690	6610
EUR_56	0	EUR	1187958	1193517	5559
EUR_56	0	EUR	1370605	1381856	11251
EUR_56	0	EUR	1556187	1697654	141467
EUR_56	0	EUR	1753052	1779619	26567
EUR_56	0	EUR	2197269	2223299	26030
EUR_56	0	EUR	3645899	3706513	60614
EUR_56	0	EUR	3721616	3822465	100849
EUR_56	0	EUR	7027399	7058275	30876
EUR_56	0	EUR	7299991	7321362	21371
EUR_56	0	EUR	14586202	14616963	30761
EUR_56	0	EUR	17752821	17771299	18478
EUR_56	0	EUR	19028853	19122892	94039
EUR_56	0	EUR	19191008	19207072	16064
EUR_56	0	EUR	20179905	20196095	16190
EUR_56	0	EUR	23077256	23091932	14676
EUR_56	0	EUR	30016686	30042531	25845
EUR_56	0	EUR	35055953	35214677	158724
EUR_56	0	EUR	41284698	41336191	51493
EUR_56	0	EUR	41560941	41602958	42017
EUR_56	0	EUR	43261516	43263827	2311
EUR_56	0	EUR	43320030	43407842	87812
EUR_56	0	EUR	43505036	43543865	38829
EUR_56	0	EUR	45032675	45067243	34568
EUR_56	0	EUR	45695997	45762645	66648
EUR_56	0	EUR	49686447	49698362	11915
EUR_56	0	EUR	50473723	50517916	44193
EUR_56	0	EUR	52344468	52374049	29581
EUR_56	0	EUR	53429545	53464647	35102
EUR_56	0	EUR	56337270	56349424	12154
EUR_56	0	EUR	58032752	58041411	8659
EUR_56	0	EUR	58884785	58943349	58564
EUR_56	0	EUR	60039225	60097132	57907
EUR_56	0	EUR	60596138	60633643	37505
EUR_56	0	EUR	65485272	65615238	129966
EUR_56	0	EUR	66856055	66960977	104922
EUR_56	0	EUR	70712856	70909181	196325
EUR_56	0	EUR	71242461	71316162	73701
EUR_56	0	EUR	71467759	71561887	94128
EUR_56	0	EUR	78953619	79244810	291191
EUR_56	0	EUR	79326193	79369874	43681
EUR_56	0	EUR	79474336	79552411	78075
EUR_56	0	EUR	81433691	81457708	24017
EUR_56	0	EUR	84225779	84252060	26281
EUR_56	0	EUR	91333470	91696322	362852
EUR_56	0	EUR	93159470	93164021	4551
EUR_56	0	EUR	93692525	93701268	8743
EUR_56	0	EUR	99091618	99154807	63189
EUR_57	0	EUR	920604	923302	2698
EUR_57	0	EUR	1323879	1381210	57331
EUR_57	0	EUR	1773640	1837067	63427
EUR_57	0	EUR	2880200	2905256	25056
EUR_57	0	EUR	3289981	3352860	62879
EUR_57	0	EUR	3396867	3440079	43212
EUR_57	0	EUR	3536418	3625436	89018
EUR_57	0	EUR	6889715	7000601	110886
EUR_57	0	EUR	7299991	7309906	9915
EUR_57	0	EUR	8830982	8872441	41459
EUR_57	0	EUR	9863180	9949611	86431
EUR_57	0	EUR	10623618	10660183	36565
EUR_57	0	EUR	15061174	15085934	24760
EUR_57	0	EUR	17875815	17921585	45770
EUR_57	0	EUR	19191008	19211100	20092
EUR_57	0	EUR	31426914	31476899	49985
EUR_57	0	EUR	33554925	33743699	188774
EUR_57	0	EUR	34921166	35011423	90257
EUR_57	0	EUR	35380728	35390337	9609
EUR_57	0	EUR	42408822	42425477	16655
EUR_57	0	EUR	43339196	43362153	22957
EUR_57	0	EUR	44991814	45007205	15391
EUR_57	0	EUR	45034982	45045358	10376
EUR_57	0	EUR	47967792	48023849	56057
EUR_57	0	EUR	49686447	49698362	11915
EUR_57	0	EUR	56602535	56667953	65418
EUR_57	0	EUR	58884785	58943349	58564
EUR_57	0	EUR	59511674	59521946	10272
EUR_57	0	EUR	60608959	60633643	24684
EUR_57	0	EUR	66910347	66956140	45793
EUR_57	0	EUR	66967487	67089545	122058
EUR_57	0	EUR	67166972	67204343	37371
EUR_57	0	EUR	70508217	70509937	1720
EUR_57	0	EUR	82070795	82083585	12790
EUR_57	0	EUR	89558335	89600117	41782
EUR_57	0	EUR	91397920	91521171	123251
EUR_57	0	EUR	95065283	95286873	221590
EUR_57	0	EUR	95461014	95462095	1081
EUR_57	0	EUR	97383224	97392053	8829
EUR_57	0	EUR	208647	238464	29817
EUR_57	0	EUR	412113	516507	104394
EUR_57	0	EUR	700406	736181	35775
EUR_57	0	EUR	982163	1010148	27985
EUR_57	0	EUR	1171467	1240732	69265
EUR_57	0	EUR	1658602	1697654	39052
EUR_57	0	EUR	1767611	1797088	29477
EUR_57	0	EUR	2976688	2977418	730
EUR_57	0	EUR	3123264	3135851	12587
EUR_57	0	EUR	3299438	3352860	53422
EUR_57	0	EUR	3396867	3554025	157158
EUR_57	0	EUR	3684886	3685368	482
EUR_57	0	EUR	6950834	6996264	45430
EUR_57	0	EUR	7285890	7286386	496
EUR_57	0	EUR	8689567	8722903	33336
EUR_57	0	EUR	8727732	8821493	93761
EUR_57	0	EUR	10690096	10697984	7888
EUR_57	0	EUR	19072394	19187354	114960
EUR_57	0	EUR	19207099	19345535	138436
EUR_57	0	EUR	19630585	19668854	38269
EUR_57	0	EUR	27472162	27501911	29749
EUR_57	0	EUR	30016686	30027821	11135
EUR_57	0	EUR	31426914	31460819	33905
EUR_57	0	EUR	32175477	32179369	3892
EUR_57	0	EUR	33554925	33720138	165213
EUR_57	0	EUR	35380728	35390337	9609
EUR_57	0	EUR	36685026	36692328	7302
EUR_57	0	EUR	42919420	43042745	123325
EUR_57	0	EUR	47923463	47982456	58993
EUR_57	0	EUR	48654788	48782792	128004
EUR_57	0	EUR	48885950	48891674	5724
EUR_57	0	EUR	56652533	56698672	46139
EUR_57	0	EUR	56954709	57084783	130074
EUR_57	0	EUR	58032752	58041411	8659
EUR_57	0	EUR	59397484	59434986	37502
EUR_57	0	EUR	60039225	60103598	64373
EUR_57	0	EUR	60235523	60266502	30979
EUR_57	0	EUR	66910347	66911181	834
EUR_57	0	EUR	67083948	67090564	6616
EUR_57	0	EUR	70004307	70009272	4965
EUR_57	0	EUR	78826314	78841506	15192
EUR_57	0	EUR	79182474	79271383	88909
EUR_57	0	EUR	79385783	79455230	69447
EUR_57	0	EUR	81412372	81447297	34925
EUR_57	0	EUR	85029423	85147241	117818
EUR_57	0	EUR	89558335	89600117	41782
EUR_57	0	EUR	94980195	95277967	297772
EUR_57	0	EUR	95461014	95531429	70415
EUR_57	0	EUR	96577335	96742144	164809
EUR_57	0	EUR	99896793	99959275	62482
EUR_58	0	EUR	208647	246551	37904
EUR_58	0	EUR	455958	538194	82236
EUR_58	0	EUR	920604	923302	2698
EUR_58	0	EUR	1017843	1079878	62035
EUR_58	0	EUR	1081594	1111580	29986
EUR_58	0	EUR	1370605	1381856	11251
EUR_58	0	EUR	1556187	1697654	141467
EUR_58	0	EUR	2863855	2905256	41401
EUR_58	0	EUR	3109569	3419673	310104
EUR_58	0	EUR	3570942	3771552	200610
EUR_58	0	EUR	10029655	10047941	18286
EUR_58	0	EUR	10668862	10693831	24969
EUR_58	0	EUR	10760924	10791123	30199
EUR_58	0	EUR	14600033	14668827	68794
EUR_58	0	EUR	16370454	16371547	1093
EUR_58	0	EUR	17641535	17757633	116098
EUR_58	0	EUR	17875815	17927018	51203
EUR_58	0	EUR	19091921	19139790	47869
EUR_58	0	EUR	19521714	19760571	238857
EUR_58	0	EUR	20117020	20157102	40082
EUR_58	0	EUR	32723461	32767766	44305
EUR_58	0	EUR	32957231	32961396	4165
EUR_58	0	EUR	33554925	33743699	188774
EUR_58	0	EUR	42422028	42468677	46649
EUR_58	0	EUR	44879087	45000269	121182
EUR_58	0	EUR	48885950	48891674	5724
EUR_58	0	EUR	52538773	52546494	7721
EUR_58	0	EUR	56593963	56667953	73990
EUR_58	0	EUR	57712713	57738366	25653
EUR_58	0	EUR	57832440	57853670	21230
EUR_58	0	EUR	60235523	60266502	30979
EUR_58	0	EUR	66917291	66956140	38849
EUR_58	0	EUR	66967487	67024731	57244
EUR_58	0	EUR	67530921	67541344	10423
EUR_58	0	EUR	79182474	79271383	88909
EUR_58	0	EUR	82730154	82732667	2513
EUR_58	0	EUR	89942056	89968908	26852
EUR_58	0	EUR	91333470	91399222	65752
EUR_58	0	EUR	93120987	93123325	2338
EUR_58	0	EUR	93162614	93164021	1407
EUR_58	0	EUR	99660485	99681905	21420
EUR_58	0	EUR	991447	1198247	206800
EUR_58	0	EUR	1323879	1387753	63874
EUR_58	0	EUR	1773640	1837067	63427
EUR_58	0	EUR	1895950	1922350	26400
EUR_58	0	EUR	2282711	2302192	19481
EUR_58	0	EUR	2850480	2905256	54776
EUR_58	0	EUR	3027159	3351992	324833
EUR_58	0	EUR	3729376	3767957	38581
EUR_58	0	EUR	6853865	6855253	1388
EUR_58	0	EUR	6856181	6865726	9545
EUR_58	0	EUR	8431415	8493985	62570
EUR_58	0	EUR	15268570	15356892	88322
EUR_58	0	EUR	19091921	19139790	47869
EUR_58	0	EUR	19152858	19187354	34496
EUR_58	0	EUR	19207099	19345535	138436
EUR_58	0	EUR	19532548	19535611	3063
EUR_58	0	EUR	19687582	19760571	72989
EUR_58	0	EUR	21346331	21351752	5421
EUR_58	0	EUR	30016686	30042531	25845
EUR_58	0	EUR	32255013	32274754	19741
EUR_58	0	EUR	32735904	32767766	31862
EUR_58	0	EUR	33886572	33900204	13632
EUR_58	0	EUR	36456218	36579439	123221
EUR_58	0	EUR	41302914	41349452	46538
EUR_58	0	EUR	41597636	41613718	16082
EUR_58	0	EUR	43261516	43263827	2311
EUR_58	0	EUR	43320030	43407842	87812
EUR_58	0	EUR	43505036	43543865	38829
EUR_58	0	EUR	44988065	45067243	79178
EUR_58	0	EUR	48742096	48782792	40696
EUR_58	0	EUR	49686447	49698362	11915
EUR_58	0	EUR	52538773	52546494	7721
EUR_58	0	EUR	56358922	56486749	127827
EUR_58	0	EUR	56994891	57009137	14246
EUR_58	0	EUR	60548697	60633643	84946
EUR_58	0	EUR	66856055	66914817	58762
EUR_58	0	EUR	66940244	66960977	20733
EUR_58	0	EUR	78826314	78841506	15192
EUR_58	0	EUR	79238306	79271383	33077
EUR_58	0	EUR	79451135	79452034	899
EUR_58	0	EUR	80357099	80358802	1703
EUR_58	0	EUR	81412372	81473563	61191
EUR_58	0	EUR	81967773	81984844	17071
EUR_58	0	EUR	83535170	83547669	12499
EUR_58	0	EUR	85322882	85342815	19933
EUR_58	0	EUR	85424306	85495860	71554
EUR_58	0	EUR	89942056	89968908	26852
EUR_58	0	EUR	91342852	91444514	101662
EUR_58	0	EUR	91692476	91694947	2471
EUR_58	0	EUR	92354903	92385296	30393
EUR_58	0	EUR	95399383	95426293	26910
EUR_58	0	EUR	99097257	99157935	60678
EUR_59	0	EUR	412113	538194	126081
EUR_59	0	EUR	920604	923302	2698
EUR_59	0	EUR	1343969	1359421	15452
EUR_59	0	EUR	2023093	2064315	41222
EUR_59	0	EUR	3034147	3253053	218906
EUR_59	0	EUR	3330740	3423567	92827
EUR_59	0	EUR	3775859	3822465	46606
EUR_59	0	EUR	7423463	7444390	20927
EUR_59	0	EUR	8656056	8741568	85512
EUR_59	0	EUR	14586202	14616963	30761
EUR_59	0	EUR	16477443	16485397	7954
EUR_59	0	EUR	19152884	19202023	49139
EUR_59	0	EUR	19739034	19760571	21537
EUR_59	0	EUR	20179905	20196095	16190
EUR_59	0	EUR	21093473	21129185	35712
EUR_59	0	EUR	21160155	21220760	60605
EUR_59	0	EUR	32679415	32767766	88351
EUR_59	0	EUR	32957231	32961396	4165
EUR_59	0	EUR	36474197	36519208	45011
EUR_59	0	EUR	36626060	36628183	2123
EUR_59	0	EUR	41284698	41336191	51493
EUR_59	0	EUR	43261516	43263827	2311
EUR_59	0	EUR	43320030	43407842	87812
EUR_59	0	EUR	43505036	43543865	38829
EUR_59	0	EUR	48358044	48367375	9331
EUR_59	0	EUR	48654788	48782792	128004
EUR_59	0	EUR	48885950	48891674	5724
EUR_59	0	EUR	50402581	50432831	30250
EUR_59	0	EUR	51232009	51236613	4604
EUR_59	0	EUR	56472068	56570099	98031
EUR_59	0	EUR	60596138	60633643	37505
EUR_59	0	EUR	65485272	65615238	129966
EUR_59	0	EUR	66856055	66960977	104922
EUR_59	0	EUR	67081499	67089545	8046
EUR_59	0	EUR	79189815	79271383	81568
EUR_59	0	EUR	79400232	79415110	14878
EUR_59	0	EUR	80532855	80542475	9620
EUR_59	0	EUR	81404893	81515940	111047
EUR_59	0	EUR	82934867	83015744	80877
EUR_59	0	EUR	85006299	85020979	14680
EUR_59	0	EUR	85427054	85462224	35170
EUR_59	0	EUR	87935133	87967747	32614
EUR_59	0	EUR	89558335	89600117	41782
EUR_59	0	EUR	89942056	89947581	5525
EUR_59	0	EUR	91574831	91685112	110281
EUR_59	0	EUR	91685512	91709808	24296
EUR_59	0	EUR	93186259	93219993	33734
EUR_59	0	EUR	95399383	95426293	26910
EUR_59	0	EUR	96515348	96629989	114641
EUR_59	0	EUR	99540802	99639506	98704
EUR_59	0	EUR	208647	374642	165995
EUR_59	0	EUR	412113	538194	126081
EUR_59	0	EUR	882302	1088163	205861
EUR_59	0	EUR	1187573	1193517	5944
EUR_59	0	EUR	1339002	1458599	119597
EUR_59	0	EUR	1556187	1632244	76057
EUR_59	0	EUR	2850480	2905256	54776
EUR_59	0	EUR	2979048	3286475	307427
EUR_59	0	EUR	3316499	3351992	35493
EUR_59	0	EUR	3570215	3571572	1357
EUR_59	0	EUR	3667391	3706513	39122
EUR_59	0	EUR	3775859	3822465	46606
EUR_59	0	EUR	8507121	8587341	80220
EUR_59	0	EUR	14908749	14946157	37408
EUR_59	0	EUR	16251298	16255430	4132
EUR_59	0	EUR	17875815	17927018	51203
EUR_59	0	EUR	19191008	19287853	96845
EUR_59	0	EUR	19433185	19436972	3787
EUR_59	0	EUR	19532548	19535611	3063
EUR_59	0	EUR	21114661	21220760	106099
EUR_59	0	EUR	24495328	24545857	50529
EUR_59	0	EUR	30016686	30042531	25845
EUR_59	0	EUR	32751867	32767766	15899
EUR_59	0	EUR	35373338	35390337	16999
EUR_59	0	EUR	36805638	36819785	14147
EUR_59	0	EUR	42408822	42442844	34022
EUR_59	0	EUR	44916483	44956037	39554
EUR_59	0	EUR	48358044	48367375	9331
EUR_59	0	EUR	51232009	51249792	17783
EUR_59	0	EUR	56358922	56698672	339750
EUR_59	0	EUR	58032752	58041411	8659
EUR_59	0	EUR	58884785	58908267	23482
EUR_59	0	EUR	60596138	60633643	37505
EUR_59	0	EUR	66910347	66956140	45793
EUR_59	0	EUR	66967487	67007373	39886
EUR_59	0	EUR	67373504	67408005	34501
EUR_59	0	EUR	70508217	70509937	1720
EUR_59	0	EUR	70712856	70978704	265848
EUR_59	0	EUR	71467759	71570198	102439
EUR_59	0	EUR	78826314	78841506	15192
EUR_59	0	EUR	83535170	83547669	12499
EUR_59	0	EUR	85380637	85495860	115223
EUR_59	0	EUR	85886159	85917767	31608
EUR_59	0	EUR	95047282	95082994	35712
EUR_59	0	EUR	99896793	99959275	62482
EUR_60	0	EUR	1323879	1331144	7265
EUR_60	0	EUR	7100116	7142898	42782
EUR_60	0	EUR	8830982	8872441	41459
EUR_60	0	EUR	10029655	10047941	18286
EUR_60	0	EUR	19533012	19535611	2599
EUR_60	0	EUR	20003557	20010525	6968
EUR_60	0	EUR	20039089	20089141	50052
EUR_60	0	EUR	21093473	21095853	2380
EUR_60	0	EUR	21180289	21220760	40471
EUR_60	0	EUR	32744330	32763079	18749
EUR_60	0	EUR	33554925	33594811	39886
EUR_60	0	EUR	34155827	34199650	43823
EUR_60	0	EUR	35115895	35203216	87321
EUR_60	0	EUR	36510572	36519208	8636
EUR_60	0	EUR	36626060	36759374	133314
EUR_60	0	EUR	41284698	41336191	51493
EUR_60	0	EUR	42378979	42384712	5733
EUR_60	0	EUR	44988065	45067243	79178
EUR_60	0	EUR	47967792	48023849	56057
EUR_60	0	EUR	48846263	48891674	45411
EUR_60	0	EUR	49686447	49698362	11915
EUR_60	0	EUR	56346050	56428787	82737
EUR_60	0	EUR	56954709	57084783	130074
EUR_60	0	EUR	60039225	60127183	87958
EUR_60	0	EUR	60302138	60350832	48694
EUR_60	0	EUR	66910347	66956380	46033
EUR_60	0	EUR	78813158	78855950	42792
EUR_60	0	EUR	79283689	79366572	82883
EUR_60	0	EUR	81412372	81447297	34925
EUR_60	0	EUR	84225779	84245174	19395
EUR_60	0	EUR	85413688	85441761	28073
EUR_60	0	EUR	91452092	91464223	12131
EUR_60	0	EUR	91512862	91656733	143871
EUR_60	0	EUR	91683657	91696746	13089
EUR_60	0	EUR	93169766	93288388	118622
EUR_60	0	EUR	95450713	95533801	83088
EUR_60	0	EUR	99130962	99154807	23845
EUR_60	0	EUR	99813314	99881673	68359
EUR_60	0	EUR	1483359	1697654	214295
EUR_60	0	EUR	1762492	1779619	17127
EUR_60	0	EUR	2282711	2298513	15802
EUR_60	0	EUR	3340703	3423567	82864
EUR_60	0	EUR	6889715	7000601	110886
EUR_60	0	EUR	7005790	7157330	151540
EUR_60	0	EUR	8431415	8542201	110786
EUR_60	0	EUR	8706783	8722903	16120
EUR_60	0	EUR	8727732	8816918	89186
EUR_60	0	EUR	16370454	16371547	1093
EUR_60	0	EUR	19204124	19345535	141411
EUR_60	0	EUR	19521714	19760571	238857
EUR_60	0	EUR	20003557	20010525	6968
EUR_60	0	EUR	20081484	20157102	75618
EUR_60	0	EUR	20179905	20188958	9053
EUR_60	0	EUR	21114661	21220760	106099
EUR_60	0	EUR	31418549	31442444	23895
EUR_60	0	EUR	32175477	32179918	4441
EUR_60	0	EUR	44988065	45056500	68435
EUR_60	0	EUR	45695997	45712193	16196
EUR_60	0	EUR	48396498	48397442	944
EUR_60	0	EUR	48654788	48782792	128004
EUR_60	0	EUR	48885950	48891674	5724
EUR_60	0	EUR	49686447	49698362	11915
EUR_60	0	EUR	55535416	55625946	90530
EUR_60	0	EUR	56454823	56570099	115276
EUR_60	0	EUR	57988115	58068801	80686
EUR_60	0	EUR	60628049	60633643	5594
EUR_60	0	EUR	66900632	66935894	35262
EUR_60	0	EUR	67166972	67204343	37371
EUR_60	0	EUR	72242581	72335196	92615
EUR_60	0	EUR	79474336	79552411	78075
EUR_60	0	EUR	81471610	81515940	44330
EUR_60	0	EUR	82238363	82245156	6793
EUR_60	0	EUR	85413688	85441761	28073
EUR_60	0	EUR	91333470	91696746	363276
EUR_60	0	EUR	95065283	95286873	221590
EUR_60	0	EUR	95461014	95462095	1081
EUR_60	0	EUR	98197423	98272136	74713
