name	sample_age	pop	node_id	left	right	length
EUR_1	50000	EUR	0	19127220	19527944	400724
EUR_1	50000	EUR	0	50960983	51219943	258960
EUR_1	50000	EUR	0	54542568	55565589	1023021
EUR_1	50000	EUR	0	59782108	59938917	156809
EUR_1	50000	EUR	0	95275454	96092356	816902
EUR_1	50000	EUR	1	482833	887166	404333
EUR_1	50000	EUR	1	9178348	9191865	13517
EUR_1	50000	EUR	1	47755037	48715368	960331
EUR_1	50000	EUR	1	62276039	62914084	638045
EUR_1	50000	EUR	1	84342084	84432573	90489
EUR_1	50000	EUR	1	88992283	89283098	290815
EUR_1	50000	EUR	1	96935175	98867955	1932780
EUR_2	50000	EUR	2	0	747704	747704
EUR_2	50000	EUR	2	17874426	18158774	284348
EUR_2	50000	EUR	2	46869363	49445009	2575646
EUR_2	50000	EUR	3	59609372	59762285	152913
EUR_2	50000	EUR	3	62976574	64048404	1071830
EUR_2	50000	EUR	3	74092259	74111582	19323
EUR_2	50000	EUR	3	75192676	75719284	526608
EUR_2	50000	EUR	3	83148795	83790282	641487
EUR_2	50000	EUR	3	84040452	85382299	1341847
EUR_3	50000	EUR	4	12978494	13749149	770655
EUR_3	50000	EUR	4	86954468	87115837	161369
EUR_3	50000	EUR	4	98247583	98867955	620372
EUR_3	50000	EUR	5	2390434	2548507	158073
EUR_3	50000	EUR	5	12386475	13748542	1362067
EUR_3	50000	EUR	5	16556677	16622461	65784
EUR_3	50000	EUR	5	27367141	27927317	560176
EUR_3	50000	EUR	5	35242896	36110972	868076
EUR_3	50000	EUR	5	80381576	81015903	634327
EUR_3	50000	EUR	5	92978633	94091139	1112506
EUR_3	50000	EUR	5	97826957	99781615	1954658
EUR_4	50000	EUR	6	31273240	32581466	1308226
EUR_4	50000	EUR	6	43066847	43892072	825225
EUR_4	50000	EUR	6	48187183	48905680	718497
EUR_4	50000	EUR	6	50017733	51025535	1007802
EUR_4	50000	EUR	6	64332882	64618542	285660
EUR_4	50000	EUR	6	81250649	81534639	283990
EUR_4	50000	EUR	6	84040452	85382299	1341847
EUR_4	50000	EUR	7	18842024	18924955	82931
EUR_4	50000	EUR	7	25499984	26121918	621934
EUR_4	50000	EUR	7	45919475	45981151	61676
EUR_4	50000	EUR	7	62447396	62679200	231804
EUR_4	50000	EUR	7	64648112	67079423	2431311
EUR_5	50000	EUR	8	975930	1414360	438430
EUR_5	50000	EUR	8	12604239	12776130	171891
EUR_5	50000	EUR	8	21053031	21290475	237444
EUR_5	50000	EUR	8	47573262	48321534	748272
EUR_5	50000	EUR	8	51721135	51826252	105117
EUR_5	50000	EUR	8	94031298	94767078	735780
EUR_5	50000	EUR	8	97229828	97235742	5914
EUR_5	50000	EUR	9	35329644	37781345	2451701
EUR_5	50000	EUR	9	54156560	54894861	738301
EUR_5	50000	EUR	9	60580754	61382986	802232
EUR_6	50000	EUR	10	88436	887166	798730
EUR_6	50000	EUR	10	3385702	4253081	867379
EUR_6	50000	EUR	10	56825387	58347750	1522363
EUR_6	50000	EUR	11	58008794	58023254	14460
EUR_6	50000	EUR	11	73247966	73607499	359533
EUR_6	50000	EUR	11	94687120	94828898	141778
EUR_7	50000	EUR	12	2266226	4693520	2427294
EUR_7	50000	EUR	12	10591174	10605170	13996
EUR_7	50000	EUR	12	15837982	16135699	297717
EUR_7	50000	EUR	12	30338563	31098617	760054
EUR_7	50000	EUR	12	38786996	40532520	1745524
EUR_7	50000	EUR	12	56477469	57053710	576241
EUR_7	50000	EUR	12	67104727	67378599	273872
EUR_7	50000	EUR	13	1969736	2103100	133364
EUR_7	50000	EUR	13	9178348	9374161	195813
EUR_7	50000	EUR	13	27780237	28550679	770442
EUR_7	50000	EUR	13	45779531	46004405	224874
EUR_7	50000	EUR	13	59079996	59875641	795645
EUR_7	50000	EUR	13	66329807	66362168	32361
EUR_7	50000	EUR	13	78000198	78333149	332951
EUR_7	50000	EUR	13	81939196	82257427	318231
EUR_7	50000	EUR	13	90252537	90798120	545583
EUR_7	50000	EUR	13	95275454	96092356	816902
EUR_8	50000	EUR	14	12303898	13277357	973459
EUR_8	50000	EUR	14	17935003	18493896	558893
EUR_8	50000	EUR	14	20919793	21048196	128403
EUR_8	50000	EUR	14	43750662	44088815	338153
EUR_8	50000	EUR	14	56477469	57053710	576241
EUR_8	50000	EUR	14	59099981	59113995	14014
EUR_8	50000	EUR	14	65538537	65722195	183658
EUR_8	50000	EUR	15	4059608	4333564	273956
EUR_8	50000	EUR	15	17698801	18310114	611313
EUR_8	50000	EUR	15	21539204	21965772	426568
EUR_8	50000	EUR	15	41286506	41675549	389043
EUR_8	50000	EUR	15	44156331	44161135	4804
EUR_8	50000	EUR	15	48206789	48715368	508579
EUR_8	50000	EUR	15	56544194	57182153	637959
EUR_8	50000	EUR	15	62266230	63883651	1617421
EUR_8	50000	EUR	15	77470010	77933016	463006
EUR_8	50000	EUR	15	96379317	96543344	164027
EUR_8	50000	EUR	15	99365042	99925173	560131
EUR_9	50000	EUR	16	0	299560	299560
EUR_9	50000	EUR	16	28771071	30124006	1352935
EUR_9	50000	EUR	16	56606415	56867904	261489
EUR_9	50000	EUR	16	67516377	67693426	177049
EUR_9	50000	EUR	16	82682910	82810328	127418
EUR_9	50000	EUR	17	2254479	2714275	459796
EUR_9	50000	EUR	17	36004064	36062268	58204
EUR_9	50000	EUR	17	48804742	48818489	13747
EUR_9	50000	EUR	17	72313374	72399948	86574
EUR_9	50000	EUR	17	85019375	85554609	535234
EUR_10	50000	EUR	18	32123254	32855838	732584
EUR_10	50000	EUR	18	49312143	49440694	128551
EUR_10	50000	EUR	18	54156560	54888926	732366
EUR_10	50000	EUR	18	84040452	84271381	230929
EUR_10	50000	EUR	19	10886437	11132879	246442
EUR_10	50000	EUR	19	12604239	14215670	1611431
EUR_10	50000	EUR	19	16556677	16674572	117895
EUR_10	50000	EUR	19	21935834	21965772	29938
EUR_10	50000	EUR	19	28909134	28912719	3585
EUR_10	50000	EUR	19	43501961	43571611	69650
EUR_10	50000	EUR	19	46941843	47383207	441364
EUR_10	50000	EUR	19	76810926	77160533	349607
EUR_11	40000	EUR	20	0	8597	8597
EUR_11	40000	EUR	20	4067245	4101969	34724
EUR_11	40000	EUR	20	14140059	14161746	21687
EUR_11	40000	EUR	20	19324499	19493755	169256
EUR_11	40000	EUR	20	20612442	21216187	603745
EUR_11	40000	EUR	20	21942088	21965772	23684
EUR_11	40000	EUR	20	32453173	32787200	334027
EUR_11	40000	EUR	20	39683884	39959656	275772
EUR_11	40000	EUR	20	43595172	43817028	221856
EUR_11	40000	EUR	20	49133746	49164811	31065
EUR_11	40000	EUR	20	64007129	64060264	53135
EUR_11	40000	EUR	20	67802545	67901463	98918
EUR_11	40000	EUR	20	96819904	97253692	433788
EUR_11	40000	EUR	21	5623952	5741613	117661
EUR_11	40000	EUR	21	9327703	9647147	319444
EUR_11	40000	EUR	21	12166455	12498767	332312
EUR_11	40000	EUR	21	19189424	19465227	275803
EUR_11	40000	EUR	21	27000566	27015533	14967
EUR_11	40000	EUR	21	29749217	30224445	475228
EUR_11	40000	EUR	21	36536523	36652775	116252
EUR_11	40000	EUR	21	43750662	43846571	95909
EUR_11	40000	EUR	21	60834393	60897919	63526
EUR_11	40000	EUR	21	64152513	64192154	39641
EUR_11	40000	EUR	21	70063263	70143173	79910
EUR_11	40000	EUR	21	73714003	74433313	719310
EUR_11	40000	EUR	21	74952867	74953952	1085
EUR_11	40000	EUR	21	79878461	80057565	179104
EUR_11	40000	EUR	21	80365634	80466548	100914
EUR_11	40000	EUR	21	84118542	84198948	80406
EUR_11	40000	EUR	21	84847586	85007611	160025
EUR_11	40000	EUR	21	86417646	86479474	61828
EUR_11	40000	EUR	21	93867328	93983424	116096
EUR_12	40000	EUR	22	4067245	4258696	191451
EUR_12	40000	EUR	22	5380293	5526855	146562
EUR_12	40000	EUR	22	5612289	5741613	129324
EUR_12	40000	EUR	22	13400034	13652558	252524
EUR_12	40000	EUR	22	13744802	13748542	3740
EUR_12	40000	EUR	22	19189424	19465227	275803
EUR_12	40000	EUR	22	22186191	22214748	28557
EUR_12	40000	EUR	22	27030183	27172878	142695
EUR_12	40000	EUR	22	31101337	31198091	96754
EUR_12	40000	EUR	22	31444098	31913161	469063
EUR_12	40000	EUR	22	46033726	46484138	450412
EUR_12	40000	EUR	22	50121706	50139700	17994
EUR_12	40000	EUR	22	57959433	58064278	104845
EUR_12	40000	EUR	22	62266230	62449988	183758
EUR_12	40000	EUR	22	78312904	78326890	13986
EUR_12	40000	EUR	22	80899922	80948602	48680
EUR_12	40000	EUR	22	84744924	84859626	114702
EUR_12	40000	EUR	23	21766544	22064725	298181
EUR_12	40000	EUR	23	23339358	23438353	98995
EUR_12	40000	EUR	23	31098605	31134052	35447
EUR_12	40000	EUR	23	48039880	48801513	761633
EUR_12	40000	EUR	23	49006754	49164811	158057
EUR_12	40000	EUR	23	50075754	50139700	63946
EUR_12	40000	EUR	23	53195740	53215009	19269
EUR_12	40000	EUR	23	55662959	55943914	280955
EUR_12	40000	EUR	23	56926210	56952580	26370
EUR_12	40000	EUR	23	59025323	59087449	62126
EUR_12	40000	EUR	23	62360857	62537606	176749
EUR_12	40000	EUR	23	62626144	63041174	415030
EUR_12	40000	EUR	23	64559645	64648825	89180
EUR_12	40000	EUR	23	67516377	67550551	34174
EUR_12	40000	EUR	23	71466211	71510785	44574
EUR_12	40000	EUR	23	73460990	73621956	160966
EUR_12	40000	EUR	23	76406273	76485346	79073
EUR_12	40000	EUR	23	79636078	79781838	145760
EUR_12	40000	EUR	23	96909677	97184963	275286
EUR_12	40000	EUR	23	97203189	97335488	132299
EUR_12	40000	EUR	23	98041545	98553700	512155
EUR_13	40000	EUR	24	5894459	5971269	76810
EUR_13	40000	EUR	24	9051485	9411162	359677
EUR_13	40000	EUR	24	11802975	11836160	33185
EUR_13	40000	EUR	24	12498821	13050169	551348
EUR_13	40000	EUR	24	29741238	29767219	25981
EUR_13	40000	EUR	24	43547085	43852571	305486
EUR_13	40000	EUR	24	46588754	46702870	114116
EUR_13	40000	EUR	24	47624392	47744901	120509
EUR_13	40000	EUR	24	57959433	58064278	104845
EUR_13	40000	EUR	24	60836692	60933571	96879
EUR_13	40000	EUR	24	63735447	64066021	330574
EUR_13	40000	EUR	24	72313374	72399948	86574
EUR_13	40000	EUR	24	74737587	74953952	216365
EUR_13	40000	EUR	24	81329834	81426284	96450
EUR_13	40000	EUR	24	84059860	84133615	73755
EUR_13	40000	EUR	24	84248591	84284876	36285
EUR_13	40000	EUR	25	9633606	10496018	862412
EUR_13	40000	EUR	25	12166455	12231489	65034
EUR_13	40000	EUR	25	13001397	13085270	83873
EUR_13	40000	EUR	25	14713216	14909313	196097
EUR_13	40000	EUR	25	19490258	19509281	19023
EUR_13	40000	EUR	25	20919793	21048196	128403
EUR_13	40000	EUR	25	30743485	30841267	97782
EUR_13	40000	EUR	25	48146977	48250037	103060
EUR_13	40000	EUR	25	50020142	50516476	496334
EUR_13	40000	EUR	25	55568745	55651082	82337
EUR_13	40000	EUR	25	59745200	59789210	44010
EUR_13	40000	EUR	25	60580754	60988138	407384
EUR_13	40000	EUR	25	61775819	61825359	49540
EUR_13	40000	EUR	25	62423497	62754209	330712
EUR_13	40000	EUR	25	64400103	64676127	276024
EUR_13	40000	EUR	25	65607977	66060924	452947
EUR_13	40000	EUR	25	69004995	69315282	310287
EUR_13	40000	EUR	25	73866047	74462618	596571
EUR_13	40000	EUR	25	82096594	82248911	152317
EUR_13	40000	EUR	25	82712051	83035646	323595
EUR_13	40000	EUR	25	84271016	84589581	318565
EUR_13	40000	EUR	25	88161185	88192866	31681
EUR_13	40000	EUR	25	89056501	89116106	59605
EUR_13	40000	EUR	25	90737504	90798120	60616
EUR_13	40000	EUR	25	92657968	92966114	308146
EUR_13	40000	EUR	25	95540547	95546050	5503
EUR_13	40000	EUR	25	97439953	97542615	102662
EUR_14	40000	EUR	26	0	38454	38454
EUR_14	40000	EUR	26	4067245	4101969	34724
EUR_14	40000	EUR	26	5748464	5800485	52021
EUR_14	40000	EUR	26	12166455	12300041	133586
EUR_14	40000	EUR	26	13229578	13565189	335611
EUR_14	40000	EUR	26	14713216	14904614	191398
EUR_14	40000	EUR	26	19490258	19815522	325264
EUR_14	40000	EUR	26	30174565	30224445	49880
EUR_14	40000	EUR	26	38601596	38684344	82748
EUR_14	40000	EUR	26	40884304	41067173	182869
EUR_14	40000	EUR	26	44688002	44811416	123414
EUR_14	40000	EUR	26	47069594	47141198	71604
EUR_14	40000	EUR	26	47624392	47744901	120509
EUR_14	40000	EUR	26	62363965	62460553	96588
EUR_14	40000	EUR	26	64025137	64066021	40884
EUR_14	40000	EUR	26	69991439	70318525	327086
EUR_14	40000	EUR	26	72313374	72399948	86574
EUR_14	40000	EUR	26	75018361	75213527	195166
EUR_14	40000	EUR	26	83543294	83547818	4524
EUR_14	40000	EUR	26	85014022	85039484	25462
EUR_14	40000	EUR	26	89360185	89463966	103781
EUR_14	40000	EUR	27	12350442	12929392	578950
EUR_14	40000	EUR	27	23507155	23676423	169268
EUR_14	40000	EUR	27	29578129	29606582	28453
EUR_14	40000	EUR	27	39781521	40486683	705162
EUR_14	40000	EUR	27	50001047	50063201	62154
EUR_14	40000	EUR	27	61672452	61750181	77729
EUR_14	40000	EUR	27	62266230	62443764	177534
EUR_14	40000	EUR	27	62493467	62546944	53477
EUR_14	40000	EUR	27	64213067	64332094	119027
EUR_14	40000	EUR	27	88064488	88163055	98567
EUR_14	40000	EUR	27	93824275	93983424	159149
EUR_15	40000	EUR	28	2546547	2868801	322254
EUR_15	40000	EUR	28	4067245	4576126	508881
EUR_15	40000	EUR	28	11827144	12386769	559625
EUR_15	40000	EUR	28	14032040	14295184	263144
EUR_15	40000	EUR	28	19553736	19815522	261786
EUR_15	40000	EUR	28	31358728	31564869	206141
EUR_15	40000	EUR	28	39683884	40019809	335925
EUR_15	40000	EUR	28	50121706	50139700	17994
EUR_15	40000	EUR	28	51721135	51826252	105117
EUR_15	40000	EUR	28	54298907	54463647	164740
EUR_15	40000	EUR	28	56739090	56867904	128814
EUR_15	40000	EUR	28	59931426	59938917	7491
EUR_15	40000	EUR	28	62266230	62516189	249959
EUR_15	40000	EUR	28	63290316	63549215	258899
EUR_15	40000	EUR	28	63947203	64035302	88099
EUR_15	40000	EUR	28	69991439	70318525	327086
EUR_15	40000	EUR	28	77152145	77201526	49381
EUR_15	40000	EUR	28	81956784	82014609	57825
EUR_15	40000	EUR	28	96454365	96606510	152145
EUR_15	40000	EUR	28	97137184	97229983	92799
EUR_15	40000	EUR	28	97580196	98146557	566361
EUR_15	40000	EUR	29	1368100	1622588	254488
EUR_15	40000	EUR	29	13071066	13369355	298289
EUR_15	40000	EUR	29	15480623	15577035	96412
EUR_15	40000	EUR	29	19451591	19484817	33226
EUR_15	40000	EUR	29	30528228	31263629	735401
EUR_15	40000	EUR	29	41082532	41386596	304064
EUR_15	40000	EUR	29	49589824	49637628	47804
EUR_15	40000	EUR	29	53185452	53248662	63210
EUR_15	40000	EUR	29	67673403	67733569	60166
EUR_15	40000	EUR	29	73344343	73621956	277613
EUR_15	40000	EUR	29	79636078	79837106	201028
EUR_15	40000	EUR	29	80169302	80492274	322972
EUR_15	40000	EUR	29	84744924	84859626	114702
EUR_15	40000	EUR	29	92491162	92750437	259275
EUR_15	40000	EUR	29	96909677	97184963	275286
EUR_15	40000	EUR	29	97203189	97335488	132299
EUR_15	40000	EUR	29	98041545	98553700	512155
EUR_16	40000	EUR	30	196934	206962	10028
EUR_16	40000	EUR	30	7991076	8157835	166759
EUR_16	40000	EUR	30	12592297	12645530	53233
EUR_16	40000	EUR	30	14032040	14295184	263144
EUR_16	40000	EUR	30	24541668	24875637	333969
EUR_16	40000	EUR	30	43066847	43382485	315638
EUR_16	40000	EUR	30	44182199	44353481	171282
EUR_16	40000	EUR	30	48137196	48501306	364110
EUR_16	40000	EUR	30	48730455	48852598	122143
EUR_16	40000	EUR	30	54201120	54258186	57066
EUR_16	40000	EUR	30	56739090	56867904	128814
EUR_16	40000	EUR	30	61435163	61520121	84958
EUR_16	40000	EUR	30	62266230	62301664	35434
EUR_16	40000	EUR	30	63616457	63767652	151195
EUR_16	40000	EUR	30	67802545	68008547	206002
EUR_16	40000	EUR	30	73344343	73621956	277613
EUR_16	40000	EUR	30	77940158	77981834	41676
EUR_16	40000	EUR	30	81789814	81974654	184840
EUR_16	40000	EUR	30	82084282	82192866	108584
EUR_16	40000	EUR	30	96808612	96983305	174693
EUR_16	40000	EUR	31	994187	1121593	127406
EUR_16	40000	EUR	31	5612289	5629543	17254
EUR_16	40000	EUR	31	12564547	13085270	520723
EUR_16	40000	EUR	31	28909134	28912719	3585
EUR_16	40000	EUR	31	48891623	49409796	518173
EUR_16	40000	EUR	31	49591055	49792315	201260
EUR_16	40000	EUR	31	56981282	57026186	44904
EUR_16	40000	EUR	31	60580754	60767465	186711
EUR_16	40000	EUR	31	61775819	62537606	761787
EUR_16	40000	EUR	31	62626144	63041174	415030
EUR_16	40000	EUR	31	64559645	64648825	89180
EUR_16	40000	EUR	31	67516377	67550551	34174
EUR_16	40000	EUR	31	73344343	73440646	96303
EUR_16	40000	EUR	31	76219599	76386209	166610
EUR_16	40000	EUR	31	82712051	83035646	323595
EUR_16	40000	EUR	31	96536306	97108754	572448
EUR_16	40000	EUR	31	97398476	98146557	748081
EUR_17	40000	EUR	32	11155402	11267811	112409
EUR_17	40000	EUR	32	13990229	14206093	215864
EUR_17	40000	EUR	32	14623115	14641335	18220
EUR_17	40000	EUR	32	22420714	22571400	150686
EUR_17	40000	EUR	32	27699854	27765523	65669
EUR_17	40000	EUR	32	29201265	29403219	201954
EUR_17	40000	EUR	32	33953984	34131064	177080
EUR_17	40000	EUR	32	35329644	35348990	19346
EUR_17	40000	EUR	32	37227560	37455443	227883
EUR_17	40000	EUR	32	43066847	43566857	500010
EUR_17	40000	EUR	32	44651613	44811416	159803
EUR_17	40000	EUR	32	49589824	49961812	371988
EUR_17	40000	EUR	32	50214714	50684992	470278
EUR_17	40000	EUR	32	55727235	55943914	216679
EUR_17	40000	EUR	32	56088795	56202989	114194
EUR_17	40000	EUR	32	62363965	62460553	96588
EUR_17	40000	EUR	32	62808129	62863488	55359
EUR_17	40000	EUR	32	69084451	69099903	15452
EUR_17	40000	EUR	32	79823819	80047802	223983
EUR_17	40000	EUR	32	88064488	88315643	251155
EUR_17	40000	EUR	32	96645441	96684466	39025
EUR_17	40000	EUR	33	1581345	1671703	90358
EUR_17	40000	EUR	33	10148513	10335169	186656
EUR_17	40000	EUR	33	11967943	12005846	37903
EUR_17	40000	EUR	33	12594483	12687739	93256
EUR_17	40000	EUR	33	12959122	12989272	30150
EUR_17	40000	EUR	33	17183404	17259360	75956
EUR_17	40000	EUR	33	22922311	23158720	236409
EUR_17	40000	EUR	33	23358116	23379796	21680
EUR_17	40000	EUR	33	30642174	30878325	236151
EUR_17	40000	EUR	33	39781521	40486683	705162
EUR_17	40000	EUR	33	44182199	44353481	171282
EUR_17	40000	EUR	33	46821026	46998835	177809
EUR_17	40000	EUR	33	49067936	49164811	96875
EUR_17	40000	EUR	33	54092263	54139664	47401
EUR_17	40000	EUR	33	55133951	55176093	42142
EUR_17	40000	EUR	33	57959433	58064278	104845
EUR_17	40000	EUR	33	60613717	60988138	374421
EUR_17	40000	EUR	33	67382553	67392164	9611
EUR_17	40000	EUR	33	67945509	68176869	231360
EUR_17	40000	EUR	33	70200024	70323506	123482
EUR_17	40000	EUR	33	77659474	77705895	46421
EUR_17	40000	EUR	33	81834623	81951234	116611
EUR_17	40000	EUR	33	84040452	84198948	158496
EUR_17	40000	EUR	33	96215188	97584976	1369788
EUR_18	40000	EUR	34	4067245	4132846	65601
EUR_18	40000	EUR	34	12480475	12687739	207264
EUR_18	40000	EUR	34	14501013	14758699	257686
EUR_18	40000	EUR	34	15526420	15701244	174824
EUR_18	40000	EUR	34	16651776	16663817	12041
EUR_18	40000	EUR	34	17587984	17857804	269820
EUR_18	40000	EUR	34	18494323	18604686	110363
EUR_18	40000	EUR	34	31068444	31233050	164606
EUR_18	40000	EUR	34	44651613	44817985	166372
EUR_18	40000	EUR	34	45003549	45007478	3929
EUR_18	40000	EUR	34	47876289	47900182	23893
EUR_18	40000	EUR	34	52049469	52092551	43082
EUR_18	40000	EUR	34	56606415	56867904	261489
EUR_18	40000	EUR	34	60834393	60897919	63526
EUR_18	40000	EUR	34	62060602	62076335	15733
EUR_18	40000	EUR	34	63947203	64066021	118818
EUR_18	40000	EUR	34	64076405	64481665	405260
EUR_18	40000	EUR	34	67529684	67733569	203885
EUR_18	40000	EUR	34	69976346	70323506	347160
EUR_18	40000	EUR	34	83699331	83845592	146261
EUR_18	40000	EUR	34	91198280	91198684	404
EUR_18	40000	EUR	35	28909134	28912719	3585
EUR_18	40000	EUR	35	46645242	46898836	253594
EUR_18	40000	EUR	35	48474462	48715368	240906
EUR_18	40000	EUR	35	53195740	53215009	19269
EUR_18	40000	EUR	35	53914631	53938830	24199
EUR_18	40000	EUR	35	55608330	55943914	335584
EUR_18	40000	EUR	35	56088795	56202989	114194
EUR_18	40000	EUR	35	63177292	63277354	100062
EUR_18	40000	EUR	35	73245291	73299538	54247
EUR_18	40000	EUR	35	76219599	76336677	117078
EUR_18	40000	EUR	35	76964560	77018398	53838
EUR_18	40000	EUR	35	83692011	83727774	35763
EUR_18	40000	EUR	35	96215188	97584976	1369788
EUR_19	40000	EUR	36	8771111	9042764	271653
EUR_19	40000	EUR	36	15607322	16041545	434223
EUR_19	40000	EUR	36	21398553	21428911	30358
EUR_19	40000	EUR	36	29749217	29884548	135331
EUR_19	40000	EUR	36	39093544	39182279	88735
EUR_19	40000	EUR	36	41227254	41386596	159342
EUR_19	40000	EUR	36	44182199	44353481	171282
EUR_19	40000	EUR	36	49170933	49589727	418794
EUR_19	40000	EUR	36	50121706	50139700	17994
EUR_19	40000	EUR	36	62067635	62243586	175951
EUR_19	40000	EUR	36	67432373	67704856	272483
EUR_19	40000	EUR	36	77152145	77201526	49381
EUR_19	40000	EUR	36	79228995	79380093	151098
EUR_19	40000	EUR	36	81849638	82014609	164971
EUR_19	40000	EUR	36	90308604	90651092	342488
EUR_19	40000	EUR	36	95113083	95769773	656690
EUR_19	40000	EUR	36	96935175	97293915	358740
EUR_19	40000	EUR	36	98090476	98553700	463224
EUR_19	40000	EUR	37	196934	206962	10028
EUR_19	40000	EUR	37	994187	1125339	131152
EUR_19	40000	EUR	37	13096243	13191657	95414
EUR_19	40000	EUR	37	14750581	14751815	1234
EUR_19	40000	EUR	37	14790075	14920107	130032
EUR_19	40000	EUR	37	19490258	19815522	325264
EUR_19	40000	EUR	37	22186351	22214748	28397
EUR_19	40000	EUR	37	29749217	30224445	475228
EUR_19	40000	EUR	37	31020964	31084206	63242
EUR_19	40000	EUR	37	43590054	43829551	239497
EUR_19	40000	EUR	37	45719414	45742393	22979
EUR_19	40000	EUR	37	49589824	50063201	473377
EUR_19	40000	EUR	37	56981282	57026186	44904
EUR_19	40000	EUR	37	62238541	62546944	308403
EUR_19	40000	EUR	37	70063263	70143173	79910
EUR_19	40000	EUR	37	77940158	77981834	41676
EUR_19	40000	EUR	37	83543294	84552343	1009049
EUR_19	40000	EUR	37	95144247	95179379	35132
EUR_19	40000	EUR	37	96087102	96192568	105466
EUR_19	40000	EUR	37	96344658	96679252	334594
EUR_20	40000	EUR	38	10536751	10559629	22878
EUR_20	40000	EUR	38	12959122	12963600	4478
EUR_20	40000	EUR	38	14713216	14909313	196097
EUR_20	40000	EUR	38	28909134	28912719	3585
EUR_20	40000	EUR	38	29741238	29767219	25981
EUR_20	40000	EUR	38	31785402	32403171	617769
EUR_20	40000	EUR	38	43066847	43382485	315638
EUR_20	40000	EUR	38	47868799	48035282	166483
EUR_20	40000	EUR	38	49798646	50063201	264555
EUR_20	40000	EUR	38	54190988	54258186	67198
EUR_20	40000	EUR	38	62266230	62344730	78500
EUR_20	40000	EUR	38	62756917	62794679	37762
EUR_20	40000	EUR	38	66901089	67015056	113967
EUR_20	40000	EUR	38	67141252	67765396	624144
EUR_20	40000	EUR	38	72313374	72399948	86574
EUR_20	40000	EUR	38	76664084	76797843	133759
EUR_20	40000	EUR	38	84074915	84083936	9021
EUR_20	40000	EUR	39	4059608	4161432	101824
EUR_20	40000	EUR	39	12235935	12299867	63932
EUR_20	40000	EUR	39	23358116	23438353	80237
EUR_20	40000	EUR	39	24835791	25051204	215413
EUR_20	40000	EUR	39	30743485	30841267	97782
EUR_20	40000	EUR	39	48891623	49409796	518173
EUR_20	40000	EUR	39	49591055	49792315	201260
EUR_20	40000	EUR	39	54183346	54258186	74840
EUR_20	40000	EUR	39	55925886	55943914	18028
EUR_20	40000	EUR	39	56795478	56867904	72426
EUR_20	40000	EUR	39	56983256	57026186	42930
EUR_20	40000	EUR	39	60834393	60897919	63526
EUR_20	40000	EUR	39	67529684	67733569	203885
EUR_20	40000	EUR	39	69976346	70323506	347160
EUR_20	40000	EUR	39	81789814	81974654	184840
EUR_20	40000	EUR	39	84040452	84198948	158496
EUR_20	40000	EUR	39	95127554	95397499	269945
EUR_20	40000	EUR	39	97200322	97235742	35420
EUR_21	30000	EUR	40	5689746	5741613	51867
EUR_21	30000	EUR	40	12592297	12592393	96
EUR_21	30000	EUR	40	16960554	17029159	68605
EUR_21	30000	EUR	40	22370098	22698639	328541
EUR_21	30000	EUR	40	23507155	23576056	68901
EUR_21	30000	EUR	40	30528228	30590405	62177
EUR_21	30000	EUR	40	43404146	43566857	162711
EUR_21	30000	EUR	40	43829906	43852571	22665
EUR_21	30000	EUR	40	44058762	44080181	21419
EUR_21	30000	EUR	40	45485530	45495004	9474
EUR_21	30000	EUR	40	45919475	46069871	150396
EUR_21	30000	EUR	40	48273976	48321534	47558
EUR_21	30000	EUR	40	49050712	49139016	88304
EUR_21	30000	EUR	40	51821951	52045718	223767
EUR_21	30000	EUR	40	53001895	53302464	300569
EUR_21	30000	EUR	40	54422321	54463647	41326
EUR_21	30000	EUR	40	54568733	54580607	11874
EUR_21	30000	EUR	40	54779751	54834542	54791
EUR_21	30000	EUR	40	55505150	55603453	98303
EUR_21	30000	EUR	40	63177292	63277354	100062
EUR_21	30000	EUR	40	63330030	63427526	97496
EUR_21	30000	EUR	40	67824287	67905310	81023
EUR_21	30000	EUR	40	70314329	70323506	9177
EUR_21	30000	EUR	40	70425266	70471952	46686
EUR_21	30000	EUR	40	73344343	73621956	277613
EUR_21	30000	EUR	40	74118442	74159054	40612
EUR_21	30000	EUR	40	78278359	78281355	2996
EUR_21	30000	EUR	40	84971245	84989654	18409
EUR_21	30000	EUR	40	89458586	89463966	5380
EUR_21	30000	EUR	40	91097171	91171662	74491
EUR_21	30000	EUR	40	92657968	92893775	235807
EUR_21	30000	EUR	40	96344658	96460323	115665
EUR_21	30000	EUR	40	97145171	97374985	229814
EUR_21	30000	EUR	41	2267390	2436497	169107
EUR_21	30000	EUR	41	4066689	4333564	266875
EUR_21	30000	EUR	41	8846483	8958572	112089
EUR_21	30000	EUR	41	9629012	9637337	8325
EUR_21	30000	EUR	41	17260702	17323735	63033
EUR_21	30000	EUR	41	28909134	28912719	3585
EUR_21	30000	EUR	41	31091633	31263629	171996
EUR_21	30000	EUR	41	35919099	36017172	98073
EUR_21	30000	EUR	41	39531946	39913649	381703
EUR_21	30000	EUR	41	44002732	44033993	31261
EUR_21	30000	EUR	41	44497681	44701885	204204
EUR_21	30000	EUR	41	50214714	50344415	129701
EUR_21	30000	EUR	41	54241431	54294851	53420
EUR_21	30000	EUR	41	61849129	62021622	172493
EUR_21	30000	EUR	41	62266230	62587991	321761
EUR_21	30000	EUR	41	64559645	64648825	89180
EUR_21	30000	EUR	41	64682627	64755238	72611
EUR_21	30000	EUR	41	65392456	65443601	51145
EUR_21	30000	EUR	41	67943453	68176869	233416
EUR_21	30000	EUR	41	70176832	70336637	159805
EUR_21	30000	EUR	41	72313374	72399948	86574
EUR_21	30000	EUR	41	83745607	84000212	254605
EUR_21	30000	EUR	41	84271016	84589581	318565
EUR_21	30000	EUR	41	93210081	93437672	227591
EUR_21	30000	EUR	41	95713081	95757302	44221
EUR_21	30000	EUR	41	96935175	96957114	21939
EUR_21	30000	EUR	41	97145555	97229983	84428
EUR_21	30000	EUR	41	97398476	97581104	182628
EUR_22	30000	EUR	42	0	11076	11076
EUR_22	30000	EUR	42	4122069	4333564	211495
EUR_22	30000	EUR	42	10185883	10351635	165752
EUR_22	30000	EUR	42	12592297	12592393	96
EUR_22	30000	EUR	42	19316850	19544916	228066
EUR_22	30000	EUR	42	21586791	21973157	386366
EUR_22	30000	EUR	42	23793798	23946866	153068
EUR_22	30000	EUR	42	29201265	29403219	201954
EUR_22	30000	EUR	42	39475823	39545103	69280
EUR_22	30000	EUR	42	40040672	40169297	128625
EUR_22	30000	EUR	42	41252118	41267617	15499
EUR_22	30000	EUR	42	43816300	43852571	36271
EUR_22	30000	EUR	42	44183609	44244547	60938
EUR_22	30000	EUR	42	48540943	48602191	61248
EUR_22	30000	EUR	42	53195740	53215009	19269
EUR_22	30000	EUR	42	55283447	55557649	274202
EUR_22	30000	EUR	42	55683186	55935283	252097
EUR_22	30000	EUR	42	56606415	56695626	89211
EUR_22	30000	EUR	42	56981282	57026186	44904
EUR_22	30000	EUR	42	62427365	62539886	112521
EUR_22	30000	EUR	42	62584114	62820719	236605
EUR_22	30000	EUR	42	63089221	63269352	180131
EUR_22	30000	EUR	42	63334896	63563994	229098
EUR_22	30000	EUR	42	64034761	64066021	31260
EUR_22	30000	EUR	42	64332882	64447738	114856
EUR_22	30000	EUR	42	67360462	67404467	44005
EUR_22	30000	EUR	42	67581165	67704856	123691
EUR_22	30000	EUR	42	80747385	80896589	149204
EUR_22	30000	EUR	42	82979134	83035646	56512
EUR_22	30000	EUR	42	84271016	84423669	152653
EUR_22	30000	EUR	42	85810254	85965919	155665
EUR_22	30000	EUR	42	86183232	86324407	141175
EUR_22	30000	EUR	42	91097171	91160908	63737
EUR_22	30000	EUR	42	95964529	96045606	81077
EUR_22	30000	EUR	42	96882609	97166881	284272
EUR_22	30000	EUR	43	3994924	4124617	129693
EUR_22	30000	EUR	43	10148513	10351635	203122
EUR_22	30000	EUR	43	13471709	13475364	3655
EUR_22	30000	EUR	43	15872423	16041545	169122
EUR_22	30000	EUR	43	23249672	23362675	113003
EUR_22	30000	EUR	43	23678834	23696381	17547
EUR_22	30000	EUR	43	27190538	27244932	54394
EUR_22	30000	EUR	43	30736728	31015180	278452
EUR_22	30000	EUR	43	43547085	43559878	12793
EUR_22	30000	EUR	43	44253582	44347094	93512
EUR_22	30000	EUR	43	45719414	45742393	22979
EUR_22	30000	EUR	43	48942765	49071287	128522
EUR_22	30000	EUR	43	49807803	50340188	532385
EUR_22	30000	EUR	43	53195740	53215009	19269
EUR_22	30000	EUR	43	55283447	55557649	274202
EUR_22	30000	EUR	43	60401573	60942404	540831
EUR_22	30000	EUR	43	61881873	62460553	578680
EUR_22	30000	EUR	43	62808129	62863488	55359
EUR_22	30000	EUR	43	71108569	71427923	319354
EUR_22	30000	EUR	43	79917556	79977985	60429
EUR_22	30000	EUR	43	84074915	84095270	20355
EUR_22	30000	EUR	43	84174413	84347352	172939
EUR_22	30000	EUR	43	86340983	86466441	125458
EUR_22	30000	EUR	43	96476805	96558722	81917
EUR_22	30000	EUR	43	97133123	97478654	345531
EUR_22	30000	EUR	43	97607910	97690675	82765
EUR_23	30000	EUR	44	8846483	8958572	112089
EUR_23	30000	EUR	44	9390723	9477829	87106
EUR_23	30000	EUR	44	10310816	10559629	248813
EUR_23	30000	EUR	44	13070757	13085270	14513
EUR_23	30000	EUR	44	15607322	15638885	31563
EUR_23	30000	EUR	44	15697742	15701244	3502
EUR_23	30000	EUR	44	21335089	21404271	69182
EUR_23	30000	EUR	44	22024903	22064725	39822
EUR_23	30000	EUR	44	22947870	23374530	426660
EUR_23	30000	EUR	44	28909134	28912719	3585
EUR_23	30000	EUR	44	29201265	29403219	201954
EUR_23	30000	EUR	44	31159137	31446569	287432
EUR_23	30000	EUR	44	39475823	39537203	61380
EUR_23	30000	EUR	44	41227254	41386596	159342
EUR_23	30000	EUR	44	43066847	43291736	224889
EUR_23	30000	EUR	44	43547085	43587658	40573
EUR_23	30000	EUR	44	44199789	44353481	153692
EUR_23	30000	EUR	44	49589824	49712639	122815
EUR_23	30000	EUR	44	50494917	50499105	4188
EUR_23	30000	EUR	44	50834852	50964254	129402
EUR_23	30000	EUR	44	51721135	51756063	34928
EUR_23	30000	EUR	44	56606415	56661029	54614
EUR_23	30000	EUR	44	64007129	64060264	53135
EUR_23	30000	EUR	44	64632417	65025826	393409
EUR_23	30000	EUR	44	67529684	67733569	203885
EUR_23	30000	EUR	44	78312824	78326890	14066
EUR_23	30000	EUR	44	82740735	83035646	294911
EUR_23	30000	EUR	44	84586314	84597943	11629
EUR_23	30000	EUR	44	85960165	86128721	168556
EUR_23	30000	EUR	44	92601762	92958238	356476
EUR_23	30000	EUR	44	96873067	96946119	73052
EUR_23	30000	EUR	44	97516792	97643848	127056
EUR_23	30000	EUR	45	15926488	15963051	36563
EUR_23	30000	EUR	45	18850191	18885640	35449
EUR_23	30000	EUR	45	19316850	19544916	228066
EUR_23	30000	EUR	45	21586791	21973157	386366
EUR_23	30000	EUR	45	23849387	24132984	283597
EUR_23	30000	EUR	45	25018279	25033225	14946
EUR_23	30000	EUR	45	29836876	29907334	70458
EUR_23	30000	EUR	45	29960808	30107253	146445
EUR_23	30000	EUR	45	32469772	32532337	62565
EUR_23	30000	EUR	45	37289843	37455443	165600
EUR_23	30000	EUR	45	48540943	48602191	61248
EUR_23	30000	EUR	45	53195740	53215009	19269
EUR_23	30000	EUR	45	55283447	55557649	274202
EUR_23	30000	EUR	45	55683186	55935283	252097
EUR_23	30000	EUR	45	56606415	56695626	89211
EUR_23	30000	EUR	45	56981282	57026186	44904
EUR_23	30000	EUR	45	62427365	62539886	112521
EUR_23	30000	EUR	45	62584114	62820719	236605
EUR_23	30000	EUR	45	67051350	67063283	11933
EUR_23	30000	EUR	45	67726807	67879641	152834
EUR_23	30000	EUR	45	71347780	71460948	113168
EUR_23	30000	EUR	45	74609427	74823103	213676
EUR_23	30000	EUR	45	80700295	80813234	112939
EUR_23	30000	EUR	45	84271503	84372525	101022
EUR_23	30000	EUR	45	84634596	84859626	225030
EUR_23	30000	EUR	45	85810254	85965919	155665
EUR_23	30000	EUR	45	87069518	87079833	10315
EUR_23	30000	EUR	45	89337683	89463966	126283
EUR_23	30000	EUR	45	97100087	97478654	378567
EUR_23	30000	EUR	45	98187403	98216504	29101
EUR_24	30000	EUR	46	5922397	5971269	48872
EUR_24	30000	EUR	46	11926927	11927735	808
EUR_24	30000	EUR	46	15864253	16036609	172356
EUR_24	30000	EUR	46	16235802	16340550	104748
EUR_24	30000	EUR	46	19524348	19815522	291174
EUR_24	30000	EUR	46	22024903	22064725	39822
EUR_24	30000	EUR	46	23454655	23632090	177435
EUR_24	30000	EUR	46	28453419	28568059	114640
EUR_24	30000	EUR	46	29749217	29804612	55395
EUR_24	30000	EUR	46	39475823	39545103	69280
EUR_24	30000	EUR	46	44200642	44431264	230622
EUR_24	30000	EUR	46	45292333	45333059	40726
EUR_24	30000	EUR	46	48273976	48321534	47558
EUR_24	30000	EUR	46	48942765	49071287	128522
EUR_24	30000	EUR	46	49807803	50340188	532385
EUR_24	30000	EUR	46	50621631	50675343	53712
EUR_24	30000	EUR	46	52966223	53302464	336241
EUR_24	30000	EUR	46	60675915	60703119	27204
EUR_24	30000	EUR	46	60836692	60933571	96879
EUR_24	30000	EUR	46	62048759	62460553	411794
EUR_24	30000	EUR	46	64034761	64066021	31260
EUR_24	30000	EUR	46	67720425	67829293	108868
EUR_24	30000	EUR	46	68126213	68219989	93776
EUR_24	30000	EUR	46	69533022	69656422	123400
EUR_24	30000	EUR	46	71294860	71374978	80118
EUR_24	30000	EUR	46	84223686	84589581	365895
EUR_24	30000	EUR	46	86340983	86466441	125458
EUR_24	30000	EUR	46	93210081	93437672	227591
EUR_24	30000	EUR	46	97739562	97944812	205250
EUR_24	30000	EUR	47	618499	697581	79082
EUR_24	30000	EUR	47	4066689	4156369	89680
EUR_24	30000	EUR	47	5612289	5741613	129324
EUR_24	30000	EUR	47	10531119	10559629	28510
EUR_24	30000	EUR	47	11187362	11267811	80449
EUR_24	30000	EUR	47	12959122	12989272	30150
EUR_24	30000	EUR	47	17321152	17323735	2583
EUR_24	30000	EUR	47	19490258	19802409	312151
EUR_24	30000	EUR	47	33959989	34131064	171075
EUR_24	30000	EUR	47	43816300	43830917	14617
EUR_24	30000	EUR	47	44780031	44803559	23528
EUR_24	30000	EUR	47	48978592	49071287	92695
EUR_24	30000	EUR	47	49591055	49961812	370757
EUR_24	30000	EUR	47	54035533	54200124	164591
EUR_24	30000	EUR	47	56981282	57026186	44904
EUR_24	30000	EUR	47	57744838	57747881	3043
EUR_24	30000	EUR	47	62427365	62685357	257992
EUR_24	30000	EUR	47	66915791	67022791	107000
EUR_24	30000	EUR	47	67043600	67098584	54984
EUR_24	30000	EUR	47	84271016	84589581	318565
EUR_24	30000	EUR	47	96707027	97130504	423477
EUR_24	30000	EUR	47	97407632	97478654	71022
EUR_24	30000	EUR	47	97607910	97690675	82765
EUR_25	30000	EUR	48	4067245	4101969	34724
EUR_25	30000	EUR	48	5623952	5741613	117661
EUR_25	30000	EUR	48	13302325	13565189	262864
EUR_25	30000	EUR	48	17225383	17323735	98352
EUR_25	30000	EUR	48	19490258	19765406	275148
EUR_25	30000	EUR	48	19772407	19815522	43115
EUR_25	30000	EUR	48	23695264	23842450	147186
EUR_25	30000	EUR	48	29749217	29765658	16441
EUR_25	30000	EUR	48	30423096	30559727	136631
EUR_25	30000	EUR	48	31048766	31113036	64270
EUR_25	30000	EUR	48	43750662	43813419	62757
EUR_25	30000	EUR	48	48700664	48801513	100849
EUR_25	30000	EUR	48	49006754	49164811	158057
EUR_25	30000	EUR	48	49914410	50340188	425778
EUR_25	30000	EUR	48	51719606	52045718	326112
EUR_25	30000	EUR	48	54094408	54146876	52468
EUR_25	30000	EUR	48	61849129	61857137	8008
EUR_25	30000	EUR	48	64162479	64213081	50602
EUR_25	30000	EUR	48	64302697	64350135	47438
EUR_25	30000	EUR	48	68126213	68219989	93776
EUR_25	30000	EUR	48	72313374	72399948	86574
EUR_25	30000	EUR	48	83752999	83819773	66774
EUR_25	30000	EUR	48	84252820	84291822	39002
EUR_25	30000	EUR	48	84527801	84730925	203124
EUR_25	30000	EUR	48	96935175	96957114	21939
EUR_25	30000	EUR	49	11155402	11267811	112409
EUR_25	30000	EUR	49	12635579	12649905	14326
EUR_25	30000	EUR	49	13486470	13493099	6629
EUR_25	30000	EUR	49	19205162	19465227	260065
EUR_25	30000	EUR	49	28909134	28912719	3585
EUR_25	30000	EUR	49	30665466	30768369	102903
EUR_25	30000	EUR	49	31342191	31358443	16252
EUR_25	30000	EUR	49	43750662	43813419	62757
EUR_25	30000	EUR	49	46821026	46998835	177809
EUR_25	30000	EUR	49	48547355	48602191	54836
EUR_25	30000	EUR	49	51819962	51826252	6290
EUR_25	30000	EUR	49	54163206	54185177	21971
EUR_25	30000	EUR	49	56767806	56867904	100098
EUR_25	30000	EUR	49	62480689	62662553	181864
EUR_25	30000	EUR	49	63947203	64060264	113061
EUR_25	30000	EUR	49	66848687	66882708	34021
EUR_25	30000	EUR	49	67516377	67550551	34174
EUR_25	30000	EUR	49	70314329	70323506	9177
EUR_25	30000	EUR	49	70425266	70471952	46686
EUR_25	30000	EUR	49	74609427	74682927	73500
EUR_25	30000	EUR	49	77940158	77946857	6699
EUR_25	30000	EUR	49	83543294	83583418	40124
EUR_25	30000	EUR	49	95645985	95706836	60851
EUR_25	30000	EUR	49	96707027	97130504	423477
EUR_26	30000	EUR	50	2267390	2417674	150284
EUR_26	30000	EUR	50	8916078	8958572	42494
EUR_26	30000	EUR	50	10444060	10559629	115569
EUR_26	30000	EUR	50	11221129	11267811	46682
EUR_26	30000	EUR	50	11804630	11836160	31530
EUR_26	30000	EUR	50	16872759	16905629	32870
EUR_26	30000	EUR	50	22370098	22698639	328541
EUR_26	30000	EUR	50	25625985	25633422	7437
EUR_26	30000	EUR	50	30982404	31134052	151648
EUR_26	30000	EUR	50	35895719	35972564	76845
EUR_26	30000	EUR	50	41449292	41509643	60351
EUR_26	30000	EUR	50	41698837	41826713	127876
EUR_26	30000	EUR	50	44183609	44244547	60938
EUR_26	30000	EUR	50	49862547	49901292	38745
EUR_26	30000	EUR	50	62607089	62686121	79032
EUR_26	30000	EUR	50	63258645	63264053	5408
EUR_26	30000	EUR	50	63354466	63409484	55018
EUR_26	30000	EUR	50	67529684	67733569	203885
EUR_26	30000	EUR	50	71153579	71427923	274344
EUR_26	30000	EUR	50	84252820	84291822	39002
EUR_26	30000	EUR	50	88064488	88315643	251155
EUR_26	30000	EUR	50	93579639	93686534	106895
EUR_26	30000	EUR	50	96935175	96957114	21939
EUR_26	30000	EUR	51	5359828	5407808	47980
EUR_26	30000	EUR	51	10444060	10559629	115569
EUR_26	30000	EUR	51	11221129	11267811	46682
EUR_26	30000	EUR	51	11804630	11836160	31530
EUR_26	30000	EUR	51	12741429	12870468	129039
EUR_26	30000	EUR	51	12980691	12987083	6392
EUR_26	30000	EUR	51	13096243	13191657	95414
EUR_26	30000	EUR	51	19189424	19205647	16223
EUR_26	30000	EUR	51	19445931	19450661	4730
EUR_26	30000	EUR	51	21705358	21973157	267799
EUR_26	30000	EUR	51	27566433	27654115	87682
EUR_26	30000	EUR	51	28909134	28912719	3585
EUR_26	30000	EUR	51	30128454	30224445	95991
EUR_26	30000	EUR	51	30382455	30429186	46731
EUR_26	30000	EUR	51	31204110	31446569	242459
EUR_26	30000	EUR	51	33352525	33405018	52493
EUR_26	30000	EUR	51	40559832	40561321	1489
EUR_26	30000	EUR	51	41698837	41826713	127876
EUR_26	30000	EUR	51	44497681	44701885	204204
EUR_26	30000	EUR	51	47888202	48027620	139418
EUR_26	30000	EUR	51	50524394	50562004	37610
EUR_26	30000	EUR	51	56642327	56661029	18702
EUR_26	30000	EUR	51	60697771	60881646	183875
EUR_26	30000	EUR	51	62102957	62801895	698938
EUR_26	30000	EUR	51	62808129	62863488	55359
EUR_26	30000	EUR	51	64569161	64648825	79664
EUR_26	30000	EUR	51	67529684	67733569	203885
EUR_26	30000	EUR	51	73483646	73508952	25306
EUR_26	30000	EUR	51	73920589	74226288	305699
EUR_26	30000	EUR	51	74345860	74386200	40340
EUR_26	30000	EUR	51	78312824	78326890	14066
EUR_26	30000	EUR	51	79636078	79638765	2687
EUR_26	30000	EUR	51	84495585	84737569	241984
EUR_26	30000	EUR	51	96344658	96969240	624582
EUR_27	30000	EUR	52	0	38454	38454
EUR_27	30000	EUR	52	4066689	4332737	266048
EUR_27	30000	EUR	52	8864829	8958572	93743
EUR_27	30000	EUR	52	13242637	13485576	242939
EUR_27	30000	EUR	52	14713216	14909313	196097
EUR_27	30000	EUR	52	15949210	16036609	87399
EUR_27	30000	EUR	52	16235802	16340550	104748
EUR_27	30000	EUR	52	19191247	19392515	201268
EUR_27	30000	EUR	52	23695264	23842450	147186
EUR_27	30000	EUR	52	25018279	25033225	14946
EUR_27	30000	EUR	52	26757616	26868609	110993
EUR_27	30000	EUR	52	29201265	29403219	201954
EUR_27	30000	EUR	52	30665466	31134052	468586
EUR_27	30000	EUR	52	37289843	37455443	165600
EUR_27	30000	EUR	52	39537711	39545103	7392
EUR_27	30000	EUR	52	40040672	40284557	243885
EUR_27	30000	EUR	52	46167446	46287015	119569
EUR_27	30000	EUR	52	48240560	48246225	5665
EUR_27	30000	EUR	52	49862547	49901292	38745
EUR_27	30000	EUR	52	50295201	50482087	186886
EUR_27	30000	EUR	52	50807678	50926023	118345
EUR_27	30000	EUR	52	53081737	53085025	3288
EUR_27	30000	EUR	52	54035533	54138742	103209
EUR_27	30000	EUR	52	54171480	54211157	39677
EUR_27	30000	EUR	52	57959433	58064278	104845
EUR_27	30000	EUR	52	60697771	60881646	183875
EUR_27	30000	EUR	52	62266230	62456836	190606
EUR_27	30000	EUR	52	64632417	65025826	393409
EUR_27	30000	EUR	52	67720425	68059654	339229
EUR_27	30000	EUR	52	84040452	84198948	158496
EUR_27	30000	EUR	52	96429121	96581202	152081
EUR_27	30000	EUR	52	96954897	97469085	514188
EUR_27	30000	EUR	53	2458971	2636526	177555
EUR_27	30000	EUR	53	5515391	5560949	45558
EUR_27	30000	EUR	53	12592297	12592393	96
EUR_27	30000	EUR	53	13070331	13111111	40780
EUR_27	30000	EUR	53	16265965	16340550	74585
EUR_27	30000	EUR	53	19568716	19815522	246806
EUR_27	30000	EUR	53	21384205	21428911	44706
EUR_27	30000	EUR	53	28909134	28912719	3585
EUR_27	30000	EUR	53	30423096	30559727	136631
EUR_27	30000	EUR	53	31061901	31226316	164415
EUR_27	30000	EUR	53	39537711	39545103	7392
EUR_27	30000	EUR	53	40040672	40284557	243885
EUR_27	30000	EUR	53	41449292	41517844	68552
EUR_27	30000	EUR	53	43256147	43477546	221399
EUR_27	30000	EUR	53	44361001	44404700	43699
EUR_27	30000	EUR	53	48793399	48832663	39264
EUR_27	30000	EUR	53	50505922	50514335	8413
EUR_27	30000	EUR	53	50618884	50682125	63241
EUR_27	30000	EUR	53	54094408	54258186	163778
EUR_27	30000	EUR	53	55727235	55744919	17684
EUR_27	30000	EUR	53	60391758	60626445	234687
EUR_27	30000	EUR	53	62781664	62797882	16218
EUR_27	30000	EUR	53	62860595	62872790	12195
EUR_27	30000	EUR	53	67651819	67724777	72958
EUR_27	30000	EUR	53	68126213	68219989	93776
EUR_27	30000	EUR	53	69004995	69315282	310287
EUR_27	30000	EUR	53	69530905	69699605	168700
EUR_27	30000	EUR	53	70094238	70144147	49909
EUR_27	30000	EUR	53	79917556	79977985	60429
EUR_27	30000	EUR	53	81962315	82042725	80410
EUR_27	30000	EUR	53	93926019	93983424	57405
EUR_27	30000	EUR	53	97212058	97478654	266596
EUR_28	30000	EUR	54	0	809	809
EUR_28	30000	EUR	54	2640024	2868801	228777
EUR_28	30000	EUR	54	11187362	11243926	56564
EUR_28	30000	EUR	54	12585693	12631962	46269
EUR_28	30000	EUR	54	15697742	15701244	3502
EUR_28	30000	EUR	54	19023843	19050864	27021
EUR_28	30000	EUR	54	21164886	21168829	3943
EUR_28	30000	EUR	54	21179486	21230787	51301
EUR_28	30000	EUR	54	21282427	21445145	162718
EUR_28	30000	EUR	54	23849387	24132984	283597
EUR_28	30000	EUR	54	30382455	30559727	177272
EUR_28	30000	EUR	54	43750662	43785095	34433
EUR_28	30000	EUR	54	45719414	45742393	22979
EUR_28	30000	EUR	54	46891052	46956192	65140
EUR_28	30000	EUR	54	48891623	48952633	61010
EUR_28	30000	EUR	54	50208059	50340188	132129
EUR_28	30000	EUR	54	50505922	50514335	8413
EUR_28	30000	EUR	54	50618884	50682125	63241
EUR_28	30000	EUR	54	54035533	54138742	103209
EUR_28	30000	EUR	54	54171480	54211157	39677
EUR_28	30000	EUR	54	55365672	55376432	10760
EUR_28	30000	EUR	54	63156537	63227147	70610
EUR_28	30000	EUR	54	67726807	67777415	50608
EUR_28	30000	EUR	54	68047846	68053372	5526
EUR_28	30000	EUR	54	71294860	71374978	80118
EUR_28	30000	EUR	54	78312824	78326890	14066
EUR_28	30000	EUR	54	79917556	79977985	60429
EUR_28	30000	EUR	54	84271016	84589581	318565
EUR_28	30000	EUR	54	86183232	86324407	141175
EUR_28	30000	EUR	54	92657968	92683228	25260
EUR_28	30000	EUR	54	95964529	95999039	34510
EUR_28	30000	EUR	54	96454365	96969240	514875
EUR_28	30000	EUR	54	97306339	97335488	29149
EUR_28	30000	EUR	55	9913	38454	28541
EUR_28	30000	EUR	55	1550996	1622588	71592
EUR_28	30000	EUR	55	11155402	11267811	112409
EUR_28	30000	EUR	55	12999504	13067942	68438
EUR_28	30000	EUR	55	19445931	19527944	82013
EUR_28	30000	EUR	55	21160526	21190857	30331
EUR_28	30000	EUR	55	31091633	31263629	171996
EUR_28	30000	EUR	55	39101936	39182279	80343
EUR_28	30000	EUR	55	41327269	41386596	59327
EUR_28	30000	EUR	55	48095070	48145084	50014
EUR_28	30000	EUR	55	50532431	50604242	71811
EUR_28	30000	EUR	55	50889308	50964254	74946
EUR_28	30000	EUR	55	54298907	54310566	11659
EUR_28	30000	EUR	55	59931426	59938917	7491
EUR_28	30000	EUR	55	62427365	62685357	257992
EUR_28	30000	EUR	55	64007129	64060264	53135
EUR_28	30000	EUR	55	65392456	65439431	46975
EUR_28	30000	EUR	55	67516377	67550551	34174
EUR_28	30000	EUR	55	73471543	73621956	150413
EUR_28	30000	EUR	55	76212053	76354315	142262
EUR_28	30000	EUR	55	78128495	78236096	107601
EUR_28	30000	EUR	55	79636078	79848351	212273
EUR_28	30000	EUR	55	82896432	82994729	98297
EUR_28	30000	EUR	55	86417646	86479474	61828
EUR_28	30000	EUR	55	86998307	87018305	19998
EUR_28	30000	EUR	55	96454365	96969240	514875
EUR_28	30000	EUR	55	97306339	97335488	29149
EUR_28	30000	EUR	55	97794614	97798893	4279
EUR_28	30000	EUR	55	97979927	98017859	37932
EUR_29	30000	EUR	56	5399268	5408555	9287
EUR_29	30000	EUR	56	5905143	5971269	66126
EUR_29	30000	EUR	56	8864829	8958572	93743
EUR_29	30000	EUR	56	9561534	9647147	85613
EUR_29	30000	EUR	56	10162900	10265441	102541
EUR_29	30000	EUR	56	11187362	11267811	80449
EUR_29	30000	EUR	56	12981357	13067942	86585
EUR_29	30000	EUR	56	15678424	15857544	179120
EUR_29	30000	EUR	56	16872759	16989582	116823
EUR_29	30000	EUR	56	19528439	19815522	287083
EUR_29	30000	EUR	56	20925981	20952589	26608
EUR_29	30000	EUR	56	39475823	39545103	69280
EUR_29	30000	EUR	56	41082532	41386596	304064
EUR_29	30000	EUR	56	48793399	48832663	39264
EUR_29	30000	EUR	56	52677619	52686699	9080
EUR_29	30000	EUR	56	54233402	54294851	61449
EUR_29	30000	EUR	56	54690356	54696544	6188
EUR_29	30000	EUR	56	62266230	62266246	16
EUR_29	30000	EUR	56	62495143	62723125	227982
EUR_29	30000	EUR	56	64559645	64648825	89180
EUR_29	30000	EUR	56	80106200	80125347	19147
EUR_29	30000	EUR	56	80307017	80378472	71455
EUR_29	30000	EUR	56	84736507	84743813	7306
EUR_29	30000	EUR	56	96518753	96606510	87757
EUR_29	30000	EUR	57	0	38454	38454
EUR_29	30000	EUR	57	5399268	5408555	9287
EUR_29	30000	EUR	57	12959122	12989272	30150
EUR_29	30000	EUR	57	21618309	21813506	195197
EUR_29	30000	EUR	57	28909134	28912719	3585
EUR_29	30000	EUR	57	30912874	31464998	552124
EUR_29	30000	EUR	57	33352525	33355723	3198
EUR_29	30000	EUR	57	43750662	43813419	62757
EUR_29	30000	EUR	57	46821026	46823389	2363
EUR_29	30000	EUR	57	46994412	46998835	4423
EUR_29	30000	EUR	57	48281196	48289227	8031
EUR_29	30000	EUR	57	49589824	50063201	473377
EUR_29	30000	EUR	57	54201120	54258186	57066
EUR_29	30000	EUR	57	55891681	55941600	49919
EUR_29	30000	EUR	57	59129042	59164124	35082
EUR_29	30000	EUR	57	60314986	60413741	98755
EUR_29	30000	EUR	57	60675915	60703119	27204
EUR_29	30000	EUR	57	60755631	60810384	54753
EUR_29	30000	EUR	57	62679237	62680258	1021
EUR_29	30000	EUR	57	63010595	63041174	30579
EUR_29	30000	EUR	57	63239582	63647089	407507
EUR_29	30000	EUR	57	75059598	75227717	168119
EUR_29	30000	EUR	57	78278359	78281355	2996
EUR_29	30000	EUR	57	84040452	84198948	158496
EUR_29	30000	EUR	57	84736507	84743813	7306
EUR_29	30000	EUR	57	87069518	87192258	122740
EUR_29	30000	EUR	57	93579639	93686534	106895
EUR_29	30000	EUR	57	96344658	96425362	80704
EUR_29	30000	EUR	57	97137184	97229983	92799
EUR_29	30000	EUR	57	97398476	97544557	146081
EUR_30	30000	EUR	58	11221129	11267811	46682
EUR_30	30000	EUR	58	12000620	12020001	19381
EUR_30	30000	EUR	58	12166455	12231489	65034
EUR_30	30000	EUR	58	12992838	13085270	92432
EUR_30	30000	EUR	58	14026402	14461446	435044
EUR_30	30000	EUR	58	15678424	15857544	179120
EUR_30	30000	EUR	58	16872759	16989582	116823
EUR_30	30000	EUR	58	21117076	21160897	43821
EUR_30	30000	EUR	58	21935834	21956345	20511
EUR_30	30000	EUR	58	27236668	27471494	234826
EUR_30	30000	EUR	58	27834349	27890638	56289
EUR_30	30000	EUR	58	41449292	41509643	60351
EUR_30	30000	EUR	58	43816300	43852571	36271
EUR_30	30000	EUR	58	44183609	44244547	60938
EUR_30	30000	EUR	58	48311900	48321534	9634
EUR_30	30000	EUR	58	50214714	50344415	129701
EUR_30	30000	EUR	58	56606415	56661029	54614
EUR_30	30000	EUR	58	62196179	62520941	324762
EUR_30	30000	EUR	58	63947203	64060264	113061
EUR_30	30000	EUR	58	69976346	70136356	160010
EUR_30	30000	EUR	58	74609427	74823103	213676
EUR_30	30000	EUR	58	77940158	77981834	41676
EUR_30	30000	EUR	58	81834623	81951234	116611
EUR_30	30000	EUR	58	82141070	82248911	107841
EUR_30	30000	EUR	58	84495585	84623210	127625
EUR_30	30000	EUR	58	86183232	86324407	141175
EUR_30	30000	EUR	58	93210081	93437672	227591
EUR_30	30000	EUR	58	96215188	96313082	97894
EUR_30	30000	EUR	59	228095	317557	89462
EUR_30	30000	EUR	59	12592297	12592393	96
EUR_30	30000	EUR	59	18850191	18885640	35449
EUR_30	30000	EUR	59	21384205	21428911	44706
EUR_30	30000	EUR	59	29749217	29765658	16441
EUR_30	30000	EUR	59	30423096	30559727	136631
EUR_30	30000	EUR	59	31048766	31088907	40141
EUR_30	30000	EUR	59	31969356	31978344	8988
EUR_30	30000	EUR	59	39537711	39545103	7392
EUR_30	30000	EUR	59	43750662	43813419	62757
EUR_30	30000	EUR	59	45330879	45413157	82278
EUR_30	30000	EUR	59	50537720	50543169	5449
EUR_30	30000	EUR	59	54156560	54429543	272983
EUR_30	30000	EUR	59	54447874	54728631	280757
EUR_30	30000	EUR	59	60836692	60933571	96879
EUR_30	30000	EUR	59	64559645	64648825	89180
EUR_30	30000	EUR	59	69612781	69699605	86824
EUR_30	30000	EUR	59	70094238	70144147	49909
EUR_30	30000	EUR	59	73245291	73299538	54247
EUR_30	30000	EUR	59	78278359	78281355	2996
EUR_30	30000	EUR	59	80757955	80896589	138634
EUR_30	30000	EUR	59	95540547	95706836	166289
EUR_30	30000	EUR	59	96344658	96460323	115665
EUR_31	20000	EUR	60	0	38454	38454
EUR_31	20000	EUR	60	292297	305368	13071
EUR_31	20000	EUR	60	7801499	7901153	99654
EUR_31	20000	EUR	60	10310816	10559629	248813
EUR_31	20000	EUR	60	11221129	11267811	46682
EUR_31	20000	EUR	60	12957537	12972366	14829
EUR_31	20000	EUR	60	15697742	15701244	3502
EUR_31	20000	EUR	60	16997514	17323735	326221
EUR_31	20000	EUR	60	19771179	19815522	44343
EUR_31	20000	EUR	60	21414350	21547886	133536
EUR_31	20000	EUR	60	21574468	21582697	8229
EUR_31	20000	EUR	60	21887939	21936915	48976
EUR_31	20000	EUR	60	23919670	24053709	134039
EUR_31	20000	EUR	60	28447913	28554899	106986
EUR_31	20000	EUR	60	29749217	29774921	25704
EUR_31	20000	EUR	60	29853109	29884548	31439
EUR_31	20000	EUR	60	31118293	31265497	147204
EUR_31	20000	EUR	60	31340450	31464998	124548
EUR_31	20000	EUR	60	31810551	31836096	25545
EUR_31	20000	EUR	60	39475823	39545103	69280
EUR_31	20000	EUR	60	41277406	41386596	109190
EUR_31	20000	EUR	60	47646745	47728980	82235
EUR_31	20000	EUR	60	48993613	49139016	145403
EUR_31	20000	EUR	60	49683183	49823430	140247
EUR_31	20000	EUR	60	50079988	50086485	6497
EUR_31	20000	EUR	60	50213660	50246763	33103
EUR_31	20000	EUR	60	50316944	50340188	23244
EUR_31	20000	EUR	60	53185452	53248662	63210
EUR_31	20000	EUR	60	60391758	60473482	81724
EUR_31	20000	EUR	60	62352839	62421852	69013
EUR_31	20000	EUR	60	62584114	62723208	139094
EUR_31	20000	EUR	60	62781664	63092804	311140
EUR_31	20000	EUR	60	63345194	63367008	21814
EUR_31	20000	EUR	60	64007129	64060264	53135
EUR_31	20000	EUR	60	64843420	64968332	124912
EUR_31	20000	EUR	60	67726807	68219989	493182
EUR_31	20000	EUR	60	71214523	71270702	56179
EUR_31	20000	EUR	60	74609427	74673535	64108
EUR_31	20000	EUR	60	78312824	78319054	6230
EUR_31	20000	EUR	60	80106200	80125347	19147
EUR_31	20000	EUR	60	80307017	80378472	71455
EUR_31	20000	EUR	60	81329834	81395863	66029
EUR_31	20000	EUR	60	84271016	84487039	216023
EUR_31	20000	EUR	60	84581093	84609377	28284
EUR_31	20000	EUR	60	86974749	87115837	141088
EUR_31	20000	EUR	60	92728134	92911223	183089
EUR_31	20000	EUR	60	96505046	96551349	46303
EUR_31	20000	EUR	60	96664028	96969240	305212
EUR_31	20000	EUR	61	5612289	5741613	129324
EUR_31	20000	EUR	61	12957537	13085270	127733
EUR_31	20000	EUR	61	13845423	13904570	59147
EUR_31	20000	EUR	61	15585791	15632929	47138
EUR_31	20000	EUR	61	15697742	15701244	3502
EUR_31	20000	EUR	61	15903220	16019493	116273
EUR_31	20000	EUR	61	17056564	17323735	267171
EUR_31	20000	EUR	61	19445931	19447994	2063
EUR_31	20000	EUR	61	19720323	19815522	95199
EUR_31	20000	EUR	61	23614282	23695974	81692
EUR_31	20000	EUR	61	28447913	28454759	6846
EUR_31	20000	EUR	61	29146149	29190448	44299
EUR_31	20000	EUR	61	29201265	29403219	201954
EUR_31	20000	EUR	61	43726568	43817028	90460
EUR_31	20000	EUR	61	44000162	44062496	62334
EUR_31	20000	EUR	61	44319048	44353481	34433
EUR_31	20000	EUR	61	47624392	47758303	133911
EUR_31	20000	EUR	61	48909503	48987001	77498
EUR_31	20000	EUR	61	50199687	50220042	20355
EUR_31	20000	EUR	61	50446207	50560553	114346
EUR_31	20000	EUR	61	50644699	50682125	37426
EUR_31	20000	EUR	61	53307869	53413728	105859
EUR_31	20000	EUR	61	60314986	60367058	52072
EUR_31	20000	EUR	61	61563808	61565203	1395
EUR_31	20000	EUR	61	62266230	62266246	16
EUR_31	20000	EUR	61	62495143	62723125	227982
EUR_31	20000	EUR	61	63177292	63277354	100062
EUR_31	20000	EUR	61	63345194	63367008	21814
EUR_31	20000	EUR	61	64007129	64060264	53135
EUR_31	20000	EUR	61	64204604	64213081	8477
EUR_31	20000	EUR	61	64569161	64648825	79664
EUR_31	20000	EUR	61	69533022	69656422	123400
EUR_31	20000	EUR	61	70090968	70143173	52205
EUR_31	20000	EUR	61	70314329	70323506	9177
EUR_31	20000	EUR	61	70425266	70471952	46686
EUR_31	20000	EUR	61	71411050	71427923	16873
EUR_31	20000	EUR	61	80106200	80125347	19147
EUR_31	20000	EUR	61	80307017	80378472	71455
EUR_31	20000	EUR	61	84307433	84446481	139048
EUR_31	20000	EUR	61	85268776	85314478	45702
EUR_31	20000	EUR	61	93241661	93437672	196011
EUR_31	20000	EUR	61	93789189	93971419	182230
EUR_31	20000	EUR	61	95681624	95884049	202425
EUR_32	20000	EUR	62	171404	187050	15646
EUR_32	20000	EUR	62	293630	317557	23927
EUR_32	20000	EUR	62	8004685	8026219	21534
EUR_32	20000	EUR	62	9628779	9647147	18368
EUR_32	20000	EUR	62	15920084	16041545	121461
EUR_32	20000	EUR	62	19373601	19465227	91626
EUR_32	20000	EUR	62	21282427	21582697	300270
EUR_32	20000	EUR	62	22370098	22371767	1669
EUR_32	20000	EUR	62	23308637	23325355	16718
EUR_32	20000	EUR	62	26802769	27028137	225368
EUR_32	20000	EUR	62	37958228	37981646	23418
EUR_32	20000	EUR	62	39499118	39538059	38941
EUR_32	20000	EUR	62	41294820	41386596	91776
EUR_32	20000	EUR	62	43768000	43813419	45419
EUR_32	20000	EUR	62	47600170	47701270	101100
EUR_32	20000	EUR	62	47721867	47761411	39544
EUR_32	20000	EUR	62	50075754	50079837	4083
EUR_32	20000	EUR	62	50214714	50600707	385993
EUR_32	20000	EUR	62	53914631	53938830	24199
EUR_32	20000	EUR	62	56606415	56661029	54614
EUR_32	20000	EUR	62	59025323	59087449	62126
EUR_32	20000	EUR	62	62442246	62456836	14590
EUR_32	20000	EUR	62	62976599	63021458	44859
EUR_32	20000	EUR	62	63404118	63430652	26534
EUR_32	20000	EUR	62	63510487	63775905	265418
EUR_32	20000	EUR	62	67726807	67922192	195385
EUR_32	20000	EUR	62	69273103	69296795	23692
EUR_32	20000	EUR	62	70178120	70180545	2425
EUR_32	20000	EUR	62	74609427	74663374	53947
EUR_32	20000	EUR	62	79804244	79813758	9514
EUR_32	20000	EUR	62	80346144	80378472	32328
EUR_32	20000	EUR	62	82392396	82400999	8603
EUR_32	20000	EUR	62	84586314	84597943	11629
EUR_32	20000	EUR	62	87069518	87079833	10315
EUR_32	20000	EUR	62	92657968	92893775	235807
EUR_32	20000	EUR	62	93364712	93374394	9682
EUR_32	20000	EUR	62	93579639	93661251	81612
EUR_32	20000	EUR	62	95665719	95725152	59433
EUR_32	20000	EUR	62	96622952	96969240	346288
EUR_32	20000	EUR	62	97184785	97235404	50619
EUR_32	20000	EUR	63	0	11076	11076
EUR_32	20000	EUR	63	2267390	2436497	169107
EUR_32	20000	EUR	63	8922196	8953694	31498
EUR_32	20000	EUR	63	10310816	10371329	60513
EUR_32	20000	EUR	63	12195294	12394574	199280
EUR_32	20000	EUR	63	12909514	12975665	66151
EUR_32	20000	EUR	63	21299608	21392501	92893
EUR_32	20000	EUR	63	23348628	23374530	25902
EUR_32	20000	EUR	63	23675106	23744358	69252
EUR_32	20000	EUR	63	24052627	24070707	18080
EUR_32	20000	EUR	63	24713899	24800868	86969
EUR_32	20000	EUR	63	26820043	26827636	7593
EUR_32	20000	EUR	63	28447913	28554899	106986
EUR_32	20000	EUR	63	29871842	29884548	12706
EUR_32	20000	EUR	63	44556562	44692189	135627
EUR_32	20000	EUR	63	45919475	46077353	157878
EUR_32	20000	EUR	63	48109321	48354749	245428
EUR_32	20000	EUR	63	48540943	48602191	61248
EUR_32	20000	EUR	63	48894894	48952633	57739
EUR_32	20000	EUR	63	49807803	50340188	532385
EUR_32	20000	EUR	63	50537759	50573069	35310
EUR_32	20000	EUR	63	53307869	53323885	16016
EUR_32	20000	EUR	63	60577974	60618684	40710
EUR_32	20000	EUR	63	62060602	62076335	15733
EUR_32	20000	EUR	63	62266230	62275522	9292
EUR_32	20000	EUR	63	62371186	62664593	293407
EUR_32	20000	EUR	63	62672738	62791767	119029
EUR_32	20000	EUR	63	64007129	64060264	53135
EUR_32	20000	EUR	63	64635938	64775972	140034
EUR_32	20000	EUR	63	67529684	67733569	203885
EUR_32	20000	EUR	63	67996165	68234683	238518
EUR_32	20000	EUR	63	69063156	69087335	24179
EUR_32	20000	EUR	63	69976346	70136356	160010
EUR_32	20000	EUR	63	70406536	70442419	35883
EUR_32	20000	EUR	63	71108569	71336069	227500
EUR_32	20000	EUR	63	73920589	74226288	305699
EUR_32	20000	EUR	63	74345860	74386200	40340
EUR_32	20000	EUR	63	80307017	80378472	71455
EUR_32	20000	EUR	63	80774687	80831869	57182
EUR_32	20000	EUR	63	84586314	84597943	11629
EUR_32	20000	EUR	63	86459570	86466441	6871
EUR_32	20000	EUR	63	93177388	93213384	35996
EUR_32	20000	EUR	63	93609865	93654906	45041
EUR_32	20000	EUR	63	95549067	95706836	157769
EUR_32	20000	EUR	63	97120986	97188820	67834
EUR_33	20000	EUR	64	19482	38454	18972
EUR_33	20000	EUR	64	5515391	5560949	45558
EUR_33	20000	EUR	64	10310816	10559629	248813
EUR_33	20000	EUR	64	13473030	13550872	77842
EUR_33	20000	EUR	64	15678424	15764951	86527
EUR_33	20000	EUR	64	15783413	15857544	74131
EUR_33	20000	EUR	64	16235802	16340550	104748
EUR_33	20000	EUR	64	19490258	19640640	150382
EUR_33	20000	EUR	64	21489581	21724233	234652
EUR_33	20000	EUR	64	21771683	21914523	142840
EUR_33	20000	EUR	64	21975735	22064725	88990
EUR_33	20000	EUR	64	23414479	23438353	23874
EUR_33	20000	EUR	64	28447913	28554899	106986
EUR_33	20000	EUR	64	29146149	29190448	44299
EUR_33	20000	EUR	64	29201265	29403219	201954
EUR_33	20000	EUR	64	29749217	29751787	2570
EUR_33	20000	EUR	64	29885100	30020785	135685
EUR_33	20000	EUR	64	31061901	31134052	72151
EUR_33	20000	EUR	64	44233876	44244547	10671
EUR_33	20000	EUR	64	44422772	44641229	218457
EUR_33	20000	EUR	64	45296556	45413157	116601
EUR_33	20000	EUR	64	47588227	47619485	31258
EUR_33	20000	EUR	64	47800452	47867455	67003
EUR_33	20000	EUR	64	48777473	48788773	11300
EUR_33	20000	EUR	64	49018324	49139016	120692
EUR_33	20000	EUR	64	49139324	49164811	25487
EUR_33	20000	EUR	64	50151559	50299995	148436
EUR_33	20000	EUR	64	51819962	51826252	6290
EUR_33	20000	EUR	64	56606415	56688585	82170
EUR_33	20000	EUR	64	56981282	57026186	44904
EUR_33	20000	EUR	64	60612044	60623780	11736
EUR_33	20000	EUR	64	61881873	62262900	381027
EUR_33	20000	EUR	64	62455976	62546944	90968
EUR_33	20000	EUR	64	62672738	63021458	348720
EUR_33	20000	EUR	64	66915791	67022791	107000
EUR_33	20000	EUR	64	67043600	67371632	328032
EUR_33	20000	EUR	64	67726807	67861249	134442
EUR_33	20000	EUR	64	71153579	71427923	274344
EUR_33	20000	EUR	64	79636078	79662887	26809
EUR_33	20000	EUR	64	79744728	79815448	70720
EUR_33	20000	EUR	64	80700295	80813234	112939
EUR_33	20000	EUR	64	80829772	80896500	66728
EUR_33	20000	EUR	64	81906745	81951234	44489
EUR_33	20000	EUR	64	84133095	84136758	3663
EUR_33	20000	EUR	64	85268776	85314478	45702
EUR_33	20000	EUR	64	93639360	93686534	47174
EUR_33	20000	EUR	65	5865668	5891953	26285
EUR_33	20000	EUR	65	12195294	12351606	156312
EUR_33	20000	EUR	65	12741429	12832004	90575
EUR_33	20000	EUR	65	13471709	13549834	78125
EUR_33	20000	EUR	65	16925040	17152004	226964
EUR_33	20000	EUR	65	21164886	21168829	3943
EUR_33	20000	EUR	65	21467411	21549370	81959
EUR_33	20000	EUR	65	23614282	23655464	41182
EUR_33	20000	EUR	65	23831885	23853580	21695
EUR_33	20000	EUR	65	24713899	24800868	86969
EUR_33	20000	EUR	65	27030183	27120057	89874
EUR_33	20000	EUR	65	29201265	29403219	201954
EUR_33	20000	EUR	65	39475823	39537203	61380
EUR_33	20000	EUR	65	40211027	40249065	38038
EUR_33	20000	EUR	65	44351028	44353481	2453
EUR_33	20000	EUR	65	45719414	45722822	3408
EUR_33	20000	EUR	65	46821026	46892165	71139
EUR_33	20000	EUR	65	47874821	48273370	398549
EUR_33	20000	EUR	65	48942765	49139016	196251
EUR_33	20000	EUR	65	49422646	49501602	78956
EUR_33	20000	EUR	65	50079988	50086485	6497
EUR_33	20000	EUR	65	50468145	50607406	139261
EUR_33	20000	EUR	65	56739090	56867904	128814
EUR_33	20000	EUR	65	59794583	59870587	76004
EUR_33	20000	EUR	65	60360602	60618684	258082
EUR_33	20000	EUR	65	62482898	62546166	63268
EUR_33	20000	EUR	65	62570596	62648920	78324
EUR_33	20000	EUR	65	62707428	62886738	179310
EUR_33	20000	EUR	65	64018404	64060264	41860
EUR_33	20000	EUR	65	64275342	64277727	2385
EUR_33	20000	EUR	65	66667736	66867964	200228
EUR_33	20000	EUR	65	67581165	67629756	48591
EUR_33	20000	EUR	65	67669977	67733569	63592
EUR_33	20000	EUR	65	71343174	71430180	87006
EUR_33	20000	EUR	65	80852781	80961424	108643
EUR_33	20000	EUR	65	82777601	83035646	258045
EUR_33	20000	EUR	65	93210081	93297339	87258
EUR_33	20000	EUR	65	96743876	96969240	225364
EUR_33	20000	EUR	65	97184785	97321820	137035
EUR_34	20000	EUR	66	24100	38454	14354
EUR_34	20000	EUR	66	5905143	5971269	66126
EUR_34	20000	EUR	66	10310816	10371329	60513
EUR_34	20000	EUR	66	11221129	11267811	46682
EUR_34	20000	EUR	66	12957537	12972366	14829
EUR_34	20000	EUR	66	15697742	15701244	3502
EUR_34	20000	EUR	66	16997514	17323735	326221
EUR_34	20000	EUR	66	19771179	19815522	44343
EUR_34	20000	EUR	66	21414350	21547886	133536
EUR_34	20000	EUR	66	21574468	21582697	8229
EUR_34	20000	EUR	66	21887939	21936915	48976
EUR_34	20000	EUR	66	23919670	24053709	134039
EUR_34	20000	EUR	66	28447913	28554899	106986
EUR_34	20000	EUR	66	29749217	29774921	25704
EUR_34	20000	EUR	66	29853109	29884548	31439
EUR_34	20000	EUR	66	31118293	31265497	147204
EUR_34	20000	EUR	66	31340450	31464998	124548
EUR_34	20000	EUR	66	31810551	31836096	25545
EUR_34	20000	EUR	66	41747380	41782913	35533
EUR_34	20000	EUR	66	45321666	45413157	91491
EUR_34	20000	EUR	66	48181642	48225224	43582
EUR_34	20000	EUR	66	48773745	48823805	50060
EUR_34	20000	EUR	66	49025304	49042187	16883
EUR_34	20000	EUR	66	49043466	49075471	32005
EUR_34	20000	EUR	66	50094550	50340188	245638
EUR_34	20000	EUR	66	50594292	50682125	87833
EUR_34	20000	EUR	66	51721135	51756063	34928
EUR_34	20000	EUR	66	53359909	53413728	53819
EUR_34	20000	EUR	66	54352751	54424698	71947
EUR_34	20000	EUR	66	54732365	54740924	8559
EUR_34	20000	EUR	66	59025323	59087449	62126
EUR_34	20000	EUR	66	62442246	62456836	14590
EUR_34	20000	EUR	66	64018404	64060264	41860
EUR_34	20000	EUR	66	64275342	64277727	2385
EUR_34	20000	EUR	66	66848687	66882708	34021
EUR_34	20000	EUR	66	67516377	67550551	34174
EUR_34	20000	EUR	66	67890847	68012425	121578
EUR_34	20000	EUR	66	68202321	68219989	17668
EUR_34	20000	EUR	66	68543110	68564643	21533
EUR_34	20000	EUR	66	69004995	69072506	67511
EUR_34	20000	EUR	66	69262441	69296795	34354
EUR_34	20000	EUR	66	70178120	70180545	2425
EUR_34	20000	EUR	66	70314329	70323506	9177
EUR_34	20000	EUR	66	70425266	70471952	46686
EUR_34	20000	EUR	66	71411050	71427923	16873
EUR_34	20000	EUR	66	74185839	74211177	25338
EUR_34	20000	EUR	66	74704171	74781759	77588
EUR_34	20000	EUR	66	81847136	81856204	9068
EUR_34	20000	EUR	66	84278449	84347352	68903
EUR_34	20000	EUR	66	86439603	86466441	26838
EUR_34	20000	EUR	66	89251444	89360109	108665
EUR_34	20000	EUR	66	96488824	96551349	62525
EUR_34	20000	EUR	66	97120986	97188820	67834
EUR_34	20000	EUR	67	0	38454	38454
EUR_34	20000	EUR	67	4067245	4155031	87786
EUR_34	20000	EUR	67	5738269	5741613	3344
EUR_34	20000	EUR	67	8922196	8953694	31498
EUR_34	20000	EUR	67	13070757	13085270	14513
EUR_34	20000	EUR	67	19602327	19640640	38313
EUR_34	20000	EUR	67	28592294	28668202	75908
EUR_34	20000	EUR	67	30665466	30875320	209854
EUR_34	20000	EUR	67	30929417	30992298	62881
EUR_34	20000	EUR	67	32052642	32104320	51678
EUR_34	20000	EUR	67	43750662	43813419	62757
EUR_34	20000	EUR	67	44438534	44513938	75404
EUR_34	20000	EUR	67	48181642	48246225	64583
EUR_34	20000	EUR	67	48974035	49018779	44744
EUR_34	20000	EUR	67	49051657	49139016	87359
EUR_34	20000	EUR	67	50807678	50964254	156576
EUR_34	20000	EUR	67	51721135	51737158	16023
EUR_34	20000	EUR	67	55891681	55941600	49919
EUR_34	20000	EUR	67	56642327	56661029	18702
EUR_34	20000	EUR	67	56981282	57026186	44904
EUR_34	20000	EUR	67	59025323	59087449	62126
EUR_34	20000	EUR	67	60466872	60623780	156908
EUR_34	20000	EUR	67	60697825	60703119	5294
EUR_34	20000	EUR	67	62791039	63227147	436108
EUR_34	20000	EUR	67	64843420	64968332	124912
EUR_34	20000	EUR	67	66786821	66800432	13611
EUR_34	20000	EUR	67	66848687	66900890	52203
EUR_34	20000	EUR	67	69586157	69604190	18033
EUR_34	20000	EUR	67	78656227	78660130	3903
EUR_34	20000	EUR	67	79636078	79803495	167417
EUR_34	20000	EUR	67	81849638	81877251	27613
EUR_34	20000	EUR	67	84271016	84589581	318565
EUR_34	20000	EUR	67	92582365	92911223	328858
EUR_34	20000	EUR	67	96215188	96313082	97894
EUR_34	20000	EUR	67	96628171	96829111	200940
EUR_34	20000	EUR	67	97100087	97197935	97848
EUR_34	20000	EUR	67	97398476	97597298	198822
EUR_35	20000	EUR	68	0	187050	187050
EUR_35	20000	EUR	68	293630	317557	23927
EUR_35	20000	EUR	68	5351614	5514753	163139
EUR_35	20000	EUR	68	7764477	7852331	87854
EUR_35	20000	EUR	68	10358872	10559629	200757
EUR_35	20000	EUR	68	13473030	13521112	48082
EUR_35	20000	EUR	68	15678424	15743283	64859
EUR_35	20000	EUR	68	23841284	24070707	229423
EUR_35	20000	EUR	68	25625985	25637091	11106
EUR_35	20000	EUR	68	27030183	27120057	89874
EUR_35	20000	EUR	68	28730691	28751710	21019
EUR_35	20000	EUR	68	31005915	31042242	36327
EUR_35	20000	EUR	68	31342564	31464998	122434
EUR_35	20000	EUR	68	32730745	32787200	56455
EUR_35	20000	EUR	68	35945899	36017172	71273
EUR_35	20000	EUR	68	43760561	43813419	52858
EUR_35	20000	EUR	68	49630087	49662298	32211
EUR_35	20000	EUR	68	50094550	50108086	13536
EUR_35	20000	EUR	68	50287644	50340188	52544
EUR_35	20000	EUR	68	54352751	54422822	70071
EUR_35	20000	EUR	68	60314986	60623780	308794
EUR_35	20000	EUR	68	60675915	60703119	27204
EUR_35	20000	EUR	68	62781664	62797882	16218
EUR_35	20000	EUR	68	62860595	63151646	291051
EUR_35	20000	EUR	68	64050970	64066021	15051
EUR_35	20000	EUR	68	64699193	64699609	416
EUR_35	20000	EUR	68	67096300	67168090	71790
EUR_35	20000	EUR	68	67726807	67774483	47676
EUR_35	20000	EUR	68	71214523	71270702	56179
EUR_35	20000	EUR	68	80106200	80125347	19147
EUR_35	20000	EUR	68	80307017	80378472	71455
EUR_35	20000	EUR	68	80790902	80831869	40967
EUR_35	20000	EUR	68	84271016	84371174	100158
EUR_35	20000	EUR	68	86418855	86466441	47586
EUR_35	20000	EUR	68	91097171	91116161	18990
EUR_35	20000	EUR	68	93210081	93434333	224252
EUR_35	20000	EUR	68	97529637	97597298	67661
EUR_35	20000	EUR	69	5399268	5408555	9287
EUR_35	20000	EUR	69	10310816	10371329	60513
EUR_35	20000	EUR	69	10547168	10559629	12461
EUR_35	20000	EUR	69	12436919	12649905	212986
EUR_35	20000	EUR	69	13070757	13085270	14513
EUR_35	20000	EUR	69	15892928	16041545	148617
EUR_35	20000	EUR	69	16872759	17212846	340087
EUR_35	20000	EUR	69	19490258	19651006	160748
EUR_35	20000	EUR	69	21282427	21365066	82639
EUR_35	20000	EUR	69	23325683	23438353	112670
EUR_35	20000	EUR	69	23849387	24068408	219021
EUR_35	20000	EUR	69	29201265	29262122	60857
EUR_35	20000	EUR	69	29853109	29884548	31439
EUR_35	20000	EUR	69	31203931	31261283	57352
EUR_35	20000	EUR	69	31270356	31349680	79324
EUR_35	20000	EUR	69	39536610	39556838	20228
EUR_35	20000	EUR	69	41082532	41103899	21367
EUR_35	20000	EUR	69	45292333	45335213	42880
EUR_35	20000	EUR	69	46821026	46878762	57736
EUR_35	20000	EUR	69	47573262	47867455	294193
EUR_35	20000	EUR	69	48828898	48852598	23700
EUR_35	20000	EUR	69	49063282	49211922	148640
EUR_35	20000	EUR	69	49835442	49931459	96017
EUR_35	20000	EUR	69	50079988	50180511	100523
EUR_35	20000	EUR	69	50265072	50340188	75116
EUR_35	20000	EUR	69	54352751	54429543	76792
EUR_35	20000	EUR	69	54447874	54482640	34766
EUR_35	20000	EUR	69	55662959	55943914	280955
EUR_35	20000	EUR	69	62495143	62651348	156205
EUR_35	20000	EUR	69	62670131	62820719	150588
EUR_35	20000	EUR	69	63356933	63605906	248973
EUR_35	20000	EUR	69	64007129	64060264	53135
EUR_35	20000	EUR	69	64689850	64713211	23361
EUR_35	20000	EUR	69	64779628	64968332	188704
EUR_35	20000	EUR	69	67516377	67693426	177049
EUR_35	20000	EUR	69	69004995	69092409	87414
EUR_35	20000	EUR	69	69976346	70136356	160010
EUR_35	20000	EUR	69	70425266	70471952	46686
EUR_35	20000	EUR	69	71153579	71419702	266123
EUR_35	20000	EUR	69	74185839	74211177	25338
EUR_35	20000	EUR	69	78278359	78281355	2996
EUR_35	20000	EUR	69	80751058	80831869	80811
EUR_35	20000	EUR	69	82777601	82858642	81041
EUR_35	20000	EUR	69	84040452	84198948	158496
EUR_35	20000	EUR	69	84586314	84597943	11629
EUR_35	20000	EUR	69	86361900	86399809	37909
EUR_35	20000	EUR	69	92728134	92911223	183089
EUR_35	20000	EUR	69	95261532	95309603	48071
EUR_35	20000	EUR	69	96677706	96969240	291534
EUR_35	20000	EUR	69	97670105	97850405	180300
EUR_36	20000	EUR	70	11155402	11226347	70945
EUR_36	20000	EUR	70	12405520	12649905	244385
EUR_36	20000	EUR	70	12959122	12989272	30150
EUR_36	20000	EUR	70	15686234	15701244	15010
EUR_36	20000	EUR	70	15783892	15884079	100187
EUR_36	20000	EUR	70	16960554	17115665	155111
EUR_36	20000	EUR	70	19395138	19439044	43906
EUR_36	20000	EUR	70	19490258	19640640	150382
EUR_36	20000	EUR	70	19703413	19752209	48796
EUR_36	20000	EUR	70	21166394	21195469	29075
EUR_36	20000	EUR	70	22947870	23014908	67038
EUR_36	20000	EUR	70	23264640	23438353	173713
EUR_36	20000	EUR	70	23454655	23632090	177435
EUR_36	20000	EUR	70	23841284	23878136	36852
EUR_36	20000	EUR	70	29853109	29884548	31439
EUR_36	20000	EUR	70	30528228	30655575	127347
EUR_36	20000	EUR	70	31402082	31464998	62916
EUR_36	20000	EUR	70	31810551	31996286	185735
EUR_36	20000	EUR	70	40125941	40169297	43356
EUR_36	20000	EUR	70	44361001	44404700	43699
EUR_36	20000	EUR	70	45292333	45413157	120824
EUR_36	20000	EUR	70	47874821	48095137	220316
EUR_36	20000	EUR	70	48980390	49071287	90897
EUR_36	20000	EUR	70	49138915	49139016	101
EUR_36	20000	EUR	70	49593845	49778991	185146
EUR_36	20000	EUR	70	49938053	50340188	402135
EUR_36	20000	EUR	70	53185452	53248662	63210
EUR_36	20000	EUR	70	59025323	59060025	34702
EUR_36	20000	EUR	70	60859224	60933571	74347
EUR_36	20000	EUR	70	62270017	62407580	137563
EUR_36	20000	EUR	70	64993828	65025826	31998
EUR_36	20000	EUR	70	67632239	67659453	27214
EUR_36	20000	EUR	70	71343174	71370919	27745
EUR_36	20000	EUR	70	73189891	73191693	1802
EUR_36	20000	EUR	70	74609427	74620157	10730
EUR_36	20000	EUR	70	77940158	77981834	41676
EUR_36	20000	EUR	70	79508567	79577121	68554
EUR_36	20000	EUR	70	81009858	81095721	85863
EUR_36	20000	EUR	70	83543294	83583418	40124
EUR_36	20000	EUR	70	84174413	84347352	172939
EUR_36	20000	EUR	70	84385265	84423669	38404
EUR_36	20000	EUR	70	93436001	93437672	1671
EUR_36	20000	EUR	70	95127554	95309603	182049
EUR_36	20000	EUR	71	5515391	5560949	45558
EUR_36	20000	EUR	71	8846483	8958572	112089
EUR_36	20000	EUR	71	11741022	11810853	69831
EUR_36	20000	EUR	71	12405520	12649905	244385
EUR_36	20000	EUR	71	12959122	12984105	24983
EUR_36	20000	EUR	71	13990229	14094824	104595
EUR_36	20000	EUR	71	14643309	14747360	104051
EUR_36	20000	EUR	71	15585791	15632929	47138
EUR_36	20000	EUR	71	15697742	15701244	3502
EUR_36	20000	EUR	71	19659204	19765406	106202
EUR_36	20000	EUR	71	23766186	23784377	18191
EUR_36	20000	EUR	71	31203931	31261283	57352
EUR_36	20000	EUR	71	31270356	31349680	79324
EUR_36	20000	EUR	71	40559832	40561321	1489
EUR_36	20000	EUR	71	41236994	41386596	149602
EUR_36	20000	EUR	71	43760561	43813419	52858
EUR_36	20000	EUR	71	45274093	45295441	21348
EUR_36	20000	EUR	71	47722097	47744901	22804
EUR_36	20000	EUR	71	48455942	48675545	219603
EUR_36	20000	EUR	71	48883624	48956042	72418
EUR_36	20000	EUR	71	49214391	49270017	55626
EUR_36	20000	EUR	71	50199687	50220042	20355
EUR_36	20000	EUR	71	50333952	50340188	6236
EUR_36	20000	EUR	71	50524394	50546250	21856
EUR_36	20000	EUR	71	50572126	50682125	109999
EUR_36	20000	EUR	71	51721135	51756063	34928
EUR_36	20000	EUR	71	53359909	53413728	53819
EUR_36	20000	EUR	71	59129042	59164124	35082
EUR_36	20000	EUR	71	62266230	62343666	77436
EUR_36	20000	EUR	71	66667736	67022791	355055
EUR_36	20000	EUR	71	67043600	67160970	117370
EUR_36	20000	EUR	71	74609427	74689986	80559
EUR_36	20000	EUR	71	74695445	74723577	28132
EUR_36	20000	EUR	71	79714947	79717095	2148
EUR_36	20000	EUR	71	79834311	79835487	1176
EUR_36	20000	EUR	71	80852781	80961424	108643
EUR_36	20000	EUR	71	82779823	82867077	87254
EUR_36	20000	EUR	71	84454434	84589581	135147
EUR_37	20000	EUR	72	0	110433	110433
EUR_37	20000	EUR	72	2297916	2447327	149411
EUR_37	20000	EUR	72	5515391	5560949	45558
EUR_37	20000	EUR	72	11309495	11324870	15375
EUR_37	20000	EUR	72	12480475	12595681	115206
EUR_37	20000	EUR	72	12957537	13029529	71992
EUR_37	20000	EUR	72	15617938	15701244	83306
EUR_37	20000	EUR	72	15783892	15821860	37968
EUR_37	20000	EUR	72	19206296	19308093	101797
EUR_37	20000	EUR	72	23519809	23696381	176572
EUR_37	20000	EUR	72	27030183	27075416	45233
EUR_37	20000	EUR	72	28588373	28683533	95160
EUR_37	20000	EUR	72	29741785	29763985	22200
EUR_37	20000	EUR	72	31213935	31253915	39980
EUR_37	20000	EUR	72	46948492	47043436	94944
EUR_37	20000	EUR	72	47654777	47684388	29611
EUR_37	20000	EUR	72	47867299	47891572	24273
EUR_37	20000	EUR	72	49844125	49874186	30061
EUR_37	20000	EUR	72	50199687	50220042	20355
EUR_37	20000	EUR	72	50333952	50340188	6236
EUR_37	20000	EUR	72	50524394	50546634	22240
EUR_37	20000	EUR	72	54352751	54422822	70071
EUR_37	20000	EUR	72	55907255	55941600	34345
EUR_37	20000	EUR	72	59745200	59762191	16991
EUR_37	20000	EUR	72	61563808	61569183	5375
EUR_37	20000	EUR	72	62266230	62343666	77436
EUR_37	20000	EUR	72	67632239	67659453	27214
EUR_37	20000	EUR	72	67993239	68098049	104810
EUR_37	20000	EUR	72	68543110	68564643	21533
EUR_37	20000	EUR	72	69004995	69072506	67511
EUR_37	20000	EUR	72	69262441	69296795	34354
EUR_37	20000	EUR	72	70178120	70180545	2425
EUR_37	20000	EUR	72	73344343	73357038	12695
EUR_37	20000	EUR	72	82777601	83035646	258045
EUR_37	20000	EUR	72	84271016	84311979	40963
EUR_37	20000	EUR	72	84570415	84809687	239272
EUR_37	20000	EUR	72	87069518	87192258	122740
EUR_37	20000	EUR	72	98197427	98216504	19077
EUR_37	20000	EUR	73	0	38454	38454
EUR_37	20000	EUR	73	1291609	1354736	63127
EUR_37	20000	EUR	73	1443312	1474375	31063
EUR_37	20000	EUR	73	2267390	2305620	38230
EUR_37	20000	EUR	73	11926927	11927735	808
EUR_37	20000	EUR	73	12971780	13085270	113490
EUR_37	20000	EUR	73	13175672	13190842	15170
EUR_37	20000	EUR	73	15585791	15689989	104198
EUR_37	20000	EUR	73	16335668	16340550	4882
EUR_37	20000	EUR	73	19395138	19417914	22776
EUR_37	20000	EUR	73	23941733	24132984	191251
EUR_37	20000	EUR	73	25625985	25637091	11106
EUR_37	20000	EUR	73	28447913	28454759	6846
EUR_37	20000	EUR	73	28909134	28912719	3585
EUR_37	20000	EUR	73	29741238	29767219	25981
EUR_37	20000	EUR	73	30592221	30655575	63354
EUR_37	20000	EUR	73	31194898	31233050	38152
EUR_37	20000	EUR	73	31387106	31415119	28013
EUR_37	20000	EUR	73	31953948	32129155	175207
EUR_37	20000	EUR	73	43768000	43813419	45419
EUR_37	20000	EUR	73	44486264	44811416	325152
EUR_37	20000	EUR	73	49138915	49139016	101
EUR_37	20000	EUR	73	50594292	50682125	87833
EUR_37	20000	EUR	73	51739382	51756063	16681
EUR_37	20000	EUR	73	56981282	57026186	44904
EUR_37	20000	EUR	73	59745200	59789210	44010
EUR_37	20000	EUR	73	59858820	59875965	17145
EUR_37	20000	EUR	73	60587632	60595221	7589
EUR_37	20000	EUR	73	60836692	60933571	96879
EUR_37	20000	EUR	73	61991743	62430091	438348
EUR_37	20000	EUR	73	62571477	62571923	446
EUR_37	20000	EUR	73	62672738	62763590	90852
EUR_37	20000	EUR	73	67096300	67168090	71790
EUR_37	20000	EUR	73	67726807	67774483	47676
EUR_37	20000	EUR	73	69253738	69314431	60693
EUR_37	20000	EUR	73	69976346	70136356	160010
EUR_37	20000	EUR	73	71108569	71509363	400794
EUR_37	20000	EUR	73	72348347	72391607	43260
EUR_37	20000	EUR	73	73164377	73191693	27316
EUR_37	20000	EUR	73	74609427	74663374	53947
EUR_37	20000	EUR	73	77940158	77981834	41676
EUR_37	20000	EUR	73	78128495	78236096	107601
EUR_37	20000	EUR	73	82778902	83035646	256744
EUR_37	20000	EUR	73	84586314	84597943	11629
EUR_37	20000	EUR	73	86284062	86324407	40345
EUR_37	20000	EUR	73	87914298	87992882	78584
EUR_37	20000	EUR	73	95681624	95770835	89211
EUR_37	20000	EUR	73	96089909	96133921	44012
EUR_37	20000	EUR	73	96580037	96678817	98780
EUR_38	20000	EUR	74	8004685	8026219	21534
EUR_38	20000	EUR	74	10318920	10559629	240709
EUR_38	20000	EUR	74	12353636	12432602	78966
EUR_38	20000	EUR	74	14713216	14799065	85849
EUR_38	20000	EUR	74	14839438	14894976	55538
EUR_38	20000	EUR	74	18850191	18885640	35449
EUR_38	20000	EUR	74	19650300	19765406	115106
EUR_38	20000	EUR	74	21489581	21558457	68876
EUR_38	20000	EUR	74	23414479	23438353	23874
EUR_38	20000	EUR	74	23678834	23696381	17547
EUR_38	20000	EUR	74	23923937	24132984	209047
EUR_38	20000	EUR	74	28447913	28454759	6846
EUR_38	20000	EUR	74	32052642	32104320	51678
EUR_38	20000	EUR	74	35825437	35904356	78919
EUR_38	20000	EUR	74	43066847	43071200	4353
EUR_38	20000	EUR	74	43768000	43813419	45419
EUR_38	20000	EUR	74	50020142	50183908	163766
EUR_38	20000	EUR	74	50807678	50885012	77334
EUR_38	20000	EUR	74	51721135	51737158	16023
EUR_38	20000	EUR	74	54082858	54110395	27537
EUR_38	20000	EUR	74	54156560	54229443	72883
EUR_38	20000	EUR	74	55662959	55943914	280955
EUR_38	20000	EUR	74	59745200	59789210	44010
EUR_38	20000	EUR	74	62031429	62268658	237229
EUR_38	20000	EUR	74	62363965	62460553	96588
EUR_38	20000	EUR	74	64632417	64777381	144964
EUR_38	20000	EUR	74	66713300	66867964	154664
EUR_38	20000	EUR	74	67106601	67147046	40445
EUR_38	20000	EUR	74	67726807	68131443	404636
EUR_38	20000	EUR	74	71153579	71427923	274344
EUR_38	20000	EUR	74	74638673	74738201	99528
EUR_38	20000	EUR	74	76457074	76485346	28272
EUR_38	20000	EUR	74	79714947	79717095	2148
EUR_38	20000	EUR	74	79834311	79835487	1176
EUR_38	20000	EUR	74	80307017	80378472	71455
EUR_38	20000	EUR	74	82682910	82761538	78628
EUR_38	20000	EUR	74	84271016	84550993	279977
EUR_38	20000	EUR	74	84553831	84589581	35750
EUR_38	20000	EUR	74	87069518	87099768	30250
EUR_38	20000	EUR	74	88064488	88291850	227362
EUR_38	20000	EUR	74	95549067	95706836	157769
EUR_38	20000	EUR	74	97227283	97229983	2700
EUR_38	20000	EUR	74	97398476	97442009	43533
EUR_38	20000	EUR	74	97499614	97573671	74057
EUR_38	20000	EUR	74	97587101	97698044	110943
EUR_38	20000	EUR	74	97711629	97766796	55167
EUR_38	20000	EUR	75	0	38454	38454
EUR_38	20000	EUR	75	12674660	12687739	13079
EUR_38	20000	EUR	75	12909514	13008521	99007
EUR_38	20000	EUR	75	14731136	14762675	31539
EUR_38	20000	EUR	75	15678424	15747671	69247
EUR_38	20000	EUR	75	19438596	19544916	106320
EUR_38	20000	EUR	75	23454655	23632090	177435
EUR_38	20000	EUR	75	23841284	24070707	229423
EUR_38	20000	EUR	75	31342564	31464998	122434
EUR_38	20000	EUR	75	41241594	41386596	145002
EUR_38	20000	EUR	75	43750662	43813419	62757
EUR_38	20000	EUR	75	44422772	44647773	225001
EUR_38	20000	EUR	75	47800452	47867455	67003
EUR_38	20000	EUR	75	48281283	48321534	40251
EUR_38	20000	EUR	75	48942765	49071287	128522
EUR_38	20000	EUR	75	53175827	53302464	126637
EUR_38	20000	EUR	75	54352751	54422822	70071
EUR_38	20000	EUR	75	55891681	55941600	49919
EUR_38	20000	EUR	75	60314986	60406009	91023
EUR_38	20000	EUR	75	62015446	62232042	216596
EUR_38	20000	EUR	75	62266230	62343666	77436
EUR_38	20000	EUR	75	62968245	63031514	63269
EUR_38	20000	EUR	75	64740348	64968332	227984
EUR_38	20000	EUR	75	66942688	67022791	80103
EUR_38	20000	EUR	75	67043600	67142501	98901
EUR_38	20000	EUR	75	67581165	67629756	48591
EUR_38	20000	EUR	75	67669977	67733569	63592
EUR_38	20000	EUR	75	67750394	68089779	339385
EUR_38	20000	EUR	75	68118814	68219989	101175
EUR_38	20000	EUR	75	69208907	69257859	48952
EUR_38	20000	EUR	75	69976346	70054691	78345
EUR_38	20000	EUR	75	73344343	73485420	141077
EUR_38	20000	EUR	75	78656227	78660130	3903
EUR_38	20000	EUR	75	79636078	79803495	167417
EUR_38	20000	EUR	75	81849638	81877251	27613
EUR_38	20000	EUR	75	84271016	84550993	279977
EUR_38	20000	EUR	75	84808933	84859626	50693
EUR_38	20000	EUR	75	85268776	85278069	9293
EUR_38	20000	EUR	75	86183232	86324407	141175
EUR_38	20000	EUR	75	93268366	93378771	110405
EUR_38	20000	EUR	75	93627195	93686534	59339
EUR_38	20000	EUR	75	95261709	95309603	47894
EUR_39	20000	EUR	76	2550449	2686846	136397
EUR_39	20000	EUR	76	11221129	11267811	46682
EUR_39	20000	EUR	76	15678424	15857544	179120
EUR_39	20000	EUR	76	19490258	19651006	160748
EUR_39	20000	EUR	76	19771627	19815522	43895
EUR_39	20000	EUR	76	21540239	21544907	4668
EUR_39	20000	EUR	76	23297565	23324559	26994
EUR_39	20000	EUR	76	24532214	24693848	161634
EUR_39	20000	EUR	76	30528228	30571548	43320
EUR_39	20000	EUR	76	31213935	31415119	201184
EUR_39	20000	EUR	76	39475823	39537203	61380
EUR_39	20000	EUR	76	43356490	43477546	121056
EUR_39	20000	EUR	76	44991454	45007478	16024
EUR_39	20000	EUR	76	47868799	47937970	69171
EUR_39	20000	EUR	76	49716678	49797331	80653
EUR_39	20000	EUR	76	50040990	50057292	16302
EUR_39	20000	EUR	76	50244656	50300721	56065
EUR_39	20000	EUR	76	54156560	54196054	39494
EUR_39	20000	EUR	76	64332882	64372547	39665
EUR_39	20000	EUR	76	68202321	68219989	17668
EUR_39	20000	EUR	76	68501694	68520890	19196
EUR_39	20000	EUR	76	70178120	70180545	2425
EUR_39	20000	EUR	76	74185839	74211177	25338
EUR_39	20000	EUR	76	83543294	83583418	40124
EUR_39	20000	EUR	76	84271016	84550993	279977
EUR_39	20000	EUR	76	86183232	86324407	141175
EUR_39	20000	EUR	76	92744634	92958238	213604
EUR_39	20000	EUR	76	96770166	96981080	210914
EUR_39	20000	EUR	77	0	38454	38454
EUR_39	20000	EUR	77	8850520	8958572	108052
EUR_39	20000	EUR	77	10162900	10335169	172269
EUR_39	20000	EUR	77	15617938	15701244	83306
EUR_39	20000	EUR	77	17304972	17323735	18763
EUR_39	20000	EUR	77	20925981	20952589	26608
EUR_39	20000	EUR	77	21737927	21914523	176596
EUR_39	20000	EUR	77	23697124	23853580	156456
EUR_39	20000	EUR	77	27563461	27803948	240487
EUR_39	20000	EUR	77	28909134	28912719	3585
EUR_39	20000	EUR	77	29749217	29751787	2570
EUR_39	20000	EUR	77	29885100	30020785	135685
EUR_39	20000	EUR	77	30423096	30559727	136631
EUR_39	20000	EUR	77	31333164	31349680	16516
EUR_39	20000	EUR	77	33352525	33353174	649
EUR_39	20000	EUR	77	43750662	43785095	34433
EUR_39	20000	EUR	77	44915345	45093802	178457
EUR_39	20000	EUR	77	46009455	46088595	79140
EUR_39	20000	EUR	77	46167446	46287015	119569
EUR_39	20000	EUR	77	49883096	49948915	65819
EUR_39	20000	EUR	77	50020142	50183908	163766
EUR_39	20000	EUR	77	50256105	50340188	84083
EUR_39	20000	EUR	77	50524394	50562004	37610
EUR_39	20000	EUR	77	55365672	55376432	10760
EUR_39	20000	EUR	77	56606415	56670627	64212
EUR_39	20000	EUR	77	59025323	59078409	53086
EUR_39	20000	EUR	77	59745200	59789210	44010
EUR_39	20000	EUR	77	62508611	62571923	63312
EUR_39	20000	EUR	77	62707968	62779708	71740
EUR_39	20000	EUR	77	67099623	67160970	61347
EUR_39	20000	EUR	77	67948972	67981950	32978
EUR_39	20000	EUR	77	68044654	68219989	175335
EUR_39	20000	EUR	77	74704171	74756907	52736
EUR_39	20000	EUR	77	79636078	79803495	167417
EUR_39	20000	EUR	77	84040452	84198948	158496
EUR_39	20000	EUR	77	84609284	84609377	93
EUR_39	20000	EUR	77	88992283	89057856	65573
EUR_39	20000	EUR	77	93579639	93686534	106895
EUR_40	20000	EUR	78	0	38454	38454
EUR_40	20000	EUR	78	4067245	4155031	87786
EUR_40	20000	EUR	78	8023767	8074467	50700
EUR_40	20000	EUR	78	10310816	10371329	60513
EUR_40	20000	EUR	78	14599834	14744959	145125
EUR_40	20000	EUR	78	15678424	15747671	69247
EUR_40	20000	EUR	78	19524348	19575541	51193
EUR_40	20000	EUR	78	19690441	19765406	74965
EUR_40	20000	EUR	78	19772407	19815522	43115
EUR_40	20000	EUR	78	21525308	21558457	33149
EUR_40	20000	EUR	78	23480055	23525224	45169
EUR_40	20000	EUR	78	23678834	23696381	17547
EUR_40	20000	EUR	78	23923937	24061376	137439
EUR_40	20000	EUR	78	26757616	26827636	70020
EUR_40	20000	EUR	78	28588373	28683533	95160
EUR_40	20000	EUR	78	29146149	29190448	44299
EUR_40	20000	EUR	78	29201265	29403219	201954
EUR_40	20000	EUR	78	30838706	31157362	318656
EUR_40	20000	EUR	78	39475823	39537203	61380
EUR_40	20000	EUR	78	39707666	39718127	10461
EUR_40	20000	EUR	78	43183684	43291736	108052
EUR_40	20000	EUR	78	43547085	43587658	40573
EUR_40	20000	EUR	78	45980594	46304829	324235
EUR_40	20000	EUR	78	48181642	48250239	68597
EUR_40	20000	EUR	78	49050712	49139016	88304
EUR_40	20000	EUR	78	49430402	49494606	64204
EUR_40	20000	EUR	78	50214714	50260453	45739
EUR_40	20000	EUR	78	50437336	50573069	135733
EUR_40	20000	EUR	78	62489657	62546166	56509
EUR_40	20000	EUR	78	63010595	63029376	18781
EUR_40	20000	EUR	78	63379754	63414083	34329
EUR_40	20000	EUR	78	64993828	65025826	31998
EUR_40	20000	EUR	78	67632239	67659453	27214
EUR_40	20000	EUR	78	71343174	71376679	33505
EUR_40	20000	EUR	78	74185839	74211177	25338
EUR_40	20000	EUR	78	78128495	78236096	107601
EUR_40	20000	EUR	78	81009858	81037997	28139
EUR_40	20000	EUR	78	82779823	82867077	87254
EUR_40	20000	EUR	78	84586314	84597943	11629
EUR_40	20000	EUR	78	93364712	93374394	9682
EUR_40	20000	EUR	78	93579639	93661251	81612
EUR_40	20000	EUR	78	96344658	96374783	30125
EUR_40	20000	EUR	78	96488824	96551349	62525
EUR_40	20000	EUR	78	96822588	97142026	319438
EUR_40	20000	EUR	78	97198885	97229983	31098
EUR_40	20000	EUR	78	97398476	97760106	361630
EUR_40	20000	EUR	79	4069425	4124617	55192
EUR_40	20000	EUR	79	5399268	5408555	9287
EUR_40	20000	EUR	79	5914836	5971269	56433
EUR_40	20000	EUR	79	10162900	10351635	188735
EUR_40	20000	EUR	79	15678424	15857544	179120
EUR_40	20000	EUR	79	19490258	19765406	275148
EUR_40	20000	EUR	79	23197494	23266685	69191
EUR_40	20000	EUR	79	23348628	23374530	25902
EUR_40	20000	EUR	79	23678834	23696381	17547
EUR_40	20000	EUR	79	28588373	28683533	95160
EUR_40	20000	EUR	79	29249415	29392323	142908
EUR_40	20000	EUR	79	29885100	29898500	13400
EUR_40	20000	EUR	79	31340450	31464998	124548
EUR_40	20000	EUR	79	43547085	43587658	40573
EUR_40	20000	EUR	79	43777503	43813419	35916
EUR_40	20000	EUR	79	44243666	44287999	44333
EUR_40	20000	EUR	79	48793777	48801513	7736
EUR_40	20000	EUR	79	49006754	49152213	145459
EUR_40	20000	EUR	79	49422646	49692685	270039
EUR_40	20000	EUR	79	50654897	50675343	20446
EUR_40	20000	EUR	79	55876234	55943914	67680
EUR_40	20000	EUR	79	59025323	59087449	62126
EUR_40	20000	EUR	79	62266230	62267857	1627
EUR_40	20000	EUR	79	63010595	63041174	30579
EUR_40	20000	EUR	79	64213067	64326150	113083
EUR_40	20000	EUR	79	66769643	67022791	253148
EUR_40	20000	EUR	79	67043600	67160970	117370
EUR_40	20000	EUR	79	67720425	67747325	26900
EUR_40	20000	EUR	79	67947267	68012425	65158
EUR_40	20000	EUR	79	68209047	68341894	132847
EUR_40	20000	EUR	79	70305880	70333718	27838
EUR_40	20000	EUR	79	71108569	71229807	121238
EUR_40	20000	EUR	79	71361559	71413896	52337
EUR_40	20000	EUR	79	73164377	73263490	99113
EUR_40	20000	EUR	79	74609427	74738201	128774
EUR_40	20000	EUR	79	79636078	79835487	199409
EUR_40	20000	EUR	79	84480189	84589581	109392
EUR_40	20000	EUR	79	86383947	86466441	82494
EUR_40	20000	EUR	79	93639360	93686534	47174
EUR_41	10000	EUR	80	8004685	8026219	21534
EUR_41	10000	EUR	80	10455256	10468821	13565
EUR_41	10000	EUR	80	10544104	10559629	15525
EUR_41	10000	EUR	80	15686234	15701244	15010
EUR_41	10000	EUR	80	15783892	15884079	100187
EUR_41	10000	EUR	80	21438457	21523118	84661
EUR_41	10000	EUR	80	21525308	21558457	33149
EUR_41	10000	EUR	80	23330380	23342897	12517
EUR_41	10000	EUR	80	23358116	23371760	13644
EUR_41	10000	EUR	80	26802769	27028137	225368
EUR_41	10000	EUR	80	28447913	28454759	6846
EUR_41	10000	EUR	80	29885100	30020785	135685
EUR_41	10000	EUR	80	30678684	30730344	51660
EUR_41	10000	EUR	80	31391393	31407691	16298
EUR_41	10000	EUR	80	41236830	41330550	93720
EUR_41	10000	EUR	80	43321108	43337414	16306
EUR_41	10000	EUR	80	45919475	46077353	157878
EUR_41	10000	EUR	80	47722097	47744901	22804
EUR_41	10000	EUR	80	48197806	48250239	52433
EUR_41	10000	EUR	80	48942765	49071287	128522
EUR_41	10000	EUR	80	49663690	49778991	115301
EUR_41	10000	EUR	80	49938053	50340188	402135
EUR_41	10000	EUR	80	50524394	50562004	37610
EUR_41	10000	EUR	80	53185716	53302464	116748
EUR_41	10000	EUR	80	54156560	54190763	34203
EUR_41	10000	EUR	80	54241431	54294851	53420
EUR_41	10000	EUR	80	55662959	55747582	84623
EUR_41	10000	EUR	80	55892211	56019725	127514
EUR_41	10000	EUR	80	59129042	59164124	35082
EUR_41	10000	EUR	80	60391758	60473482	81724
EUR_41	10000	EUR	80	62336325	62520941	184616
EUR_41	10000	EUR	80	63177292	63277354	100062
EUR_41	10000	EUR	80	63345194	63367008	21814
EUR_41	10000	EUR	80	63974015	64013981	39966
EUR_41	10000	EUR	80	64050970	64066021	15051
EUR_41	10000	EUR	80	64259771	64326150	66379
EUR_41	10000	EUR	80	64559645	64648825	89180
EUR_41	10000	EUR	80	66778829	66897711	118882
EUR_41	10000	EUR	80	67469783	67486153	16370
EUR_41	10000	EUR	80	67720425	67747325	26900
EUR_41	10000	EUR	80	68003563	68012425	8862
EUR_41	10000	EUR	80	69253738	69315282	61544
EUR_41	10000	EUR	80	73920589	74226288	305699
EUR_41	10000	EUR	80	74345860	74386200	40340
EUR_41	10000	EUR	80	78020485	78031382	10897
EUR_41	10000	EUR	80	80315709	80378472	62763
EUR_41	10000	EUR	80	81329834	81344715	14881
EUR_41	10000	EUR	80	84295406	84313163	17757
EUR_41	10000	EUR	80	84332987	84347352	14365
EUR_41	10000	EUR	80	84685999	84711549	25550
EUR_41	10000	EUR	80	87069518	87106230	36712
EUR_41	10000	EUR	80	87163493	87192258	28765
EUR_41	10000	EUR	80	92882226	92958238	76012
EUR_41	10000	EUR	80	96404550	96451210	46660
EUR_41	10000	EUR	81	196934	206962	10028
EUR_41	10000	EUR	81	5738269	5741613	3344
EUR_41	10000	EUR	81	10310816	10495746	184930
EUR_41	10000	EUR	81	10504963	10559629	54666
EUR_41	10000	EUR	81	11221129	11267811	46682
EUR_41	10000	EUR	81	12436919	12518164	81245
EUR_41	10000	EUR	81	12541608	12571424	29816
EUR_41	10000	EUR	81	13943659	14132248	188589
EUR_41	10000	EUR	81	14875145	14894976	19831
EUR_41	10000	EUR	81	15607322	15740215	132893
EUR_41	10000	EUR	81	17056564	17097884	41320
EUR_41	10000	EUR	81	19427224	19446442	19218
EUR_41	10000	EUR	81	19733630	19736517	2887
EUR_41	10000	EUR	81	21411938	21462608	50670
EUR_41	10000	EUR	81	23414479	23438353	23874
EUR_41	10000	EUR	81	23868725	24070707	201982
EUR_41	10000	EUR	81	26979753	27027989	48236
EUR_41	10000	EUR	81	29256822	29403219	146397
EUR_41	10000	EUR	81	29750374	29765658	15284
EUR_41	10000	EUR	81	31213935	31392900	178965
EUR_41	10000	EUR	81	41338812	41346194	7382
EUR_41	10000	EUR	81	43321108	43338312	17204
EUR_41	10000	EUR	81	43750662	43785095	34433
EUR_41	10000	EUR	81	45023383	45093802	70419
EUR_41	10000	EUR	81	47672056	47744901	72845
EUR_41	10000	EUR	81	48273976	48321534	47558
EUR_41	10000	EUR	81	48793399	48832663	39264
EUR_41	10000	EUR	81	49051657	49139016	87359
EUR_41	10000	EUR	81	49720102	50516476	796374
EUR_41	10000	EUR	81	50654897	50675343	20446
EUR_41	10000	EUR	81	55551653	55651082	99429
EUR_41	10000	EUR	81	62197424	62243667	46243
EUR_41	10000	EUR	81	62342962	62520941	177979
EUR_41	10000	EUR	81	62709351	62791767	82416
EUR_41	10000	EUR	81	63248927	63268388	19461
EUR_41	10000	EUR	81	64275342	64277727	2385
EUR_41	10000	EUR	81	64831271	64865609	34338
EUR_41	10000	EUR	81	64893591	65025826	132235
EUR_41	10000	EUR	81	67257538	67267114	9576
EUR_41	10000	EUR	81	68074057	68089779	15722
EUR_41	10000	EUR	81	68118814	68219989	101175
EUR_41	10000	EUR	81	69004995	69064534	59539
EUR_41	10000	EUR	81	69230927	69315282	84355
EUR_41	10000	EUR	81	71187459	71214726	27267
EUR_41	10000	EUR	81	73920589	74226288	305699
EUR_41	10000	EUR	81	74345860	74386200	40340
EUR_41	10000	EUR	81	74688510	74802304	113794
EUR_41	10000	EUR	81	76219599	76223870	4271
EUR_41	10000	EUR	81	79970884	79977985	7101
EUR_41	10000	EUR	81	80817797	80831869	14072
EUR_41	10000	EUR	81	80947447	80965346	17899
EUR_41	10000	EUR	81	81883517	81919375	35858
EUR_41	10000	EUR	81	82392396	82400999	8603
EUR_41	10000	EUR	81	84454434	84508973	54539
EUR_41	10000	EUR	81	84573291	84607732	34441
EUR_41	10000	EUR	81	86340983	86466441	125458
EUR_41	10000	EUR	81	92821323	92870243	48920
EUR_41	10000	EUR	81	95702824	95706836	4012
EUR_41	10000	EUR	81	97100087	97197807	97720
EUR_41	10000	EUR	81	97198885	97229983	31098
EUR_41	10000	EUR	81	97398476	97743855	345379
EUR_42	10000	EUR	82	0	4995	4995
EUR_42	10000	EUR	82	132067	255268	123201
EUR_42	10000	EUR	82	5865668	5971269	105601
EUR_42	10000	EUR	82	7764477	7852331	87854
EUR_42	10000	EUR	82	8023767	8074467	50700
EUR_42	10000	EUR	82	10162900	10335169	172269
EUR_42	10000	EUR	82	11221129	11267811	46682
EUR_42	10000	EUR	82	12195294	12394574	199280
EUR_42	10000	EUR	82	12957537	13029529	71992
EUR_42	10000	EUR	82	13955319	13957627	2308
EUR_42	10000	EUR	82	16387387	16444740	57353
EUR_42	10000	EUR	82	16960554	17115665	155111
EUR_42	10000	EUR	82	19373820	19426196	52376
EUR_42	10000	EUR	82	23358922	23367462	8540
EUR_42	10000	EUR	82	25625985	25637091	11106
EUR_42	10000	EUR	82	28588373	28683533	95160
EUR_42	10000	EUR	82	29146149	29159010	12861
EUR_42	10000	EUR	82	29397444	29403219	5775
EUR_42	10000	EUR	82	30528228	30562678	34450
EUR_42	10000	EUR	82	30817529	30844438	26909
EUR_42	10000	EUR	82	41241594	41362133	120539
EUR_42	10000	EUR	82	43750662	43756156	5494
EUR_42	10000	EUR	82	44299125	44428884	129759
EUR_42	10000	EUR	82	44915345	44959674	44329
EUR_42	10000	EUR	82	45965073	45977166	12093
EUR_42	10000	EUR	82	45994681	46044606	49925
EUR_42	10000	EUR	82	46254910	46287015	32105
EUR_42	10000	EUR	82	47722097	47744901	22804
EUR_42	10000	EUR	82	48240560	48246225	5665
EUR_42	10000	EUR	82	48793777	48801513	7736
EUR_42	10000	EUR	82	49396758	49409796	13038
EUR_42	10000	EUR	82	49471639	49501602	29963
EUR_42	10000	EUR	82	49656815	49751578	94763
EUR_42	10000	EUR	82	54732365	54740924	8559
EUR_42	10000	EUR	82	55684852	55943914	259062
EUR_42	10000	EUR	82	60314986	60354433	39447
EUR_42	10000	EUR	82	60391758	60473482	81724
EUR_42	10000	EUR	82	60697771	60715320	17549
EUR_42	10000	EUR	82	62336325	62520941	184616
EUR_42	10000	EUR	82	62709351	62791767	82416
EUR_42	10000	EUR	82	63248927	63268388	19461
EUR_42	10000	EUR	82	63530056	63775905	245849
EUR_42	10000	EUR	82	64831271	64865609	34338
EUR_42	10000	EUR	82	66778829	66897711	118882
EUR_42	10000	EUR	82	68340349	68341913	1564
EUR_42	10000	EUR	82	72366999	72393031	26032
EUR_42	10000	EUR	82	79834311	79835487	1176
EUR_42	10000	EUR	82	82819697	82867077	47380
EUR_42	10000	EUR	82	84307433	84476006	168573
EUR_42	10000	EUR	82	87069518	87191727	122209
EUR_42	10000	EUR	82	92821323	92870243	48920
EUR_42	10000	EUR	82	95549067	95706836	157769
EUR_42	10000	EUR	82	96252522	96313082	60560
EUR_42	10000	EUR	83	9913	10215	302
EUR_42	10000	EUR	83	7801499	7843158	41659
EUR_42	10000	EUR	83	9629012	9637337	8325
EUR_42	10000	EUR	83	10455256	10468821	13565
EUR_42	10000	EUR	83	12235935	12597188	361253
EUR_42	10000	EUR	83	13061051	13085270	24219
EUR_42	10000	EUR	83	13476436	13549834	73398
EUR_42	10000	EUR	83	17012776	17077983	65207
EUR_42	10000	EUR	83	20627652	20693514	65862
EUR_42	10000	EUR	83	21166394	21195469	29075
EUR_42	10000	EUR	83	23507155	23562645	55490
EUR_42	10000	EUR	83	26795639	26827636	31997
EUR_42	10000	EUR	83	29307623	29344643	37020
EUR_42	10000	EUR	83	29885100	29906215	21115
EUR_42	10000	EUR	83	30678684	30725822	47138
EUR_42	10000	EUR	83	30838706	30960757	122051
EUR_42	10000	EUR	83	31332044	31383101	51057
EUR_42	10000	EUR	83	31929110	31976562	47452
EUR_42	10000	EUR	83	33352525	33355723	3198
EUR_42	10000	EUR	83	35842665	35850326	7661
EUR_42	10000	EUR	83	39536610	39538252	1642
EUR_42	10000	EUR	83	40040672	40088009	47337
EUR_42	10000	EUR	83	41236994	41386596	149602
EUR_42	10000	EUR	83	41808814	41826713	17899
EUR_42	10000	EUR	83	44243666	44287999	44333
EUR_42	10000	EUR	83	44991454	45007478	16024
EUR_42	10000	EUR	83	45303182	45348218	45036
EUR_42	10000	EUR	83	45980594	46052925	72331
EUR_42	10000	EUR	83	47624392	47686374	61982
EUR_42	10000	EUR	83	49107941	49211922	103981
EUR_42	10000	EUR	83	49807803	50150613	342810
EUR_42	10000	EUR	83	50292505	50340188	47683
EUR_42	10000	EUR	83	56606415	56638521	32106
EUR_42	10000	EUR	83	60314986	60501936	186950
EUR_42	10000	EUR	83	61977382	62000629	23247
EUR_42	10000	EUR	83	62427707	62455504	27797
EUR_42	10000	EUR	83	62629480	62710548	81068
EUR_42	10000	EUR	83	63354466	63455982	101516
EUR_42	10000	EUR	83	64213067	64326150	113083
EUR_42	10000	EUR	83	64690778	64713211	22433
EUR_42	10000	EUR	83	64779628	64968332	188704
EUR_42	10000	EUR	83	65424838	65439431	14593
EUR_42	10000	EUR	83	67516377	67550551	34174
EUR_42	10000	EUR	83	67707244	67778978	71734
EUR_42	10000	EUR	83	67885028	67943437	58409
EUR_42	10000	EUR	83	68079150	68089779	10629
EUR_42	10000	EUR	83	68118814	68153675	34861
EUR_42	10000	EUR	83	68543110	68564643	21533
EUR_42	10000	EUR	83	70045788	70062616	16828
EUR_42	10000	EUR	83	71148579	71377452	228873
EUR_42	10000	EUR	83	72366999	72393031	26032
EUR_42	10000	EUR	83	73483646	73508952	25306
EUR_42	10000	EUR	83	74609427	74637502	28075
EUR_42	10000	EUR	83	74745525	74796715	51190
EUR_42	10000	EUR	83	78278359	78281355	2996
EUR_42	10000	EUR	83	79636078	79679325	43247
EUR_42	10000	EUR	83	80315709	80378472	62763
EUR_42	10000	EUR	83	81329834	81344715	14881
EUR_42	10000	EUR	83	84642857	84859626	216769
EUR_42	10000	EUR	83	93322571	93382850	60279
EUR_42	10000	EUR	83	97647484	97743855	96371
EUR_43	10000	EUR	84	5673598	5741613	68015
EUR_43	10000	EUR	84	7801499	8034150	232651
EUR_43	10000	EUR	84	10196585	10229013	32428
EUR_43	10000	EUR	84	12957537	13029529	71992
EUR_43	10000	EUR	84	14599834	14699483	99649
EUR_43	10000	EUR	84	15571100	15608201	37101
EUR_43	10000	EUR	84	15682412	15721551	39139
EUR_43	10000	EUR	84	15929044	15971895	42851
EUR_43	10000	EUR	84	19445931	19447994	2063
EUR_43	10000	EUR	84	24003989	24040521	36532
EUR_43	10000	EUR	84	27070686	27120057	49371
EUR_43	10000	EUR	84	28447913	28459172	11259
EUR_43	10000	EUR	84	31391393	31407691	16298
EUR_43	10000	EUR	84	37289843	37367274	77431
EUR_43	10000	EUR	84	44460384	44480695	20311
EUR_43	10000	EUR	84	45980594	46052925	72331
EUR_43	10000	EUR	84	48112263	48116147	3884
EUR_43	10000	EUR	84	49006754	49067165	60411
EUR_43	10000	EUR	84	49693701	49778991	85290
EUR_43	10000	EUR	84	49938053	50340188	402135
EUR_43	10000	EUR	84	51819962	51826252	6290
EUR_43	10000	EUR	84	54241939	54429543	187604
EUR_43	10000	EUR	84	54447874	54485919	38045
EUR_43	10000	EUR	84	54732365	54740924	8559
EUR_43	10000	EUR	84	55365672	55376432	10760
EUR_43	10000	EUR	84	55662959	55747582	84623
EUR_43	10000	EUR	84	59025323	59087449	62126
EUR_43	10000	EUR	84	62358424	62360148	1724
EUR_43	10000	EUR	84	62384821	62405059	20238
EUR_43	10000	EUR	84	62529172	62534818	5646
EUR_43	10000	EUR	84	62679237	62680258	1021
EUR_43	10000	EUR	84	62693596	62710548	16952
EUR_43	10000	EUR	84	62714390	62886738	172348
EUR_43	10000	EUR	84	63239582	63277354	37772
EUR_43	10000	EUR	84	63537912	63766562	228650
EUR_43	10000	EUR	84	64635938	64655885	19947
EUR_43	10000	EUR	84	67726807	67774483	47676
EUR_43	10000	EUR	84	69004995	69072506	67511
EUR_43	10000	EUR	84	69262441	69296795	34354
EUR_43	10000	EUR	84	70314329	70323506	9177
EUR_43	10000	EUR	84	71343174	71376679	33505
EUR_43	10000	EUR	84	72313374	72338979	25605
EUR_43	10000	EUR	84	74638673	74653919	15246
EUR_43	10000	EUR	84	74704171	74756907	52736
EUR_43	10000	EUR	84	78128495	78213775	85280
EUR_43	10000	EUR	84	80307017	80378472	71455
EUR_43	10000	EUR	84	84040452	84086635	46183
EUR_43	10000	EUR	84	84454434	84508973	54539
EUR_43	10000	EUR	84	84573291	84607732	34441
EUR_43	10000	EUR	84	86340983	86430822	89839
EUR_43	10000	EUR	84	96215188	96273194	58006
EUR_43	10000	EUR	84	96879365	97130504	251139
EUR_43	10000	EUR	84	97207860	97375516	167656
EUR_43	10000	EUR	85	8846483	8958572	112089
EUR_43	10000	EUR	85	10162900	10351635	188735
EUR_43	10000	EUR	85	11221129	11260836	39707
EUR_43	10000	EUR	85	12195294	12247244	51950
EUR_43	10000	EUR	85	12405520	12614071	208551
EUR_43	10000	EUR	85	12957537	13085270	127733
EUR_43	10000	EUR	85	14599834	14744959	145125
EUR_43	10000	EUR	85	15571100	15608201	37101
EUR_43	10000	EUR	85	21164886	21168829	3943
EUR_43	10000	EUR	85	21735053	21774213	39160
EUR_43	10000	EUR	85	21919460	21966961	47501
EUR_43	10000	EUR	85	23960602	24013504	52902
EUR_43	10000	EUR	85	28447913	28459172	11259
EUR_43	10000	EUR	85	30085525	30116933	31408
EUR_43	10000	EUR	85	30831946	30861389	29443
EUR_43	10000	EUR	85	31213935	31267996	54061
EUR_43	10000	EUR	85	31340450	31464998	124548
EUR_43	10000	EUR	85	32007672	32101976	94304
EUR_43	10000	EUR	85	35825437	35922358	96921
EUR_43	10000	EUR	85	39475823	39545103	69280
EUR_43	10000	EUR	85	39871917	39890454	18537
EUR_43	10000	EUR	85	41082532	41103899	21367
EUR_43	10000	EUR	85	43750662	43756156	5494
EUR_43	10000	EUR	85	44299125	44431264	132139
EUR_43	10000	EUR	85	45274093	45295441	21348
EUR_43	10000	EUR	85	45948492	45999654	51162
EUR_43	10000	EUR	85	47624392	47758303	133911
EUR_43	10000	EUR	85	48181642	48250239	68597
EUR_43	10000	EUR	85	48793399	48804986	11587
EUR_43	10000	EUR	85	48952912	49075471	122559
EUR_43	10000	EUR	85	49114975	49211922	96947
EUR_43	10000	EUR	85	49212244	49243818	31574
EUR_43	10000	EUR	85	50079988	50086485	6497
EUR_43	10000	EUR	85	50215570	50270346	54776
EUR_43	10000	EUR	85	50505922	50514335	8413
EUR_43	10000	EUR	85	50618884	50682125	63241
EUR_43	10000	EUR	85	54739518	54740924	1406
EUR_43	10000	EUR	85	56606415	56661029	54614
EUR_43	10000	EUR	85	56996794	57026186	29392
EUR_43	10000	EUR	85	60675915	60703119	27204
EUR_43	10000	EUR	85	62482898	62546166	63268
EUR_43	10000	EUR	85	62570596	62648920	78324
EUR_43	10000	EUR	85	62707428	62741636	34208
EUR_43	10000	EUR	85	63461724	63488070	26346
EUR_43	10000	EUR	85	64007129	64060264	53135
EUR_43	10000	EUR	85	64213067	64326150	113083
EUR_43	10000	EUR	85	64420562	64447738	27176
EUR_43	10000	EUR	85	68176301	68234683	58382
EUR_43	10000	EUR	85	69976346	70056767	80421
EUR_43	10000	EUR	85	70314329	70323506	9177
EUR_43	10000	EUR	85	70425266	70432857	7591
EUR_43	10000	EUR	85	73920589	74176524	255935
EUR_43	10000	EUR	85	74185839	74195965	10126
EUR_43	10000	EUR	85	74614046	74797490	183444
EUR_43	10000	EUR	85	76219599	76223870	4271
EUR_43	10000	EUR	85	77180956	77201979	21023
EUR_43	10000	EUR	85	78278359	78281355	2996
EUR_43	10000	EUR	85	79636078	79803495	167417
EUR_43	10000	EUR	85	81329834	81357575	27741
EUR_43	10000	EUR	85	82804246	82944067	139821
EUR_43	10000	EUR	85	84074915	84136758	61843
EUR_43	10000	EUR	85	84276859	84281776	4917
EUR_43	10000	EUR	85	84480189	84483142	2953
EUR_43	10000	EUR	85	86183232	86262769	79537
EUR_43	10000	EUR	85	96628171	96657524	29353
EUR_43	10000	EUR	85	96928157	96969240	41083
EUR_43	10000	EUR	85	97149005	97170445	21440
EUR_43	10000	EUR	85	97368034	97434688	66654
EUR_43	10000	EUR	85	97516792	97606042	89250
EUR_44	10000	EUR	86	0	24714	24714
EUR_44	10000	EUR	86	1443312	1474375	31063
EUR_44	10000	EUR	86	5883957	5891953	7996
EUR_44	10000	EUR	86	8009348	8063843	54495
EUR_44	10000	EUR	86	10310816	10435263	124447
EUR_44	10000	EUR	86	10455256	10468821	13565
EUR_44	10000	EUR	86	11741022	11836160	95138
EUR_44	10000	EUR	86	12195294	12394574	199280
EUR_44	10000	EUR	86	12517970	12560953	42983
EUR_44	10000	EUR	86	12959122	12989272	30150
EUR_44	10000	EUR	86	14623115	14669505	46390
EUR_44	10000	EUR	86	15638515	15740215	101700
EUR_44	10000	EUR	86	17889314	17924864	35550
EUR_44	10000	EUR	86	19445630	19544916	99286
EUR_44	10000	EUR	86	21386882	21774213	387331
EUR_44	10000	EUR	86	21919460	21966961	47501
EUR_44	10000	EUR	86	23507155	23578786	71631
EUR_44	10000	EUR	86	24787278	24800868	13590
EUR_44	10000	EUR	86	27030183	27120057	89874
EUR_44	10000	EUR	86	29749217	29751787	2570
EUR_44	10000	EUR	86	29885100	29938261	53161
EUR_44	10000	EUR	86	30048478	30113486	65008
EUR_44	10000	EUR	86	30678684	30730344	51660
EUR_44	10000	EUR	86	39536610	39538252	1642
EUR_44	10000	EUR	86	44469895	44701885	231990
EUR_44	10000	EUR	86	45064382	45131072	66690
EUR_44	10000	EUR	86	46821026	46854432	33406
EUR_44	10000	EUR	86	48181642	48246225	64583
EUR_44	10000	EUR	86	48291187	48321534	30347
EUR_44	10000	EUR	86	48942765	48992520	49755
EUR_44	10000	EUR	86	49135738	49184575	48837
EUR_44	10000	EUR	86	49422646	49489442	66796
EUR_44	10000	EUR	86	50256105	50340188	84083
EUR_44	10000	EUR	86	53185716	53302464	116748
EUR_44	10000	EUR	86	55365672	55376432	10760
EUR_44	10000	EUR	86	56642327	56661029	18702
EUR_44	10000	EUR	86	60314986	60335891	20905
EUR_44	10000	EUR	86	60587632	60595221	7589
EUR_44	10000	EUR	86	62312014	62343666	31652
EUR_44	10000	EUR	86	63418847	63437406	18559
EUR_44	10000	EUR	86	64669031	64775972	106941
EUR_44	10000	EUR	86	66778829	66850193	71364
EUR_44	10000	EUR	86	67890847	68012425	121578
EUR_44	10000	EUR	86	68340349	68341913	1564
EUR_44	10000	EUR	86	69253738	69254774	1036
EUR_44	10000	EUR	86	69262441	69296795	34354
EUR_44	10000	EUR	86	71334879	71336069	1190
EUR_44	10000	EUR	86	73920589	74226288	305699
EUR_44	10000	EUR	86	74345860	74386200	40340
EUR_44	10000	EUR	86	78278359	78281355	2996
EUR_44	10000	EUR	86	80307017	80378472	71455
EUR_44	10000	EUR	86	80884825	80887060	2235
EUR_44	10000	EUR	86	81329834	81359351	29517
EUR_44	10000	EUR	86	84271016	84413705	142689
EUR_44	10000	EUR	86	86446184	86468527	22343
EUR_44	10000	EUR	86	89233989	89360109	126120
EUR_44	10000	EUR	86	96344658	96351295	6637
EUR_44	10000	EUR	86	97295440	97321820	26380
EUR_44	10000	EUR	87	1443312	1474375	31063
EUR_44	10000	EUR	87	5738269	5741613	3344
EUR_44	10000	EUR	87	7764477	7852331	87854
EUR_44	10000	EUR	87	9629012	9637337	8325
EUR_44	10000	EUR	87	10162900	10265441	102541
EUR_44	10000	EUR	87	10504963	10525722	20759
EUR_44	10000	EUR	87	12446254	12649905	203651
EUR_44	10000	EUR	87	12689167	12733612	44445
EUR_44	10000	EUR	87	14760094	14813343	53249
EUR_44	10000	EUR	87	15571100	15608201	37101
EUR_44	10000	EUR	87	15682412	15721551	39139
EUR_44	10000	EUR	87	15929044	15971895	42851
EUR_44	10000	EUR	87	17067299	17323735	256436
EUR_44	10000	EUR	87	21935834	21965772	29938
EUR_44	10000	EUR	87	23678834	23696381	17547
EUR_44	10000	EUR	87	27030183	27120057	89874
EUR_44	10000	EUR	87	28447913	28454759	6846
EUR_44	10000	EUR	87	29749217	29774921	25704
EUR_44	10000	EUR	87	31952278	31976562	24284
EUR_44	10000	EUR	87	35825437	35920140	94703
EUR_44	10000	EUR	87	36536523	36541861	5338
EUR_44	10000	EUR	87	41190630	41244487	53857
EUR_44	10000	EUR	87	45965073	45977166	12093
EUR_44	10000	EUR	87	47624392	47634129	9737
EUR_44	10000	EUR	87	47874821	48095137	220316
EUR_44	10000	EUR	87	48273976	48321534	47558
EUR_44	10000	EUR	87	48942765	49071287	128522
EUR_44	10000	EUR	87	50090268	50262383	172115
EUR_44	10000	EUR	87	50289012	50456856	167844
EUR_44	10000	EUR	87	50514235	50542598	28363
EUR_44	10000	EUR	87	50654897	50675343	20446
EUR_44	10000	EUR	87	56981282	57026186	44904
EUR_44	10000	EUR	87	59025323	59087449	62126
EUR_44	10000	EUR	87	61977382	62000629	23247
EUR_44	10000	EUR	87	62427365	62685357	257992
EUR_44	10000	EUR	87	62900098	62995054	94956
EUR_44	10000	EUR	87	63239582	63277354	37772
EUR_44	10000	EUR	87	63330030	63370527	40497
EUR_44	10000	EUR	87	63947203	64060264	113061
EUR_44	10000	EUR	87	64877575	64919684	42109
EUR_44	10000	EUR	87	67242926	67246845	3919
EUR_44	10000	EUR	87	67683259	67732388	49129
EUR_44	10000	EUR	87	67796826	67809401	12575
EUR_44	10000	EUR	87	69976346	70056767	80421
EUR_44	10000	EUR	87	70314329	70323506	9177
EUR_44	10000	EUR	87	70425266	70432857	7591
EUR_44	10000	EUR	87	74165046	74332051	167005
EUR_44	10000	EUR	87	74661597	74663374	1777
EUR_44	10000	EUR	87	78278359	78281355	2996
EUR_44	10000	EUR	87	80790902	80831869	40967
EUR_44	10000	EUR	87	81009858	81010866	1008
EUR_44	10000	EUR	87	81329834	81344715	14881
EUR_44	10000	EUR	87	82777601	82808198	30597
EUR_44	10000	EUR	87	84174413	84277374	102961
EUR_44	10000	EUR	87	86960175	87018305	58130
EUR_44	10000	EUR	87	96344658	96551349	206691
EUR_44	10000	EUR	87	96731151	96795126	63975
EUR_44	10000	EUR	87	96935175	96957114	21939
EUR_45	10000	EUR	88	0	24714	24714
EUR_45	10000	EUR	88	5633934	5741613	107679
EUR_45	10000	EUR	88	7801499	8034150	232651
EUR_45	10000	EUR	88	10310816	10371329	60513
EUR_45	10000	EUR	88	11221129	11267811	46682
EUR_45	10000	EUR	88	12436919	12518164	81245
EUR_45	10000	EUR	88	12541608	12571424	29816
EUR_45	10000	EUR	88	13943659	14132248	188589
EUR_45	10000	EUR	88	14713216	14731414	18198
EUR_45	10000	EUR	88	15678424	15743283	64859
EUR_45	10000	EUR	88	21166394	21195469	29075
EUR_45	10000	EUR	88	21525308	21533742	8434
EUR_45	10000	EUR	88	23348628	23374530	25902
EUR_45	10000	EUR	88	23472367	23562645	90278
EUR_45	10000	EUR	88	24837759	24857143	19384
EUR_45	10000	EUR	88	25625985	25637091	11106
EUR_45	10000	EUR	88	27030183	27120057	89874
EUR_45	10000	EUR	88	30085525	30116933	31408
EUR_45	10000	EUR	88	31340450	31464998	124548
EUR_45	10000	EUR	88	33352525	33353174	649
EUR_45	10000	EUR	88	35842665	35878546	35881
EUR_45	10000	EUR	88	43774531	43842289	67758
EUR_45	10000	EUR	88	45274093	45295441	21348
EUR_45	10000	EUR	88	46644585	46669897	25312
EUR_45	10000	EUR	88	48806513	48831623	25110
EUR_45	10000	EUR	88	49074315	49126531	52216
EUR_45	10000	EUR	88	49641162	49707032	65870
EUR_45	10000	EUR	88	50079988	50148912	68924
EUR_45	10000	EUR	88	50214714	50504747	290033
EUR_45	10000	EUR	88	55372681	55376432	3751
EUR_45	10000	EUR	88	59749311	59778531	29220
EUR_45	10000	EUR	88	60361404	60623780	262376
EUR_45	10000	EUR	88	60836692	60850995	14303
EUR_45	10000	EUR	88	62363965	62421852	57887
EUR_45	10000	EUR	88	62454345	62460553	6208
EUR_45	10000	EUR	88	62587181	62648920	61739
EUR_45	10000	EUR	88	62707428	62851872	144444
EUR_45	10000	EUR	88	63488006	63488070	64
EUR_45	10000	EUR	88	67778276	67782844	4568
EUR_45	10000	EUR	88	67993239	68056363	63124
EUR_45	10000	EUR	88	70425266	70452650	27384
EUR_45	10000	EUR	88	71343174	71376679	33505
EUR_45	10000	EUR	88	73920589	74112795	192206
EUR_45	10000	EUR	88	74704171	74781759	77588
EUR_45	10000	EUR	88	78626655	78660130	33475
EUR_45	10000	EUR	88	80925593	80961424	35831
EUR_45	10000	EUR	88	82740735	82787554	46819
EUR_45	10000	EUR	88	91097171	91116161	18990
EUR_45	10000	EUR	88	96344658	96968880	624222
EUR_45	10000	EUR	88	97428913	97507231	78318
EUR_45	10000	EUR	88	97591041	97612012	20971
EUR_45	10000	EUR	88	98420167	98443847	23680
EUR_45	10000	EUR	89	5515391	5560949	45558
EUR_45	10000	EUR	89	5689746	5710946	21200
EUR_45	10000	EUR	89	10504963	10559629	54666
EUR_45	10000	EUR	89	12446254	12649905	203651
EUR_45	10000	EUR	89	13943659	14132248	188589
EUR_45	10000	EUR	89	15666565	15672229	5664
EUR_45	10000	EUR	89	16998973	17115665	116692
EUR_45	10000	EUR	89	19445931	19447994	2063
EUR_45	10000	EUR	89	19700871	19708863	7992
EUR_45	10000	EUR	89	21218489	21258286	39797
EUR_45	10000	EUR	89	23414479	23438353	23874
EUR_45	10000	EUR	89	27030183	27120057	89874
EUR_45	10000	EUR	89	28730691	28751710	21019
EUR_45	10000	EUR	89	29310108	29386346	76238
EUR_45	10000	EUR	89	29749217	29774921	25704
EUR_45	10000	EUR	89	29853109	29862527	9418
EUR_45	10000	EUR	89	30528228	30561025	32797
EUR_45	10000	EUR	89	30931120	31134052	202932
EUR_45	10000	EUR	89	31340450	31464998	124548
EUR_45	10000	EUR	89	31953948	32101976	148028
EUR_45	10000	EUR	89	44915345	45077292	161947
EUR_45	10000	EUR	89	45737512	45742393	4881
EUR_45	10000	EUR	89	46215539	46222689	7150
EUR_45	10000	EUR	89	47978647	47988634	9987
EUR_45	10000	EUR	89	48181642	48250239	68597
EUR_45	10000	EUR	89	48806513	48831623	25110
EUR_45	10000	EUR	89	48993613	49054357	60744
EUR_45	10000	EUR	89	49648154	50108086	459932
EUR_45	10000	EUR	89	50199687	50220042	20355
EUR_45	10000	EUR	89	50336407	50340188	3781
EUR_45	10000	EUR	89	50505922	50514335	8413
EUR_45	10000	EUR	89	50618884	50682125	63241
EUR_45	10000	EUR	89	55372681	55376432	3751
EUR_45	10000	EUR	89	59025323	59087449	62126
EUR_45	10000	EUR	89	60836692	60850995	14303
EUR_45	10000	EUR	89	62290128	62360303	70175
EUR_45	10000	EUR	89	62571477	62571923	446
EUR_45	10000	EUR	89	62672738	62763590	90852
EUR_45	10000	EUR	89	63354466	63517969	163503
EUR_45	10000	EUR	89	64620624	64648825	28201
EUR_45	10000	EUR	89	67516377	67530122	13745
EUR_45	10000	EUR	89	68176301	68234683	58382
EUR_45	10000	EUR	89	70178120	70180545	2425
EUR_45	10000	EUR	89	70314329	70323506	9177
EUR_45	10000	EUR	89	70425266	70432857	7591
EUR_45	10000	EUR	89	71187459	71336069	148610
EUR_45	10000	EUR	89	74165046	74174221	9175
EUR_45	10000	EUR	89	74638673	74738201	99528
EUR_45	10000	EUR	89	82712051	82804103	92052
EUR_45	10000	EUR	89	82937424	83035646	98222
EUR_45	10000	EUR	89	84051369	84087948	36579
EUR_45	10000	EUR	89	84307433	84476006	168573
EUR_45	10000	EUR	89	85095833	85104111	8278
EUR_45	10000	EUR	89	93588756	93660617	71861
EUR_45	10000	EUR	89	96928157	96969240	41083
EUR_45	10000	EUR	89	97149005	97170445	21440
EUR_45	10000	EUR	89	97368034	97434688	66654
EUR_45	10000	EUR	89	97516792	97606042	89250
EUR_46	10000	EUR	90	0	38454	38454
EUR_46	10000	EUR	90	2311146	2417674	106528
EUR_46	10000	EUR	90	8037923	8069680	31757
EUR_46	10000	EUR	90	8846483	8958572	112089
EUR_46	10000	EUR	90	10195098	10208942	13844
EUR_46	10000	EUR	90	10547312	10559629	12317
EUR_46	10000	EUR	90	11155402	11162329	6927
EUR_46	10000	EUR	90	12436919	12498874	61955
EUR_46	10000	EUR	90	14719006	14731414	12408
EUR_46	10000	EUR	90	15678424	15743283	64859
EUR_46	10000	EUR	90	15920084	15929214	9130
EUR_46	10000	EUR	90	21489581	21558457	68876
EUR_46	10000	EUR	90	21935834	21965772	29938
EUR_46	10000	EUR	90	24003989	24040521	36532
EUR_46	10000	EUR	90	26757616	27016672	259056
EUR_46	10000	EUR	90	29256822	29403219	146397
EUR_46	10000	EUR	90	41241594	41253549	11955
EUR_46	10000	EUR	90	43768000	43785095	17095
EUR_46	10000	EUR	90	44243666	44287999	44333
EUR_46	10000	EUR	90	45980594	46044606	64012
EUR_46	10000	EUR	90	46254910	46287015	32105
EUR_46	10000	EUR	90	48273976	48321534	47558
EUR_46	10000	EUR	90	48988140	49057058	68918
EUR_46	10000	EUR	90	49915595	50063922	148327
EUR_46	10000	EUR	90	50135685	50340188	204503
EUR_46	10000	EUR	90	50481676	50682125	200449
EUR_46	10000	EUR	90	53307869	53387076	79207
EUR_46	10000	EUR	90	60391758	60473482	81724
EUR_46	10000	EUR	90	62707428	62886738	179310
EUR_46	10000	EUR	90	63197303	63217814	20511
EUR_46	10000	EUR	90	63974015	64013981	39966
EUR_46	10000	EUR	90	64050970	64066021	15051
EUR_46	10000	EUR	90	64259771	64326150	66379
EUR_46	10000	EUR	90	65392456	65439431	46975
EUR_46	10000	EUR	90	67726807	67774483	47676
EUR_46	10000	EUR	90	68511602	68551456	39854
EUR_46	10000	EUR	90	69004995	69072506	67511
EUR_46	10000	EUR	90	70314329	70323506	9177
EUR_46	10000	EUR	90	71501268	71509363	8095
EUR_46	10000	EUR	90	74704171	74781759	77588
EUR_46	10000	EUR	90	77940158	77981834	41676
EUR_46	10000	EUR	90	84457805	84508973	51168
EUR_46	10000	EUR	90	85268776	85314478	45702
EUR_46	10000	EUR	90	86183232	86262769	79537
EUR_46	10000	EUR	90	95549067	95706836	157769
EUR_46	10000	EUR	90	96344658	96391048	46390
EUR_46	10000	EUR	90	97100087	97197807	97720
EUR_46	10000	EUR	90	97198885	97229983	31098
EUR_46	10000	EUR	90	97368034	97434688	66654
EUR_46	10000	EUR	90	97516792	97606042	89250
EUR_46	10000	EUR	91	994187	1035072	40885
EUR_46	10000	EUR	91	5623952	5720427	96475
EUR_46	10000	EUR	91	8009348	8069680	60332
EUR_46	10000	EUR	91	10162900	10335169	172269
EUR_46	10000	EUR	91	12402534	12421454	18920
EUR_46	10000	EUR	91	13096243	13191657	95414
EUR_46	10000	EUR	91	15607322	15740215	132893
EUR_46	10000	EUR	91	17270851	17273048	2197
EUR_46	10000	EUR	91	19569358	19651006	81648
EUR_46	10000	EUR	91	21489581	21558457	68876
EUR_46	10000	EUR	91	23480055	23525224	45169
EUR_46	10000	EUR	91	23678834	23696381	17547
EUR_46	10000	EUR	91	23923937	24061376	137439
EUR_46	10000	EUR	91	26757616	26872978	115362
EUR_46	10000	EUR	91	28447913	28473925	26012
EUR_46	10000	EUR	91	29755007	29767219	12212
EUR_46	10000	EUR	91	30557628	30641876	84248
EUR_46	10000	EUR	91	31303461	31362466	59005
EUR_46	10000	EUR	91	31869080	31976562	107482
EUR_46	10000	EUR	91	43321108	43338312	17204
EUR_46	10000	EUR	91	48152063	48429959	277896
EUR_46	10000	EUR	91	49716678	49797331	80653
EUR_46	10000	EUR	91	50079988	50086485	6497
EUR_46	10000	EUR	91	50215570	50270346	54776
EUR_46	10000	EUR	91	50505922	50514335	8413
EUR_46	10000	EUR	91	50618884	50682125	63241
EUR_46	10000	EUR	91	54393191	54424698	31507
EUR_46	10000	EUR	91	55692248	55747582	55334
EUR_46	10000	EUR	91	55892211	56019725	127514
EUR_46	10000	EUR	91	60314986	60406009	91023
EUR_46	10000	EUR	91	60675915	60703119	27204
EUR_46	10000	EUR	91	62363965	62421852	57887
EUR_46	10000	EUR	91	62584114	62613178	29064
EUR_46	10000	EUR	91	62727287	62886738	159451
EUR_46	10000	EUR	91	63418847	63437406	18559
EUR_46	10000	EUR	91	64275342	64277727	2385
EUR_46	10000	EUR	91	64689850	64713211	23361
EUR_46	10000	EUR	91	64779628	64968332	188704
EUR_46	10000	EUR	91	68176301	68234683	58382
EUR_46	10000	EUR	91	70314329	70323506	9177
EUR_46	10000	EUR	91	71214523	71270702	56179
EUR_46	10000	EUR	91	73344343	73357038	12695
EUR_46	10000	EUR	91	77940158	77981834	41676
EUR_46	10000	EUR	91	81962315	82042725	80410
EUR_46	10000	EUR	91	86448717	86466441	17724
EUR_46	10000	EUR	91	93241661	93307742	66081
EUR_46	10000	EUR	91	93926019	93935697	9678
EUR_46	10000	EUR	91	95549067	95706836	157769
EUR_46	10000	EUR	91	96344658	96391048	46390
EUR_46	10000	EUR	91	97100087	97197807	97720
EUR_46	10000	EUR	91	97198885	97229983	31098
EUR_46	10000	EUR	91	97398476	97743855	345379
EUR_47	10000	EUR	92	994187	1035072	40885
EUR_47	10000	EUR	92	8023767	8024855	1088
EUR_47	10000	EUR	92	12217850	12231489	13639
EUR_47	10000	EUR	92	12283210	12367555	84345
EUR_47	10000	EUR	92	15617938	15652655	34717
EUR_47	10000	EUR	92	19528439	19583445	55006
EUR_47	10000	EUR	92	23507155	23562645	55490
EUR_47	10000	EUR	92	24655151	24693848	38697
EUR_47	10000	EUR	92	26757616	26827636	70020
EUR_47	10000	EUR	92	27582949	27637833	54884
EUR_47	10000	EUR	92	31039633	31176694	137061
EUR_47	10000	EUR	92	31303461	31362466	59005
EUR_47	10000	EUR	92	31413310	31464998	51688
EUR_47	10000	EUR	92	32052821	32101976	49155
EUR_47	10000	EUR	92	41808814	41826713	17899
EUR_47	10000	EUR	92	43750662	43798852	48190
EUR_47	10000	EUR	92	44253582	44269926	16344
EUR_47	10000	EUR	92	44299125	44431264	132139
EUR_47	10000	EUR	92	46430949	46432260	1311
EUR_47	10000	EUR	92	47624392	47760170	135778
EUR_47	10000	EUR	92	49006754	49067165	60411
EUR_47	10000	EUR	92	49693701	49778991	85290
EUR_47	10000	EUR	92	49938053	50340188	402135
EUR_47	10000	EUR	92	55662959	55747582	84623
EUR_47	10000	EUR	92	55892211	56019725	127514
EUR_47	10000	EUR	92	59025323	59087449	62126
EUR_47	10000	EUR	92	61881873	62049844	167971
EUR_47	10000	EUR	92	62266230	62343666	77436
EUR_47	10000	EUR	92	63212342	63220501	8159
EUR_47	10000	EUR	92	64620624	64648825	28201
EUR_47	10000	EUR	92	66667736	66822356	154620
EUR_47	10000	EUR	92	67982434	67997999	15565
EUR_47	10000	EUR	92	68044654	68168599	123945
EUR_47	10000	EUR	92	71334879	71336069	1190
EUR_47	10000	EUR	92	78020485	78031382	10897
EUR_47	10000	EUR	92	78278359	78281355	2996
EUR_47	10000	EUR	92	80751058	80830440	79382
EUR_47	10000	EUR	92	80947447	80965346	17899
EUR_47	10000	EUR	92	86934249	87004998	70749
EUR_47	10000	EUR	92	93789189	93826724	37535
EUR_47	10000	EUR	92	96344658	96478190	133532
EUR_47	10000	EUR	92	96599275	96652091	52816
EUR_47	10000	EUR	92	96652259	96688015	35756
EUR_47	10000	EUR	92	96906437	96969240	62803
EUR_47	10000	EUR	92	97149005	97170445	21440
EUR_47	10000	EUR	92	97516792	97544370	27578
EUR_47	10000	EUR	93	1443312	1474375	31063
EUR_47	10000	EUR	93	5865668	5971269	105601
EUR_47	10000	EUR	93	8004685	8026219	21534
EUR_47	10000	EUR	93	8846483	8958572	112089
EUR_47	10000	EUR	93	10162900	10265441	102541
EUR_47	10000	EUR	93	10504963	10525722	20759
EUR_47	10000	EUR	93	12195294	12296077	100783
EUR_47	10000	EUR	93	13864408	13957627	93219
EUR_47	10000	EUR	93	14623115	14669505	46390
EUR_47	10000	EUR	93	15607322	15740215	132893
EUR_47	10000	EUR	93	16985162	17115665	130503
EUR_47	10000	EUR	93	17270851	17295109	24258
EUR_47	10000	EUR	93	21737927	21766730	28803
EUR_47	10000	EUR	93	21773238	21828855	55617
EUR_47	10000	EUR	93	23626899	23638658	11759
EUR_47	10000	EUR	93	28447913	28454759	6846
EUR_47	10000	EUR	93	29249415	29316758	67343
EUR_47	10000	EUR	93	29885100	30020785	135685
EUR_47	10000	EUR	93	30528228	30590405	62177
EUR_47	10000	EUR	93	31391393	31407691	16298
EUR_47	10000	EUR	93	31862751	31930228	67477
EUR_47	10000	EUR	93	41190630	41244487	53857
EUR_47	10000	EUR	93	45948492	45999654	51162
EUR_47	10000	EUR	93	46238893	46277873	38980
EUR_47	10000	EUR	93	48957046	48987944	30898
EUR_47	10000	EUR	93	49094046	49139016	44970
EUR_47	10000	EUR	93	49206724	49211922	5198
EUR_47	10000	EUR	93	49807803	50150613	342810
EUR_47	10000	EUR	93	50292505	50340188	47683
EUR_47	10000	EUR	93	54352751	54424698	71947
EUR_47	10000	EUR	93	55736070	55767126	31056
EUR_47	10000	EUR	93	59040258	59081813	41555
EUR_47	10000	EUR	93	59749311	59778531	29220
EUR_47	10000	EUR	93	62489657	62546944	57287
EUR_47	10000	EUR	93	63400955	63488070	87115
EUR_47	10000	EUR	93	67516377	67544360	27983
EUR_47	10000	EUR	93	67885356	68012425	127069
EUR_47	10000	EUR	93	68060953	68219989	159036
EUR_47	10000	EUR	93	70459841	70471952	12111
EUR_47	10000	EUR	93	74640430	74642331	1901
EUR_47	10000	EUR	93	81849638	81877251	27613
EUR_47	10000	EUR	93	82902329	83015877	113548
EUR_47	10000	EUR	93	84074915	84136758	61843
EUR_47	10000	EUR	93	84338892	84476006	137114
EUR_47	10000	EUR	93	92671111	92820212	149101
EUR_47	10000	EUR	93	96580037	96652091	72054
EUR_47	10000	EUR	93	96652259	96679642	27383
EUR_47	10000	EUR	93	96968543	96969240	697
EUR_48	10000	EUR	94	10607	24714	14107
EUR_48	10000	EUR	94	257772	317557	59785
EUR_48	10000	EUR	94	994187	1035072	40885
EUR_48	10000	EUR	94	5948579	5963046	14467
EUR_48	10000	EUR	94	8922196	8953694	31498
EUR_48	10000	EUR	94	10310816	10559629	248813
EUR_48	10000	EUR	94	13864885	13899355	34470
EUR_48	10000	EUR	94	14760094	14813343	53249
EUR_48	10000	EUR	94	15678424	15743283	64859
EUR_48	10000	EUR	94	19347750	19378646	30896
EUR_48	10000	EUR	94	19445931	19447994	2063
EUR_48	10000	EUR	94	21282427	21582697	300270
EUR_48	10000	EUR	94	23472367	23533637	61270
EUR_48	10000	EUR	94	24049960	24061376	11416
EUR_48	10000	EUR	94	24837759	24857143	19384
EUR_48	10000	EUR	94	25625985	25637091	11106
EUR_48	10000	EUR	94	27563461	27652140	88679
EUR_48	10000	EUR	94	30838706	30998466	159760
EUR_48	10000	EUR	94	31048766	31088907	40141
EUR_48	10000	EUR	94	31127128	31197466	70338
EUR_48	10000	EUR	94	32453173	32511362	58189
EUR_48	10000	EUR	94	35842665	35978953	136288
EUR_48	10000	EUR	94	41698837	41705026	6189
EUR_48	10000	EUR	94	43768000	43770888	2888
EUR_48	10000	EUR	94	44299125	44431264	132139
EUR_48	10000	EUR	94	44991454	45001814	10360
EUR_48	10000	EUR	94	45326266	45335213	8947
EUR_48	10000	EUR	94	47624392	47760170	135778
EUR_48	10000	EUR	94	47917773	48089703	171930
EUR_48	10000	EUR	94	48181642	48246225	64583
EUR_48	10000	EUR	94	48291187	48321534	30347
EUR_48	10000	EUR	94	48942765	49098256	155491
EUR_48	10000	EUR	94	49716678	49823430	106752
EUR_48	10000	EUR	94	50079988	50086485	6497
EUR_48	10000	EUR	94	50097255	50255701	158446
EUR_48	10000	EUR	94	50651894	50675343	23449
EUR_48	10000	EUR	94	56646775	56670627	23852
EUR_48	10000	EUR	94	59749311	59778531	29220
EUR_48	10000	EUR	94	60340797	60366947	26150
EUR_48	10000	EUR	94	60675915	60703119	27204
EUR_48	10000	EUR	94	62358424	62360148	1724
EUR_48	10000	EUR	94	62384821	62405059	20238
EUR_48	10000	EUR	94	62529172	62534818	5646
EUR_48	10000	EUR	94	62679237	62680258	1021
EUR_48	10000	EUR	94	62742890	62886738	143848
EUR_48	10000	EUR	94	63177292	63220501	43209
EUR_48	10000	EUR	94	63687742	63775905	88163
EUR_48	10000	EUR	94	64993828	65025826	31998
EUR_48	10000	EUR	94	66942688	67022791	80103
EUR_48	10000	EUR	94	67043600	67142501	98901
EUR_48	10000	EUR	94	68501694	68552706	51012
EUR_48	10000	EUR	94	69004995	69072506	67511
EUR_48	10000	EUR	94	69230927	69315282	84355
EUR_48	10000	EUR	94	70314329	70323506	9177
EUR_48	10000	EUR	94	71501268	71509363	8095
EUR_48	10000	EUR	94	74185839	74211177	25338
EUR_48	10000	EUR	94	74638673	74738201	99528
EUR_48	10000	EUR	94	80106200	80125347	19147
EUR_48	10000	EUR	94	80307017	80378472	71455
EUR_48	10000	EUR	94	84495585	84512149	16564
EUR_48	10000	EUR	94	89347311	89360109	12798
EUR_48	10000	EUR	94	96404550	96451210	46660
EUR_48	10000	EUR	95	0	38454	38454
EUR_48	10000	EUR	95	2550449	2651211	100762
EUR_48	10000	EUR	95	5738269	5741613	3344
EUR_48	10000	EUR	95	8846483	8933755	87272
EUR_48	10000	EUR	95	9051485	9091881	40396
EUR_48	10000	EUR	95	10195098	10229013	33915
EUR_48	10000	EUR	95	10310816	10371329	60513
EUR_48	10000	EUR	95	11782696	11836160	53464
EUR_48	10000	EUR	95	12971780	12992919	21139
EUR_48	10000	EUR	95	15651184	15701244	50060
EUR_48	10000	EUR	95	15783892	15821860	37968
EUR_48	10000	EUR	95	18850191	18885640	35449
EUR_48	10000	EUR	95	19205162	19218710	13548
EUR_48	10000	EUR	95	19375630	19454354	78724
EUR_48	10000	EUR	95	19519830	19724249	204419
EUR_48	10000	EUR	95	21471760	21526260	54500
EUR_48	10000	EUR	95	21737927	21766730	28803
EUR_48	10000	EUR	95	23480055	23517332	37277
EUR_48	10000	EUR	95	24655151	24663032	7881
EUR_48	10000	EUR	95	29885100	30020785	135685
EUR_48	10000	EUR	95	35842665	36017172	174507
EUR_48	10000	EUR	95	40040672	40088009	47337
EUR_48	10000	EUR	95	43750662	43798852	48190
EUR_48	10000	EUR	95	46345940	46424629	78689
EUR_48	10000	EUR	95	46603480	46692826	89346
EUR_48	10000	EUR	95	47672056	47744901	72845
EUR_48	10000	EUR	95	48240560	48246225	5665
EUR_48	10000	EUR	95	49039217	49084376	45159
EUR_48	10000	EUR	95	49720102	50042489	322387
EUR_48	10000	EUR	95	50079988	50086485	6497
EUR_48	10000	EUR	95	50256105	50315884	59779
EUR_48	10000	EUR	95	51721135	51733712	12577
EUR_48	10000	EUR	95	55663984	55704084	40100
EUR_48	10000	EUR	95	55891681	55921875	30194
EUR_48	10000	EUR	95	56981282	57026186	44904
EUR_48	10000	EUR	95	60569371	60623780	54409
EUR_48	10000	EUR	95	62266230	62343666	77436
EUR_48	10000	EUR	95	63177292	63245436	68144
EUR_48	10000	EUR	95	64786335	64809344	23009
EUR_48	10000	EUR	95	66942688	67022791	80103
EUR_48	10000	EUR	95	67043600	67142501	98901
EUR_48	10000	EUR	95	67516377	67558609	42232
EUR_48	10000	EUR	95	67890847	68012425	121578
EUR_48	10000	EUR	95	68186638	68219989	33351
EUR_48	10000	EUR	95	68543110	68564643	21533
EUR_48	10000	EUR	95	69004995	69072506	67511
EUR_48	10000	EUR	95	69292970	69296795	3825
EUR_48	10000	EUR	95	70459841	70471952	12111
EUR_48	10000	EUR	95	74071046	74226288	155242
EUR_48	10000	EUR	95	74345860	74386200	40340
EUR_48	10000	EUR	95	74614046	74797490	183444
EUR_48	10000	EUR	95	78278359	78281355	2996
EUR_48	10000	EUR	95	82712051	82804103	92052
EUR_48	10000	EUR	95	84051369	84087948	36579
EUR_48	10000	EUR	95	84307433	84476006	168573
EUR_48	10000	EUR	95	95549067	95706836	157769
EUR_48	10000	EUR	95	96344658	96391048	46390
EUR_48	10000	EUR	95	97100087	97197807	97720
EUR_48	10000	EUR	95	97198885	97229983	31098
EUR_48	10000	EUR	95	97398476	97690281	291805
EUR_49	10000	EUR	96	994187	1010735	16548
EUR_49	10000	EUR	96	1443312	1474375	31063
EUR_49	10000	EUR	96	2267390	2417674	150284
EUR_49	10000	EUR	96	12436919	12518164	81245
EUR_49	10000	EUR	96	12541608	12571424	29816
EUR_49	10000	EUR	96	12672627	12699501	26874
EUR_49	10000	EUR	96	14599834	14744959	145125
EUR_49	10000	EUR	96	16273954	16340550	66596
EUR_49	10000	EUR	96	17270851	17323735	52884
EUR_49	10000	EUR	96	19347750	19446442	98692
EUR_49	10000	EUR	96	19524348	19575541	51193
EUR_49	10000	EUR	96	19666607	19720116	53509
EUR_49	10000	EUR	96	21737927	21766730	28803
EUR_49	10000	EUR	96	21773238	21828855	55617
EUR_49	10000	EUR	96	26757616	27016672	259056
EUR_49	10000	EUR	96	29256822	29403219	146397
EUR_49	10000	EUR	96	30838706	30852727	14021
EUR_49	10000	EUR	96	31061901	31134052	72151
EUR_49	10000	EUR	96	31332044	31383101	51057
EUR_49	10000	EUR	96	31929110	31976562	47452
EUR_49	10000	EUR	96	35825437	35904356	78919
EUR_49	10000	EUR	96	43750662	43785095	34433
EUR_49	10000	EUR	96	45919475	46077353	157878
EUR_49	10000	EUR	96	47672056	47744901	72845
EUR_49	10000	EUR	96	48273976	48321534	47558
EUR_49	10000	EUR	96	48855561	48858490	2929
EUR_49	10000	EUR	96	49039217	49084376	45159
EUR_49	10000	EUR	96	49720102	49982793	262691
EUR_49	10000	EUR	96	50079988	50086485	6497
EUR_49	10000	EUR	96	50097255	50255701	158446
EUR_49	10000	EUR	96	50651894	50675343	23449
EUR_49	10000	EUR	96	51819962	51826252	6290
EUR_49	10000	EUR	96	56981282	57026186	44904
EUR_49	10000	EUR	96	59749311	59778531	29220
EUR_49	10000	EUR	96	62482898	62546166	63268
EUR_49	10000	EUR	96	62570596	62648920	78324
EUR_49	10000	EUR	96	62707428	62877379	169951
EUR_49	10000	EUR	96	63007192	63107506	100314
EUR_49	10000	EUR	96	64689850	64699331	9481
EUR_49	10000	EUR	96	64928401	64968332	39931
EUR_49	10000	EUR	96	66848687	66882708	34021
EUR_49	10000	EUR	96	67516377	67550551	34174
EUR_49	10000	EUR	96	67890847	67938542	47695
EUR_49	10000	EUR	96	68109254	68234683	125429
EUR_49	10000	EUR	96	74704171	74756907	52736
EUR_49	10000	EUR	96	79970884	79977985	7101
EUR_49	10000	EUR	96	80817797	80831869	14072
EUR_49	10000	EUR	96	80947447	80965346	17899
EUR_49	10000	EUR	96	84307433	84331408	23975
EUR_49	10000	EUR	96	85051489	85157686	106197
EUR_49	10000	EUR	96	87004058	87035154	31096
EUR_49	10000	EUR	96	88020002	88073004	53002
EUR_49	10000	EUR	96	89233989	89360109	126120
EUR_49	10000	EUR	96	92520516	92580187	59671
EUR_49	10000	EUR	96	96252522	96313082	60560
EUR_49	10000	EUR	96	96752356	96969240	216884
EUR_49	10000	EUR	96	97227283	97229983	2700
EUR_49	10000	EUR	96	97398476	97442009	43533
EUR_49	10000	EUR	96	97516792	97575825	59033
EUR_49	10000	EUR	97	196934	206962	10028
EUR_49	10000	EUR	97	1443312	1474375	31063
EUR_49	10000	EUR	97	2267390	2417674	150284
EUR_49	10000	EUR	97	8846483	8958572	112089
EUR_49	10000	EUR	97	10310816	10435263	124447
EUR_49	10000	EUR	97	11155402	11182816	27414
EUR_49	10000	EUR	97	11309495	11324870	15375
EUR_49	10000	EUR	97	12405520	12614071	208551
EUR_49	10000	EUR	97	12957537	13085270	127733
EUR_49	10000	EUR	97	14760094	14813343	53249
EUR_49	10000	EUR	97	15678424	15834274	155850
EUR_49	10000	EUR	97	19373385	19430386	57001
EUR_49	10000	EUR	97	19637776	19677675	39899
EUR_49	10000	EUR	97	19771179	19815522	44343
EUR_49	10000	EUR	97	27030183	27120057	89874
EUR_49	10000	EUR	97	28447913	28454759	6846
EUR_49	10000	EUR	97	29342204	29344643	2439
EUR_49	10000	EUR	97	29885100	30020785	135685
EUR_49	10000	EUR	97	33352525	33355723	3198
EUR_49	10000	EUR	97	35842665	36017172	174507
EUR_49	10000	EUR	97	39871917	39913649	41732
EUR_49	10000	EUR	97	41190630	41244487	53857
EUR_49	10000	EUR	97	45261940	45295441	33501
EUR_49	10000	EUR	97	46254910	46287015	32105
EUR_49	10000	EUR	97	47616446	47655444	38998
EUR_49	10000	EUR	97	47729196	47760170	30974
EUR_49	10000	EUR	97	47917773	48089703	171930
EUR_49	10000	EUR	97	48974035	48976390	2355
EUR_49	10000	EUR	97	49039217	49084376	45159
EUR_49	10000	EUR	97	49108894	49211922	103028
EUR_49	10000	EUR	97	49716678	49823430	106752
EUR_49	10000	EUR	97	50079988	50086485	6497
EUR_49	10000	EUR	97	50097255	50255701	158446
EUR_49	10000	EUR	97	50651894	50675343	23449
EUR_49	10000	EUR	97	54352751	54424698	71947
EUR_49	10000	EUR	97	59025323	59087449	62126
EUR_49	10000	EUR	97	62583575	62662553	78978
EUR_49	10000	EUR	97	62808211	62809146	935
EUR_49	10000	EUR	97	63010595	63041174	30579
EUR_49	10000	EUR	97	63189307	63277354	88047
EUR_49	10000	EUR	97	63345194	63367008	21814
EUR_49	10000	EUR	97	67516377	67558609	42232
EUR_49	10000	EUR	97	67890847	68012425	121578
EUR_49	10000	EUR	97	68186638	68219989	33351
EUR_49	10000	EUR	97	68543110	68564643	21533
EUR_49	10000	EUR	97	70178120	70180545	2425
EUR_49	10000	EUR	97	71334879	71336069	1190
EUR_49	10000	EUR	97	75164494	75227717	63223
EUR_49	10000	EUR	97	80903139	80932876	29737
EUR_49	10000	EUR	97	81329834	81397143	67309
EUR_49	10000	EUR	97	84307433	84457650	150217
EUR_49	10000	EUR	97	84596514	84597943	1429
EUR_49	10000	EUR	97	96344658	96478190	133532
EUR_49	10000	EUR	97	96599275	96652091	52816
EUR_49	10000	EUR	97	96652259	96688015	35756
EUR_49	10000	EUR	97	96906437	96969240	62803
EUR_49	10000	EUR	97	97149005	97170445	21440
EUR_49	10000	EUR	97	97516792	97544370	27578
EUR_50	10000	EUR	98	7764477	7852331	87854
EUR_50	10000	EUR	98	11741022	11836160	95138
EUR_50	10000	EUR	98	12414121	12471082	56961
EUR_50	10000	EUR	98	12517970	12571424	53454
EUR_50	10000	EUR	98	12992001	13029529	37528
EUR_50	10000	EUR	98	13853765	13899355	45590
EUR_50	10000	EUR	98	15617938	15689350	71412
EUR_50	10000	EUR	98	15954482	16019493	65011
EUR_50	10000	EUR	98	19445931	19447994	2063
EUR_50	10000	EUR	98	19720323	19815522	95199
EUR_50	10000	EUR	98	21164886	21168829	3943
EUR_50	10000	EUR	98	23793798	23916509	122711
EUR_50	10000	EUR	98	29885100	30020785	135685
EUR_50	10000	EUR	98	31069796	31225571	155775
EUR_50	10000	EUR	98	31340450	31464998	124548
EUR_50	10000	EUR	98	31934278	31976562	42284
EUR_50	10000	EUR	98	43768000	43770888	2888
EUR_50	10000	EUR	98	44299125	44431264	132139
EUR_50	10000	EUR	98	44991454	45007478	16024
EUR_50	10000	EUR	98	46644585	46646042	1457
EUR_50	10000	EUR	98	49039217	49084376	45159
EUR_50	10000	EUR	98	49108894	49211922	103028
EUR_50	10000	EUR	98	49423645	49451224	27579
EUR_50	10000	EUR	98	49720102	50108086	387984
EUR_50	10000	EUR	98	50287644	50340188	52544
EUR_50	10000	EUR	98	55663984	55704084	40100
EUR_50	10000	EUR	98	55891681	55921875	30194
EUR_50	10000	EUR	98	62781664	62797882	16218
EUR_50	10000	EUR	98	62860595	63151646	291051
EUR_50	10000	EUR	98	63974015	64060264	86249
EUR_50	10000	EUR	98	64939632	64968332	28700
EUR_50	10000	EUR	98	67796826	68012425	215599
EUR_50	10000	EUR	98	70178120	70180545	2425
EUR_50	10000	EUR	98	73164377	73165766	1389
EUR_50	10000	EUR	98	76219599	76223870	4271
EUR_50	10000	EUR	98	78278359	78281355	2996
EUR_50	10000	EUR	98	82779823	82867077	87254
EUR_50	10000	EUR	98	86340983	86466441	125458
EUR_50	10000	EUR	98	92837215	92870243	33028
EUR_50	10000	EUR	98	96230890	96320937	90047
EUR_50	10000	EUR	99	9913	16835	6922
EUR_50	10000	EUR	99	305536	317557	12021
EUR_50	10000	EUR	99	5865668	5971269	105601
EUR_50	10000	EUR	99	8062404	8069680	7276
EUR_50	10000	EUR	99	10328334	10351635	23301
EUR_50	10000	EUR	99	10475874	10559629	83755
EUR_50	10000	EUR	99	12199512	12247078	47566
EUR_50	10000	EUR	99	12607169	12649905	42736
EUR_50	10000	EUR	99	16387387	16444740	57353
EUR_50	10000	EUR	99	19373601	19465227	91626
EUR_50	10000	EUR	99	20934893	20952589	17696
EUR_50	10000	EUR	99	21381193	21413207	32014
EUR_50	10000	EUR	99	23507155	23578786	71631
EUR_50	10000	EUR	99	30838706	30960757	122051
EUR_50	10000	EUR	99	31340450	31432165	91715
EUR_50	10000	EUR	99	31869080	31976562	107482
EUR_50	10000	EUR	99	40927141	41034990	107849
EUR_50	10000	EUR	99	43690494	43703982	13488
EUR_50	10000	EUR	99	44253582	44296925	43343
EUR_50	10000	EUR	99	48793399	48832663	39264
EUR_50	10000	EUR	99	49807803	49877351	69548
EUR_50	10000	EUR	99	50214714	50344415	129701
EUR_50	10000	EUR	99	56642327	56661029	18702
EUR_50	10000	EUR	99	59025323	59087449	62126
EUR_50	10000	EUR	99	60541769	60585416	43647
EUR_50	10000	EUR	99	60587632	60595221	7589
EUR_50	10000	EUR	99	60836692	60901803	65111
EUR_50	10000	EUR	99	62292834	62367041	74207
EUR_50	10000	EUR	99	62489657	62546166	56509
EUR_50	10000	EUR	99	62872963	62886738	13775
EUR_50	10000	EUR	99	64635938	64775972	140034
EUR_50	10000	EUR	99	68201188	68219989	18801
EUR_50	10000	EUR	99	69253738	69280158	26420
EUR_50	10000	EUR	99	70459841	70471952	12111
EUR_50	10000	EUR	99	72374762	72393031	18269
EUR_50	10000	EUR	99	73164377	73261259	96882
EUR_50	10000	EUR	99	73483646	73508952	25306
EUR_50	10000	EUR	99	74609427	74738201	128774
EUR_50	10000	EUR	99	78626655	78660130	33475
EUR_50	10000	EUR	99	80817797	80831869	14072
EUR_50	10000	EUR	99	80947447	80965346	17899
EUR_50	10000	EUR	99	81329834	81395863	66029
EUR_50	10000	EUR	99	84307433	84476006	168573
EUR_50	10000	EUR	99	86446184	86468527	22343
EUR_50	10000	EUR	99	93588756	93660617	71861
EUR_50	10000	EUR	99	95645847	95658276	12429
EUR_50	10000	EUR	99	96949071	96969240	20169
EUR_51	0	EUR	100	1443312	1474375	31063
EUR_51	0	EUR	100	7801499	8034150	232651
EUR_51	0	EUR	100	14713216	14731414	18198
EUR_51	0	EUR	100	14834975	14884113	49138
EUR_51	0	EUR	100	15571100	15608201	37101
EUR_51	0	EUR	100	17029181	17031678	2497
EUR_51	0	EUR	100	17270851	17280159	9308
EUR_51	0	EUR	100	19373385	19430386	57001
EUR_51	0	EUR	100	19602987	19651006	48019
EUR_51	0	EUR	100	21164886	21168829	3943
EUR_51	0	EUR	100	21224562	21230787	6225
EUR_51	0	EUR	100	21282427	21309916	27489
EUR_51	0	EUR	100	21406424	21582697	176273
EUR_51	0	EUR	100	21747694	21774213	26519
EUR_51	0	EUR	100	24662518	24693848	31330
EUR_51	0	EUR	100	27612645	27651507	38862
EUR_51	0	EUR	100	29750374	29765658	15284
EUR_51	0	EUR	100	30085525	30116933	31408
EUR_51	0	EUR	100	30548261	30559727	11466
EUR_51	0	EUR	100	43750662	43785095	34433
EUR_51	0	EUR	100	46603480	46692826	89346
EUR_51	0	EUR	100	46859500	46939223	79723
EUR_51	0	EUR	100	47616446	47655444	38998
EUR_51	0	EUR	100	47729196	47760170	30974
EUR_51	0	EUR	100	47917773	48089703	171930
EUR_51	0	EUR	100	48181642	48205062	23420
EUR_51	0	EUR	100	48276995	48322546	45551
EUR_51	0	EUR	100	48828898	48852598	23700
EUR_51	0	EUR	100	49063282	49170836	107554
EUR_51	0	EUR	100	49716678	49797331	80653
EUR_51	0	EUR	100	49816501	50150613	334112
EUR_51	0	EUR	100	50292505	50340188	47683
EUR_51	0	EUR	100	50474678	50560553	85875
EUR_51	0	EUR	100	50644699	50682125	37426
EUR_51	0	EUR	100	55925348	55926399	1051
EUR_51	0	EUR	100	60697771	60713933	16162
EUR_51	0	EUR	100	62635211	62648920	13709
EUR_51	0	EUR	100	62707428	62828758	121330
EUR_51	0	EUR	100	64162479	64213081	50602
EUR_51	0	EUR	100	64569161	64602184	33023
EUR_51	0	EUR	100	66827940	66897711	69771
EUR_51	0	EUR	100	67683259	67732388	49129
EUR_51	0	EUR	100	67796826	67897086	100260
EUR_51	0	EUR	100	68098959	68113243	14284
EUR_51	0	EUR	100	69262441	69296795	34354
EUR_51	0	EUR	100	70459841	70471952	12111
EUR_51	0	EUR	100	70490827	70504344	13517
EUR_51	0	EUR	100	71501268	71509363	8095
EUR_51	0	EUR	100	74270667	74332051	61384
EUR_51	0	EUR	100	74704171	74781759	77588
EUR_51	0	EUR	100	74791668	74797490	5822
EUR_51	0	EUR	100	80106200	80125347	19147
EUR_51	0	EUR	100	80903139	80961424	58285
EUR_51	0	EUR	100	84271016	84413705	142689
EUR_51	0	EUR	100	85095833	85104111	8278
EUR_51	0	EUR	100	92520516	92580187	59671
EUR_51	0	EUR	100	92728134	92911223	183089
EUR_51	0	EUR	100	93177388	93225072	47684
EUR_51	0	EUR	100	96344658	96551349	206691
EUR_51	0	EUR	100	96628171	96660713	32542
EUR_51	0	EUR	100	96681114	96688015	6901
EUR_51	0	EUR	100	96935175	96957114	21939
EUR_51	0	EUR	100	97516792	97575825	59033
EUR_51	0	EUR	101	1443312	1474375	31063
EUR_51	0	EUR	101	2267390	2385052	117662
EUR_51	0	EUR	101	4152972	4155031	2059
EUR_51	0	EUR	101	7801499	8034150	232651
EUR_51	0	EUR	101	10310816	10377560	66744
EUR_51	0	EUR	101	11747221	11784014	36793
EUR_51	0	EUR	101	12959122	12973343	14221
EUR_51	0	EUR	101	14713216	14731414	18198
EUR_51	0	EUR	101	15610665	15740215	129550
EUR_51	0	EUR	101	17203552	17323735	120183
EUR_51	0	EUR	101	21282427	21407839	125412
EUR_51	0	EUR	101	21737927	21766730	28803
EUR_51	0	EUR	101	23626899	23638658	11759
EUR_51	0	EUR	101	23841284	23992422	151138
EUR_51	0	EUR	101	24532214	24693848	161634
EUR_51	0	EUR	101	29255894	29403219	147325
EUR_51	0	EUR	101	29885100	30020785	135685
EUR_51	0	EUR	101	30838706	30842964	4258
EUR_51	0	EUR	101	30865475	30888971	23496
EUR_51	0	EUR	101	31028668	31136194	107526
EUR_51	0	EUR	101	31250345	31265497	15152
EUR_51	0	EUR	101	31353256	31389551	36295
EUR_51	0	EUR	101	31869080	31878432	9352
EUR_51	0	EUR	101	32040761	32043285	2524
EUR_51	0	EUR	101	35825437	35904356	78919
EUR_51	0	EUR	101	40975976	40977328	1352
EUR_51	0	EUR	101	41006007	41034990	28983
EUR_51	0	EUR	101	43298198	43308912	10714
EUR_51	0	EUR	101	43751615	43813419	61804
EUR_51	0	EUR	101	44182199	44210284	28085
EUR_51	0	EUR	101	44289775	44376469	86694
EUR_51	0	EUR	101	44486264	44569851	83587
EUR_51	0	EUR	101	45023383	45093802	70419
EUR_51	0	EUR	101	46821026	46854432	33406
EUR_51	0	EUR	101	49039217	49084376	45159
EUR_51	0	EUR	101	49135738	49184575	48837
EUR_51	0	EUR	101	49396758	49409796	13038
EUR_51	0	EUR	101	49482251	49501602	19351
EUR_51	0	EUR	101	49641162	49707032	65870
EUR_51	0	EUR	101	49720102	49900687	180585
EUR_51	0	EUR	101	50214714	50260453	45739
EUR_51	0	EUR	101	50446207	50450081	3874
EUR_51	0	EUR	101	50645711	50682125	36414
EUR_51	0	EUR	101	51767197	51826252	59055
EUR_51	0	EUR	101	54482373	54485919	3546
EUR_51	0	EUR	101	59025323	59087449	62126
EUR_51	0	EUR	101	59749311	59778531	29220
EUR_51	0	EUR	101	60314986	60335172	20186
EUR_51	0	EUR	101	62499163	62511197	12034
EUR_51	0	EUR	101	64699193	64699609	416
EUR_51	0	EUR	101	66870916	66900890	29974
EUR_51	0	EUR	101	67233773	67246845	13072
EUR_51	0	EUR	101	67683259	67732388	49129
EUR_51	0	EUR	101	67796826	67809401	12575
EUR_51	0	EUR	101	68014994	68056363	41369
EUR_51	0	EUR	101	68153010	68234683	81673
EUR_51	0	EUR	101	69253738	69254774	1036
EUR_51	0	EUR	101	69262441	69296795	34354
EUR_51	0	EUR	101	71108569	71258872	150303
EUR_51	0	EUR	101	71343782	71387487	43705
EUR_51	0	EUR	101	74070851	74226288	155437
EUR_51	0	EUR	101	74345860	74386200	40340
EUR_51	0	EUR	101	74609427	74689986	80559
EUR_51	0	EUR	101	74695445	74723577	28132
EUR_51	0	EUR	101	76219599	76292558	72959
EUR_51	0	EUR	101	80903139	80943322	40183
EUR_51	0	EUR	101	84349720	84414420	64700
EUR_51	0	EUR	101	85051489	85104111	52622
EUR_51	0	EUR	101	89233989	89353223	119234
EUR_51	0	EUR	101	92657968	92893775	235807
EUR_51	0	EUR	101	96252522	96313082	60560
EUR_51	0	EUR	101	96599275	96652091	52816
EUR_51	0	EUR	101	96652259	96688015	35756
EUR_51	0	EUR	101	96934735	96969240	34505
EUR_51	0	EUR	101	97149005	97170445	21440
EUR_52	0	EUR	102	7915705	8034150	118445
EUR_52	0	EUR	102	10527272	10559629	32357
EUR_52	0	EUR	102	11221129	11267811	46682
EUR_52	0	EUR	102	14713216	14884113	170897
EUR_52	0	EUR	102	14897229	14909313	12084
EUR_52	0	EUR	102	17270851	17304430	33579
EUR_52	0	EUR	102	17318810	17323735	4925
EUR_52	0	EUR	102	19373385	19430386	57001
EUR_52	0	EUR	102	19602987	19651006	48019
EUR_52	0	EUR	102	21737927	21914523	176596
EUR_52	0	EUR	102	23697124	23853580	156456
EUR_52	0	EUR	102	29152773	29190448	37675
EUR_52	0	EUR	102	29201265	29403219	201954
EUR_52	0	EUR	102	31203931	31261283	57352
EUR_52	0	EUR	102	31270356	31294111	23755
EUR_52	0	EUR	102	31336316	31349680	13364
EUR_52	0	EUR	102	39871169	39913649	42480
EUR_52	0	EUR	102	41241594	41341058	99464
EUR_52	0	EUR	102	41449292	41503009	53717
EUR_52	0	EUR	102	43751615	43813419	61804
EUR_52	0	EUR	102	44367887	44431264	63377
EUR_52	0	EUR	102	45919475	46077353	157878
EUR_52	0	EUR	102	46202405	46222689	20284
EUR_52	0	EUR	102	47874821	48177386	302565
EUR_52	0	EUR	102	48794122	48832663	38541
EUR_52	0	EUR	102	48974035	49018779	44744
EUR_52	0	EUR	102	49051657	49139016	87359
EUR_52	0	EUR	102	49716678	49806831	90153
EUR_52	0	EUR	102	50040990	50056894	15904
EUR_52	0	EUR	102	50079988	50086485	6497
EUR_52	0	EUR	102	50125413	50133902	8489
EUR_52	0	EUR	102	50167278	50340188	172910
EUR_52	0	EUR	102	51821757	51826252	4495
EUR_52	0	EUR	102	54377615	54392996	15381
EUR_52	0	EUR	102	59025323	59087449	62126
EUR_52	0	EUR	102	60360602	60623780	263178
EUR_52	0	EUR	102	62499163	62511197	12034
EUR_52	0	EUR	102	63354466	63517969	163503
EUR_52	0	EUR	102	64559645	64648825	89180
EUR_52	0	EUR	102	64891225	64968332	77107
EUR_52	0	EUR	102	66848687	66882708	34021
EUR_52	0	EUR	102	66966267	66984748	18481
EUR_52	0	EUR	102	67996165	68234683	238518
EUR_52	0	EUR	102	71501268	71509363	8095
EUR_52	0	EUR	102	72374762	72393031	18269
EUR_52	0	EUR	102	74276519	74289152	12633
EUR_52	0	EUR	102	78278359	78281355	2996
EUR_52	0	EUR	102	79759746	79763512	3766
EUR_52	0	EUR	102	84316084	84413705	97621
EUR_52	0	EUR	102	84485337	84585518	100181
EUR_52	0	EUR	102	84695221	84748669	53448
EUR_52	0	EUR	102	87105110	87192258	87148
EUR_52	0	EUR	102	88131499	88235236	103737
EUR_52	0	EUR	102	92821323	92870243	48920
EUR_52	0	EUR	102	95593010	95631393	38383
EUR_52	0	EUR	102	96719722	96818450	98728
EUR_52	0	EUR	102	97100087	97133265	33178
EUR_52	0	EUR	103	10314774	10351635	36861
EUR_52	0	EUR	103	11221129	11260836	39707
EUR_52	0	EUR	103	13845423	13899355	53932
EUR_52	0	EUR	103	15686234	15701244	15010
EUR_52	0	EUR	103	15783892	15918595	134703
EUR_52	0	EUR	103	17287888	17302285	14397
EUR_52	0	EUR	103	21735053	21774213	39160
EUR_52	0	EUR	103	29871842	29884548	12706
EUR_52	0	EUR	103	30678684	30730344	51660
EUR_52	0	EUR	103	30931120	31214224	283104
EUR_52	0	EUR	103	31321108	31349680	28572
EUR_52	0	EUR	103	31869080	31976562	107482
EUR_52	0	EUR	103	32453173	32511362	58189
EUR_52	0	EUR	103	43750662	43756156	5494
EUR_52	0	EUR	103	44915345	45093802	178457
EUR_52	0	EUR	103	45395889	45413157	17268
EUR_52	0	EUR	103	47874821	48095137	220316
EUR_52	0	EUR	103	48793399	48804986	11587
EUR_52	0	EUR	103	48980390	48992275	11885
EUR_52	0	EUR	103	49107941	49211922	103981
EUR_52	0	EUR	103	49641162	49707032	65870
EUR_52	0	EUR	103	49938053	49958565	20512
EUR_52	0	EUR	103	50244656	50300721	56065
EUR_52	0	EUR	103	50476481	50591506	115025
EUR_52	0	EUR	103	50596635	50675343	78708
EUR_52	0	EUR	103	53185452	53248662	63210
EUR_52	0	EUR	103	54327238	54429543	102305
EUR_52	0	EUR	103	54447874	54485919	38045
EUR_52	0	EUR	103	59025323	59087449	62126
EUR_52	0	EUR	103	60445678	60623780	178102
EUR_52	0	EUR	103	60680189	60703119	22930
EUR_52	0	EUR	103	62363965	62421852	57887
EUR_52	0	EUR	103	62489657	62534250	44593
EUR_52	0	EUR	103	62809352	62877379	68027
EUR_52	0	EUR	103	63007192	63107506	100314
EUR_52	0	EUR	103	63272864	63277354	4490
EUR_52	0	EUR	103	63345194	63367008	21814
EUR_52	0	EUR	103	64642406	64648825	6419
EUR_52	0	EUR	103	67720425	67747325	26900
EUR_52	0	EUR	103	67947267	68008460	61193
EUR_52	0	EUR	103	69283092	69303278	20186
EUR_52	0	EUR	103	70425266	70432857	7591
EUR_52	0	EUR	103	72313374	72338979	25605
EUR_52	0	EUR	103	74185839	74211177	25338
EUR_52	0	EUR	103	80903139	80932876	29737
EUR_52	0	EUR	103	81329834	81397143	67309
EUR_52	0	EUR	103	81849638	81865042	15404
EUR_52	0	EUR	103	84088018	84136758	48740
EUR_52	0	EUR	103	84271016	84413705	142689
EUR_52	0	EUR	103	85095833	85104111	8278
EUR_52	0	EUR	103	96454365	96464200	9835
EUR_52	0	EUR	103	97587852	97606042	18190
EUR_53	0	EUR	104	1658	38454	36796
EUR_53	0	EUR	104	149110	262455	113345
EUR_53	0	EUR	104	668948	697581	28633
EUR_53	0	EUR	104	5641307	5720427	79120
EUR_53	0	EUR	104	7801499	7829292	27793
EUR_53	0	EUR	104	10510641	10525722	15081
EUR_53	0	EUR	104	12436919	12462344	25425
EUR_53	0	EUR	104	12467549	12504242	36693
EUR_53	0	EUR	104	12801626	12870468	68842
EUR_53	0	EUR	104	14793913	14884113	90200
EUR_53	0	EUR	104	15678424	15702000	23576
EUR_53	0	EUR	104	15896526	15959302	62776
EUR_53	0	EUR	104	16026709	16040274	13565
EUR_53	0	EUR	104	21728654	21914523	185869
EUR_53	0	EUR	104	23507155	23562645	55490
EUR_53	0	EUR	104	23697124	23766373	69249
EUR_53	0	EUR	104	23961681	24026895	65214
EUR_53	0	EUR	104	28447913	28459172	11259
EUR_53	0	EUR	104	30528228	30561025	32797
EUR_53	0	EUR	104	30838706	30998466	159760
EUR_53	0	EUR	104	31048766	31088907	40141
EUR_53	0	EUR	104	31127128	31197466	70338
EUR_53	0	EUR	104	33352525	33355723	3198
EUR_53	0	EUR	104	35825437	35904356	78919
EUR_53	0	EUR	104	37432565	37455443	22878
EUR_53	0	EUR	104	39544730	39545103	373
EUR_53	0	EUR	104	43750662	43785095	34433
EUR_53	0	EUR	104	45948492	46017088	68596
EUR_53	0	EUR	104	46150248	46222689	72441
EUR_53	0	EUR	104	46516146	46626803	110657
EUR_53	0	EUR	104	47624392	47645619	21227
EUR_53	0	EUR	104	48152063	48182054	29991
EUR_53	0	EUR	104	48273976	48310647	36671
EUR_53	0	EUR	104	48828898	48852598	23700
EUR_53	0	EUR	104	48974035	49018779	44744
EUR_53	0	EUR	104	49051657	49139016	87359
EUR_53	0	EUR	104	49756462	50004887	248425
EUR_53	0	EUR	104	50095974	50145645	49671
EUR_53	0	EUR	104	50151559	50169892	18333
EUR_53	0	EUR	104	50472069	50516476	44407
EUR_53	0	EUR	104	50654897	50675343	20446
EUR_53	0	EUR	104	56646775	56670627	23852
EUR_53	0	EUR	104	60314986	60406009	91023
EUR_53	0	EUR	104	60675915	60703119	27204
EUR_53	0	EUR	104	62336325	62520941	184616
EUR_53	0	EUR	104	62652479	62657080	4601
EUR_53	0	EUR	104	64635938	64775972	140034
EUR_53	0	EUR	104	66932986	66984748	51762
EUR_53	0	EUR	104	67720425	67747325	26900
EUR_53	0	EUR	104	68053923	68056363	2440
EUR_53	0	EUR	104	68511938	68564643	52705
EUR_53	0	EUR	104	70314329	70323506	9177
EUR_53	0	EUR	104	74704171	74781759	77588
EUR_53	0	EUR	104	76219599	76292558	72959
EUR_53	0	EUR	104	80346144	80378472	32328
EUR_53	0	EUR	104	80903139	80932876	29737
EUR_53	0	EUR	104	81329834	81344715	14881
EUR_53	0	EUR	104	84176428	84340938	164510
EUR_53	0	EUR	104	84465074	84476006	10932
EUR_53	0	EUR	104	84706861	84737569	30708
EUR_53	0	EUR	104	86252507	86262769	10262
EUR_53	0	EUR	104	87069518	87192258	122740
EUR_53	0	EUR	104	89233989	89360109	126120
EUR_53	0	EUR	104	96344658	96403383	58725
EUR_53	0	EUR	104	97149005	97154451	5446
EUR_53	0	EUR	104	97772967	97850405	77438
EUR_53	0	EUR	105	10607	24714	14107
EUR_53	0	EUR	105	1349318	1525674	176356
EUR_53	0	EUR	105	5538353	5560949	22596
EUR_53	0	EUR	105	5948579	5963046	14467
EUR_53	0	EUR	105	7801499	7986175	184676
EUR_53	0	EUR	105	11221129	11260836	39707
EUR_53	0	EUR	105	11267672	11267811	139
EUR_53	0	EUR	105	12199512	12255463	55951
EUR_53	0	EUR	105	12436919	12518164	81245
EUR_53	0	EUR	105	12541608	12571424	29816
EUR_53	0	EUR	105	12959122	12989272	30150
EUR_53	0	EUR	105	16289550	16444740	155190
EUR_53	0	EUR	105	16960554	17115665	155111
EUR_53	0	EUR	105	17270851	17304430	33579
EUR_53	0	EUR	105	17318810	17323735	4925
EUR_53	0	EUR	105	17917703	17924864	7161
EUR_53	0	EUR	105	21218489	21221838	3349
EUR_53	0	EUR	105	21453345	21582697	129352
EUR_53	0	EUR	105	21728654	21914523	185869
EUR_53	0	EUR	105	23697124	23698161	1037
EUR_53	0	EUR	105	26970296	27028137	57841
EUR_53	0	EUR	105	29368986	29369784	798
EUR_53	0	EUR	105	29885100	30020785	135685
EUR_53	0	EUR	105	30678684	30730344	51660
EUR_53	0	EUR	105	30953172	30973126	19954
EUR_53	0	EUR	105	31340450	31464998	124548
EUR_53	0	EUR	105	43321108	43338312	17204
EUR_53	0	EUR	105	43750662	43785095	34433
EUR_53	0	EUR	105	45980594	46044606	64012
EUR_53	0	EUR	105	46135355	46167330	31975
EUR_53	0	EUR	105	46345940	46424629	78689
EUR_53	0	EUR	105	46603480	46692826	89346
EUR_53	0	EUR	105	46958473	46998835	40362
EUR_53	0	EUR	105	47665280	47665590	310
EUR_53	0	EUR	105	48828898	48852598	23700
EUR_53	0	EUR	105	48974035	49018779	44744
EUR_53	0	EUR	105	49051657	49139016	87359
EUR_53	0	EUR	105	50256105	50340188	84083
EUR_53	0	EUR	105	50405806	50516476	110670
EUR_53	0	EUR	105	50614311	50675343	61032
EUR_53	0	EUR	105	52677619	52686699	9080
EUR_53	0	EUR	105	59025323	59087449	62126
EUR_53	0	EUR	105	60314986	60406009	91023
EUR_53	0	EUR	105	60675915	60703119	27204
EUR_53	0	EUR	105	62342991	62387917	44926
EUR_53	0	EUR	105	62516312	62539071	22759
EUR_53	0	EUR	105	63248927	63268388	19461
EUR_53	0	EUR	105	63530056	63669658	139602
EUR_53	0	EUR	105	64689850	64713211	23361
EUR_53	0	EUR	105	67516377	67558609	42232
EUR_53	0	EUR	105	67632239	67659453	27214
EUR_53	0	EUR	105	67731956	67788309	56353
EUR_53	0	EUR	105	67792851	67861249	68398
EUR_53	0	EUR	105	67913266	67948941	35675
EUR_53	0	EUR	105	68110006	68174085	64079
EUR_53	0	EUR	105	69253738	69254774	1036
EUR_53	0	EUR	105	69262441	69296795	34354
EUR_53	0	EUR	105	70314329	70323506	9177
EUR_53	0	EUR	105	79834311	79835487	1176
EUR_53	0	EUR	105	80903139	80932876	29737
EUR_53	0	EUR	105	81329834	81357575	27741
EUR_53	0	EUR	105	84213501	84243440	29939
EUR_53	0	EUR	105	84376065	84711576	335511
EUR_53	0	EUR	105	84762165	84809687	47522
EUR_53	0	EUR	105	86183232	86262769	79537
EUR_53	0	EUR	105	93177388	93227052	49664
EUR_53	0	EUR	105	96215188	96313082	97894
EUR_53	0	EUR	105	96375906	96391048	15142
EUR_53	0	EUR	105	96731151	96795126	63975
EUR_53	0	EUR	105	96935175	96957114	21939
EUR_53	0	EUR	105	97262803	97359151	96348
EUR_53	0	EUR	105	97591041	97621479	30438
EUR_54	0	EUR	106	0	38454	38454
EUR_54	0	EUR	106	1291609	1354736	63127
EUR_54	0	EUR	106	1443312	1465074	21762
EUR_54	0	EUR	106	4152972	4155031	2059
EUR_54	0	EUR	106	5865668	5885621	19953
EUR_54	0	EUR	106	7801499	8020825	219326
EUR_54	0	EUR	106	8846483	8874923	28440
EUR_54	0	EUR	106	11309495	11324870	15375
EUR_54	0	EUR	106	13096243	13098263	2020
EUR_54	0	EUR	106	13943659	14132248	188589
EUR_54	0	EUR	106	16960554	17098245	137691
EUR_54	0	EUR	106	21406424	21582697	176273
EUR_54	0	EUR	106	21611581	21691175	79594
EUR_54	0	EUR	106	23480055	23525224	45169
EUR_54	0	EUR	106	23678834	23696381	17547
EUR_54	0	EUR	106	23923937	24026948	103011
EUR_54	0	EUR	106	24662518	24693848	31330
EUR_54	0	EUR	106	27030183	27059311	29128
EUR_54	0	EUR	106	28447913	28454759	6846
EUR_54	0	EUR	106	30594989	30655575	60586
EUR_54	0	EUR	106	31213935	31267996	54061
EUR_54	0	EUR	106	39536610	39538252	1642
EUR_54	0	EUR	106	40952583	41034990	82407
EUR_54	0	EUR	106	43321108	43338312	17204
EUR_54	0	EUR	106	43750662	43785095	34433
EUR_54	0	EUR	106	45330879	45405355	74476
EUR_54	0	EUR	106	45980594	46033072	52478
EUR_54	0	EUR	106	47874821	48229330	354509
EUR_54	0	EUR	106	48793399	48804986	11587
EUR_54	0	EUR	106	49074315	49126531	52216
EUR_54	0	EUR	106	49860747	50004887	144140
EUR_54	0	EUR	106	50079988	50086485	6497
EUR_54	0	EUR	106	50215570	50299995	84425
EUR_54	0	EUR	106	59025323	59087449	62126
EUR_54	0	EUR	106	60360602	60623780	263178
EUR_54	0	EUR	106	62363965	62421852	57887
EUR_54	0	EUR	106	62584114	62820719	236605
EUR_54	0	EUR	106	62934893	62937501	2608
EUR_54	0	EUR	106	63392714	63488070	95356
EUR_54	0	EUR	106	64736659	64775972	39313
EUR_54	0	EUR	106	65401205	65439431	38226
EUR_54	0	EUR	106	67648499	67659453	10954
EUR_54	0	EUR	106	68003563	68012425	8862
EUR_54	0	EUR	106	68340349	68341913	1564
EUR_54	0	EUR	106	69230927	69303491	72564
EUR_54	0	EUR	106	71187459	71260612	73153
EUR_54	0	EUR	106	71501268	71509363	8095
EUR_54	0	EUR	106	72313374	72338979	25605
EUR_54	0	EUR	106	73164377	73165766	1389
EUR_54	0	EUR	106	74165046	74332051	167005
EUR_54	0	EUR	106	80903139	80904640	1501
EUR_54	0	EUR	106	80947447	80965346	17899
EUR_54	0	EUR	106	84074915	84136758	61843
EUR_54	0	EUR	106	84276859	84281776	4917
EUR_54	0	EUR	106	84664205	84683027	18822
EUR_54	0	EUR	106	88131499	88235236	103737
EUR_54	0	EUR	106	95594113	95706836	112723
EUR_54	0	EUR	106	96215188	96313082	97894
EUR_54	0	EUR	106	96344658	96391048	46390
EUR_54	0	EUR	106	96938041	96985749	47708
EUR_54	0	EUR	106	97149005	97170445	21440
EUR_54	0	EUR	106	97368034	97434688	66654
EUR_54	0	EUR	106	97516792	97606042	89250
EUR_54	0	EUR	107	0	24714	24714
EUR_54	0	EUR	107	1443312	1474375	31063
EUR_54	0	EUR	107	8038172	8074467	36295
EUR_54	0	EUR	107	8922196	8953694	31498
EUR_54	0	EUR	107	10162900	10265441	102541
EUR_54	0	EUR	107	10504963	10525722	20759
EUR_54	0	EUR	107	11221129	11260836	39707
EUR_54	0	EUR	107	13096243	13098263	2020
EUR_54	0	EUR	107	14820933	14884113	63180
EUR_54	0	EUR	107	15697742	15701244	3502
EUR_54	0	EUR	107	15701864	15740215	38351
EUR_54	0	EUR	107	17029181	17031678	2497
EUR_54	0	EUR	107	17270851	17280159	9308
EUR_54	0	EUR	107	19373385	19430386	57001
EUR_54	0	EUR	107	19602987	19651006	48019
EUR_54	0	EUR	107	21406424	21582697	176273
EUR_54	0	EUR	107	21747694	21774213	26519
EUR_54	0	EUR	107	23507155	23562645	55490
EUR_54	0	EUR	107	24664847	24693848	29001
EUR_54	0	EUR	107	25625985	25637091	11106
EUR_54	0	EUR	107	26802769	27028137	225368
EUR_54	0	EUR	107	29378628	29403219	24591
EUR_54	0	EUR	107	29900404	29906215	5811
EUR_54	0	EUR	107	40937544	41034990	97446
EUR_54	0	EUR	107	43321108	43338312	17204
EUR_54	0	EUR	107	43750662	43785095	34433
EUR_54	0	EUR	107	44627203	44632425	5222
EUR_54	0	EUR	107	45023383	45093802	70419
EUR_54	0	EUR	107	46345940	46401248	55308
EUR_54	0	EUR	107	46557983	46563256	5273
EUR_54	0	EUR	107	48206458	48284798	78340
EUR_54	0	EUR	107	48980390	49018727	38337
EUR_54	0	EUR	107	49720102	50004887	284785
EUR_54	0	EUR	107	50123518	50340188	216670
EUR_54	0	EUR	107	51721135	51826252	105117
EUR_54	0	EUR	107	54262700	54290924	28224
EUR_54	0	EUR	107	56606415	56607009	594
EUR_54	0	EUR	107	56981282	57026186	44904
EUR_54	0	EUR	107	60697771	60713933	16162
EUR_54	0	EUR	107	60836692	60850995	14303
EUR_54	0	EUR	107	62336325	62520941	184616
EUR_54	0	EUR	107	62771027	62777510	6483
EUR_54	0	EUR	107	63010595	63041174	30579
EUR_54	0	EUR	107	63177292	63258025	80733
EUR_54	0	EUR	107	63354466	63392700	38234
EUR_54	0	EUR	107	64559645	64615923	56278
EUR_54	0	EUR	107	64689850	64713211	23361
EUR_54	0	EUR	107	64779628	64878760	99132
EUR_54	0	EUR	107	67257538	67343411	85873
EUR_54	0	EUR	107	67648499	67659453	10954
EUR_54	0	EUR	107	67946890	68012470	65580
EUR_54	0	EUR	107	68130778	68170606	39828
EUR_54	0	EUR	107	69253738	69280158	26420
EUR_54	0	EUR	107	73164377	73165766	1389
EUR_54	0	EUR	107	74185839	74211177	25338
EUR_54	0	EUR	107	76219599	76223870	4271
EUR_54	0	EUR	107	78630900	78660130	29230
EUR_54	0	EUR	107	80903139	80961424	58285
EUR_54	0	EUR	107	82779823	82867077	87254
EUR_54	0	EUR	107	84307433	84457650	150217
EUR_54	0	EUR	107	84483013	84508973	25960
EUR_54	0	EUR	107	93177388	93217929	40541
EUR_54	0	EUR	107	96599275	96610701	11426
EUR_54	0	EUR	107	96719722	96818450	98728
EUR_54	0	EUR	107	97799580	97850405	50825
EUR_55	0	EUR	108	0	38454	38454
EUR_55	0	EUR	108	2392450	2436497	44047
EUR_55	0	EUR	108	8022793	8069680	46887
EUR_55	0	EUR	108	10195098	10208942	13844
EUR_55	0	EUR	108	10477119	10515509	38390
EUR_55	0	EUR	108	11309495	11324870	15375
EUR_55	0	EUR	108	14713216	14731414	18198
EUR_55	0	EUR	108	15686234	15701244	15010
EUR_55	0	EUR	108	15783892	15879503	95611
EUR_55	0	EUR	108	16317541	16340550	23009
EUR_55	0	EUR	108	17026312	17091416	65104
EUR_55	0	EUR	108	19391339	19454354	63015
EUR_55	0	EUR	108	20614422	20624593	10171
EUR_55	0	EUR	108	23697124	23853580	156456
EUR_55	0	EUR	108	26757616	26784665	27049
EUR_55	0	EUR	108	29871842	29884548	12706
EUR_55	0	EUR	108	29981453	29982875	1422
EUR_55	0	EUR	108	30838706	31006796	168090
EUR_55	0	EUR	108	31342564	31464998	122434
EUR_55	0	EUR	108	39871169	39913649	42480
EUR_55	0	EUR	108	40975976	40983002	7026
EUR_55	0	EUR	108	41082532	41134854	52322
EUR_55	0	EUR	108	41323968	41330550	6582
EUR_55	0	EUR	108	43273165	43340494	67329
EUR_55	0	EUR	108	43776270	43805520	29250
EUR_55	0	EUR	108	45292333	45305694	13361
EUR_55	0	EUR	108	46238893	46318055	79162
EUR_55	0	EUR	108	48216505	48237148	20643
EUR_55	0	EUR	108	48988140	49229729	241589
EUR_55	0	EUR	108	49953599	50204377	250778
EUR_55	0	EUR	108	50287644	50340188	52544
EUR_55	0	EUR	108	54156560	54190763	34203
EUR_55	0	EUR	108	54241431	54273354	31923
EUR_55	0	EUR	108	55365672	55376432	10760
EUR_55	0	EUR	108	55925348	55926399	1051
EUR_55	0	EUR	108	59025323	59087449	62126
EUR_55	0	EUR	108	60314986	60406009	91023
EUR_55	0	EUR	108	62707428	62886738	179310
EUR_55	0	EUR	108	64736659	64775972	39313
EUR_55	0	EUR	108	70459841	70471952	12111
EUR_55	0	EUR	108	71108569	71231131	122562
EUR_55	0	EUR	108	74165046	74332051	167005
EUR_55	0	EUR	108	79834311	79835487	1176
EUR_55	0	EUR	108	80903139	80932876	29737
EUR_55	0	EUR	108	81329834	81357575	27741
EUR_55	0	EUR	108	84174413	84347352	172939
EUR_55	0	EUR	108	84385265	84423669	38404
EUR_55	0	EUR	108	84779402	84859626	80224
EUR_55	0	EUR	108	85089469	85104111	14642
EUR_55	0	EUR	108	87946387	87992882	46495
EUR_55	0	EUR	108	88992283	89057856	65573
EUR_55	0	EUR	108	96935175	96957114	21939
EUR_55	0	EUR	108	97398476	97442009	43533
EUR_55	0	EUR	108	97516792	97606042	89250
EUR_55	0	EUR	109	1443312	1474375	31063
EUR_55	0	EUR	109	5726744	5741613	14869
EUR_55	0	EUR	109	5914836	5971269	56433
EUR_55	0	EUR	109	8943880	8958572	14692
EUR_55	0	EUR	109	10162900	10351635	188735
EUR_55	0	EUR	109	11309495	11324870	15375
EUR_55	0	EUR	109	12541608	12571424	29816
EUR_55	0	EUR	109	13879741	13899355	19614
EUR_55	0	EUR	109	15711188	15740215	29027
EUR_55	0	EUR	109	17270851	17304430	33579
EUR_55	0	EUR	109	17318810	17323735	4925
EUR_55	0	EUR	109	19205162	19218710	13548
EUR_55	0	EUR	109	19445931	19447994	2063
EUR_55	0	EUR	109	21168069	21168829	760
EUR_55	0	EUR	109	21179486	21230787	51301
EUR_55	0	EUR	109	21282427	21309916	27489
EUR_55	0	EUR	109	21495136	21567089	71953
EUR_55	0	EUR	109	21935834	21965772	29938
EUR_55	0	EUR	109	23519809	23682065	162256
EUR_55	0	EUR	109	23793798	23870635	76837
EUR_55	0	EUR	109	25625985	25637091	11106
EUR_55	0	EUR	109	29255894	29345379	89485
EUR_55	0	EUR	109	30528228	30531547	3319
EUR_55	0	EUR	109	30550643	30641876	91233
EUR_55	0	EUR	109	31062988	31134052	71064
EUR_55	0	EUR	109	31190087	31216844	26757
EUR_55	0	EUR	109	31254911	31267996	13085
EUR_55	0	EUR	109	31340450	31398944	58494
EUR_55	0	EUR	109	41241594	41386596	145002
EUR_55	0	EUR	109	43690494	43703982	13488
EUR_55	0	EUR	109	45980594	46052925	72331
EUR_55	0	EUR	109	46600402	46692826	92424
EUR_55	0	EUR	109	47917773	47960163	42390
EUR_55	0	EUR	109	48163867	48177386	13519
EUR_55	0	EUR	109	48273976	48321534	47558
EUR_55	0	EUR	109	49063282	49170836	107554
EUR_55	0	EUR	109	50079988	50086485	6497
EUR_55	0	EUR	109	50292505	50340188	47683
EUR_55	0	EUR	109	50462409	50483962	21553
EUR_55	0	EUR	109	50537149	50675343	138194
EUR_55	0	EUR	109	53153857	53197187	43330
EUR_55	0	EUR	109	54570395	54580607	10212
EUR_55	0	EUR	109	60675915	60703119	27204
EUR_55	0	EUR	109	61977382	62000629	23247
EUR_55	0	EUR	109	63392714	63488070	95356
EUR_55	0	EUR	109	64736659	64775972	39313
EUR_55	0	EUR	109	65401205	65439431	38226
EUR_55	0	EUR	109	66900632	66900890	258
EUR_55	0	EUR	109	67099623	67136085	36462
EUR_55	0	EUR	109	67726807	67807658	80851
EUR_55	0	EUR	109	67993239	68079858	86619
EUR_55	0	EUR	109	68153010	68234683	81673
EUR_55	0	EUR	109	68501694	68528735	27041
EUR_55	0	EUR	109	69253738	69280158	26420
EUR_55	0	EUR	109	70314329	70323506	9177
EUR_55	0	EUR	109	70425266	70443249	17983
EUR_55	0	EUR	109	70459841	70471952	12111
EUR_55	0	EUR	109	74165046	74213902	48856
EUR_55	0	EUR	109	74294086	74332051	37965
EUR_55	0	EUR	109	74704171	74781759	77588
EUR_55	0	EUR	109	74791668	74797490	5822
EUR_55	0	EUR	109	84307433	84457650	150217
EUR_55	0	EUR	109	84483013	84508973	25960
EUR_55	0	EUR	109	87946387	87992882	46495
EUR_55	0	EUR	109	96215188	96313082	97894
EUR_55	0	EUR	109	96628171	96660713	32542
EUR_55	0	EUR	109	96681114	96688015	6901
EUR_55	0	EUR	109	96935175	96957114	21939
EUR_55	0	EUR	109	97670105	97737896	67791
EUR_56	0	EUR	110	10310816	10335227	24411
EUR_56	0	EUR	110	12436919	12462344	25425
EUR_56	0	EUR	110	12467549	12504242	36693
EUR_56	0	EUR	110	12801626	12870468	68842
EUR_56	0	EUR	110	13943659	13985521	41862
EUR_56	0	EUR	110	15678424	15702000	23576
EUR_56	0	EUR	110	15896526	15959302	62776
EUR_56	0	EUR	110	16026709	16040274	13565
EUR_56	0	EUR	110	17270851	17280159	9308
EUR_56	0	EUR	110	17917703	17924864	7161
EUR_56	0	EUR	110	19569358	19651006	81648
EUR_56	0	EUR	110	21489581	21543648	54067
EUR_56	0	EUR	110	23793798	23870635	76837
EUR_56	0	EUR	110	27041168	27059311	18143
EUR_56	0	EUR	110	29750374	29765658	15284
EUR_56	0	EUR	110	29981453	30020785	39332
EUR_56	0	EUR	110	31049866	31088907	39041
EUR_56	0	EUR	110	31127128	31197466	70338
EUR_56	0	EUR	110	32056141	32101976	45835
EUR_56	0	EUR	110	41698837	41768904	70067
EUR_56	0	EUR	110	43751615	43808041	56426
EUR_56	0	EUR	110	45919475	45922183	2708
EUR_56	0	EUR	110	45988603	45999654	11051
EUR_56	0	EUR	110	47588227	47619485	31258
EUR_56	0	EUR	110	47874821	47900802	25981
EUR_56	0	EUR	110	48793399	48804986	11587
EUR_56	0	EUR	110	48980390	48992275	11885
EUR_56	0	EUR	110	49107941	49211922	103981
EUR_56	0	EUR	110	49641162	49707032	65870
EUR_56	0	EUR	110	49724753	50108086	383333
EUR_56	0	EUR	110	50215570	50230993	15423
EUR_56	0	EUR	110	50499580	50600707	101127
EUR_56	0	EUR	110	55925348	55926399	1051
EUR_56	0	EUR	110	60314986	60366947	51961
EUR_56	0	EUR	110	60465746	60473482	7736
EUR_56	0	EUR	110	61977382	62000629	23247
EUR_56	0	EUR	110	62025489	62049844	24355
EUR_56	0	EUR	110	62328189	62360303	32114
EUR_56	0	EUR	110	62571477	62571923	446
EUR_56	0	EUR	110	62672738	62886738	214000
EUR_56	0	EUR	110	63156537	63182770	26233
EUR_56	0	EUR	110	63345194	63367008	21814
EUR_56	0	EUR	110	64213067	64326150	113083
EUR_56	0	EUR	110	66932986	66984748	51762
EUR_56	0	EUR	110	67729110	67747325	18215
EUR_56	0	EUR	110	68003563	68012425	8862
EUR_56	0	EUR	110	70314329	70323506	9177
EUR_56	0	EUR	110	71197734	71260612	62878
EUR_56	0	EUR	110	72313374	72338979	25605
EUR_56	0	EUR	110	73164377	73165766	1389
EUR_56	0	EUR	110	74614046	74797490	183444
EUR_56	0	EUR	110	79636078	79676585	40507
EUR_56	0	EUR	110	84051369	84087948	36579
EUR_56	0	EUR	110	84385265	84423669	38404
EUR_56	0	EUR	110	85095833	85104111	8278
EUR_56	0	EUR	110	87069518	87192258	122740
EUR_56	0	EUR	110	88067512	88235236	167724
EUR_56	0	EUR	110	92590099	92705931	115832
EUR_56	0	EUR	110	93179489	93227052	47563
EUR_56	0	EUR	110	93343223	93437672	94449
EUR_56	0	EUR	110	95127554	95186895	59341
EUR_56	0	EUR	110	96344658	96391048	46390
EUR_56	0	EUR	110	96496460	96545731	49271
EUR_56	0	EUR	110	96962941	96970993	8052
EUR_56	0	EUR	111	0	24714	24714
EUR_56	0	EUR	111	1443312	1474375	31063
EUR_56	0	EUR	111	12195294	12394574	199280
EUR_56	0	EUR	111	13017869	13029529	11660
EUR_56	0	EUR	111	13099541	13191657	92116
EUR_56	0	EUR	111	13845423	13859671	14248
EUR_56	0	EUR	111	14071365	14132248	60883
EUR_56	0	EUR	111	14713216	14731414	18198
EUR_56	0	EUR	111	15695543	15743283	47740
EUR_56	0	EUR	111	17067299	17105733	38434
EUR_56	0	EUR	111	19373820	19446442	72622
EUR_56	0	EUR	111	19490258	19640640	150382
EUR_56	0	EUR	111	20645018	20693514	48496
EUR_56	0	EUR	111	21869330	21914523	45193
EUR_56	0	EUR	111	23297565	23324559	26994
EUR_56	0	EUR	111	23626899	23638658	11759
EUR_56	0	EUR	111	27030183	27059311	29128
EUR_56	0	EUR	111	27563461	27803948	240487
EUR_56	0	EUR	111	29255894	29345379	89485
EUR_56	0	EUR	111	29900404	29906215	5811
EUR_56	0	EUR	111	30953172	30988149	34977
EUR_56	0	EUR	111	31329205	31367228	38023
EUR_56	0	EUR	111	31862751	31933275	70524
EUR_56	0	EUR	111	39481376	39516157	34781
EUR_56	0	EUR	111	40952583	41034990	82407
EUR_56	0	EUR	111	41698837	41704843	6006
EUR_56	0	EUR	111	43273165	43340494	67329
EUR_56	0	EUR	111	43751615	43808041	56426
EUR_56	0	EUR	111	44627203	44632425	5222
EUR_56	0	EUR	111	46345940	46348272	2332
EUR_56	0	EUR	111	46821026	46878762	57736
EUR_56	0	EUR	111	47874821	47900802	25981
EUR_56	0	EUR	111	49161242	49211922	50680
EUR_56	0	EUR	111	50123518	50198959	75441
EUR_56	0	EUR	111	50654897	50675343	20446
EUR_56	0	EUR	111	51721135	51826252	105117
EUR_56	0	EUR	111	55662959	55747582	84623
EUR_56	0	EUR	111	55892211	55943914	51703
EUR_56	0	EUR	111	56649097	56688585	39488
EUR_56	0	EUR	111	60675915	60703119	27204
EUR_56	0	EUR	111	60773332	60825923	52591
EUR_56	0	EUR	111	62172857	62323374	150517
EUR_56	0	EUR	111	62427365	62491526	64161
EUR_56	0	EUR	111	62516312	62546166	29854
EUR_56	0	EUR	111	62679237	62680258	1021
EUR_56	0	EUR	111	62714552	62844978	130426
EUR_56	0	EUR	111	63364127	63367008	2881
EUR_56	0	EUR	111	64642406	64648825	6419
EUR_56	0	EUR	111	66827940	66897711	69771
EUR_56	0	EUR	111	67469783	67484763	14980
EUR_56	0	EUR	111	68002714	68056363	53649
EUR_56	0	EUR	111	69253738	69254774	1036
EUR_56	0	EUR	111	69262441	69296795	34354
EUR_56	0	EUR	111	69976346	69993399	17053
EUR_56	0	EUR	111	70425266	70432857	7591
EUR_56	0	EUR	111	71187459	71214726	27267
EUR_56	0	EUR	111	71316162	71371297	55135
EUR_56	0	EUR	111	71411050	71427923	16873
EUR_56	0	EUR	111	72313374	72338979	25605
EUR_56	0	EUR	111	74609427	74738201	128774
EUR_56	0	EUR	111	76720252	76763688	43436
EUR_56	0	EUR	111	80307017	80378472	71455
EUR_56	0	EUR	111	80903139	80932876	29737
EUR_56	0	EUR	111	84176428	84340938	164510
EUR_56	0	EUR	111	84466844	84592202	125358
EUR_56	0	EUR	111	85119454	85157686	38232
EUR_56	0	EUR	111	93343223	93366866	23643
EUR_56	0	EUR	111	93627195	93686534	59339
EUR_56	0	EUR	111	95696854	95706836	9982
EUR_56	0	EUR	111	96344658	96391048	46390
EUR_56	0	EUR	111	96938041	96985749	47708
EUR_56	0	EUR	111	97149005	97170445	21440
EUR_56	0	EUR	111	97401837	97434688	32851
EUR_56	0	EUR	111	97516792	97548589	31797
EUR_56	0	EUR	111	97591041	97621479	30438
EUR_57	0	EUR	112	0	24714	24714
EUR_57	0	EUR	112	994187	1024498	30311
EUR_57	0	EUR	112	2343926	2436497	92571
EUR_57	0	EUR	112	10389120	10459835	70715
EUR_57	0	EUR	112	11309495	11324870	15375
EUR_57	0	EUR	112	12376950	12394574	17624
EUR_57	0	EUR	112	12517970	12541493	23523
EUR_57	0	EUR	112	15921301	16036609	115308
EUR_57	0	EUR	112	16235802	16340550	104748
EUR_57	0	EUR	112	16960554	17058271	97717
EUR_57	0	EUR	112	19211100	19218710	7610
EUR_57	0	EUR	112	19435723	19454354	18631
EUR_57	0	EUR	112	19519830	19634557	114727
EUR_57	0	EUR	112	19720323	19815522	95199
EUR_57	0	EUR	112	21737927	21914523	176596
EUR_57	0	EUR	112	23472367	23528102	55735
EUR_57	0	EUR	112	23958200	24070707	112507
EUR_57	0	EUR	112	27563461	27803948	240487
EUR_57	0	EUR	112	28447913	28473925	26012
EUR_57	0	EUR	112	28909134	28912719	3585
EUR_57	0	EUR	112	30085525	30116933	31408
EUR_57	0	EUR	112	30528228	30590405	62177
EUR_57	0	EUR	112	31869080	31976562	107482
EUR_57	0	EUR	112	32453173	32511362	58189
EUR_57	0	EUR	112	43298198	43340494	42296
EUR_57	0	EUR	112	43750662	43771347	20685
EUR_57	0	EUR	112	45023383	45093802	70419
EUR_57	0	EUR	112	45980594	46044606	64012
EUR_57	0	EUR	112	46135355	46167330	31975
EUR_57	0	EUR	112	46345940	46424629	78689
EUR_57	0	EUR	112	46603480	46692826	89346
EUR_57	0	EUR	112	47672056	47744901	72845
EUR_57	0	EUR	112	48065016	48237148	172132
EUR_57	0	EUR	112	48777473	48788773	11300
EUR_57	0	EUR	112	48957046	48987944	30898
EUR_57	0	EUR	112	49105400	49121767	16367
EUR_57	0	EUR	112	50069146	50467501	398355
EUR_57	0	EUR	112	50654897	50675343	20446
EUR_57	0	EUR	112	53261159	53302464	41305
EUR_57	0	EUR	112	61922896	62298109	375213
EUR_57	0	EUR	112	62626144	62710548	84404
EUR_57	0	EUR	112	64695270	64713211	17941
EUR_57	0	EUR	112	64779628	64816918	37290
EUR_57	0	EUR	112	64928378	64968332	39954
EUR_57	0	EUR	112	67469783	67497679	27896
EUR_57	0	EUR	112	67536791	67558609	21818
EUR_57	0	EUR	112	67640204	67659453	19249
EUR_57	0	EUR	112	67731956	67788309	56353
EUR_57	0	EUR	112	67792851	67816606	23755
EUR_57	0	EUR	112	67947267	68008460	61193
EUR_57	0	EUR	112	68065343	68234683	169340
EUR_57	0	EUR	112	74165046	74332051	167005
EUR_57	0	EUR	112	79724839	79803495	78656
EUR_57	0	EUR	112	81863285	81877251	13966
EUR_57	0	EUR	112	84174413	84347352	172939
EUR_57	0	EUR	112	84385265	84501788	116523
EUR_57	0	EUR	112	88992283	89057856	65573
EUR_57	0	EUR	112	96677706	96831567	153861
EUR_57	0	EUR	112	97226584	97235404	8820
EUR_57	0	EUR	113	0	38454	38454
EUR_57	0	EUR	113	2310091	2311679	1588
EUR_57	0	EUR	113	7801499	8034150	232651
EUR_57	0	EUR	113	10162900	10299389	136489
EUR_57	0	EUR	113	10310816	10371329	60513
EUR_57	0	EUR	113	10547168	10559629	12461
EUR_57	0	EUR	113	12382157	12442704	60547
EUR_57	0	EUR	113	12471707	12641459	169752
EUR_57	0	EUR	113	14713216	14884113	170897
EUR_57	0	EUR	113	15697742	15701244	3502
EUR_57	0	EUR	113	19445931	19447994	2063
EUR_57	0	EUR	113	21282427	21582697	300270
EUR_57	0	EUR	113	24664847	24693848	29001
EUR_57	0	EUR	113	25625985	25637091	11106
EUR_57	0	EUR	113	28447913	28454759	6846
EUR_57	0	EUR	113	28909134	28912719	3585
EUR_57	0	EUR	113	29400124	29403219	3095
EUR_57	0	EUR	113	29885100	30020785	135685
EUR_57	0	EUR	113	30909748	31020966	111218
EUR_57	0	EUR	113	31102656	31134052	31396
EUR_57	0	EUR	113	31349043	31354726	5683
EUR_57	0	EUR	113	33352525	33353174	649
EUR_57	0	EUR	113	41310351	41386596	76245
EUR_57	0	EUR	113	45980594	46058398	77804
EUR_57	0	EUR	113	46150248	46222689	72441
EUR_57	0	EUR	113	48098055	48124160	26105
EUR_57	0	EUR	113	48273976	48291671	17695
EUR_57	0	EUR	113	48988140	49229729	241589
EUR_57	0	EUR	113	49807803	49877351	69548
EUR_57	0	EUR	113	50214714	50340188	125474
EUR_57	0	EUR	113	50618884	50652765	33881
EUR_57	0	EUR	113	53185452	53248662	63210
EUR_57	0	EUR	113	55697610	55704084	6474
EUR_57	0	EUR	113	55891681	55921875	30194
EUR_57	0	EUR	113	60582515	60623780	41265
EUR_57	0	EUR	113	62342962	62428484	85522
EUR_57	0	EUR	113	62529233	62546944	17711
EUR_57	0	EUR	113	63156537	63227147	70610
EUR_57	0	EUR	113	63371917	63397067	25150
EUR_57	0	EUR	113	64786335	64809344	23009
EUR_57	0	EUR	113	67053456	67160970	107514
EUR_57	0	EUR	113	68501694	68528735	27041
EUR_57	0	EUR	113	69253738	69280158	26420
EUR_57	0	EUR	113	72313374	72338979	25605
EUR_57	0	EUR	113	80438129	80466548	28419
EUR_57	0	EUR	113	86466315	86466441	126
EUR_57	0	EUR	113	93177388	93227052	49664
EUR_57	0	EUR	113	93343223	93437672	94449
EUR_57	0	EUR	113	95127554	95236450	108896
EUR_57	0	EUR	113	95701360	95770835	69475
EUR_57	0	EUR	113	96719722	96818450	98728
EUR_57	0	EUR	113	97199338	97229460	30122
EUR_57	0	EUR	113	97566177	97575825	9648
EUR_58	0	EUR	114	1443312	1474375	31063
EUR_58	0	EUR	114	2267390	2436497	169107
EUR_58	0	EUR	114	5738269	5741613	3344
EUR_58	0	EUR	114	8022793	8069680	46887
EUR_58	0	EUR	114	10195098	10229013	33915
EUR_58	0	EUR	114	10477119	10539676	62557
EUR_58	0	EUR	114	12517970	12571424	53454
EUR_58	0	EUR	114	14713216	14731414	18198
EUR_58	0	EUR	114	15896526	15959302	62776
EUR_58	0	EUR	114	16309874	16392692	82818
EUR_58	0	EUR	114	17270851	17280159	9308
EUR_58	0	EUR	114	19445931	19447994	2063
EUR_58	0	EUR	114	21406424	21549180	142756
EUR_58	0	EUR	114	23507155	23562645	55490
EUR_58	0	EUR	114	23793798	23810060	16262
EUR_58	0	EUR	114	28447913	28496302	48389
EUR_58	0	EUR	114	29378628	29403219	24591
EUR_58	0	EUR	114	29981453	29997960	16507
EUR_58	0	EUR	114	30528228	30561025	32797
EUR_58	0	EUR	114	31188077	31225571	37494
EUR_58	0	EUR	114	31340450	31464998	124548
EUR_58	0	EUR	114	31877961	31976562	98601
EUR_58	0	EUR	114	35825437	35904356	78919
EUR_58	0	EUR	114	43751615	43813419	61804
EUR_58	0	EUR	114	45023383	45084731	61348
EUR_58	0	EUR	114	45980594	46067124	86530
EUR_58	0	EUR	114	46202917	46277139	74222
EUR_58	0	EUR	114	46664058	46672190	8132
EUR_58	0	EUR	114	47610552	47611006	454
EUR_58	0	EUR	114	48836469	48852598	16129
EUR_58	0	EUR	114	49105400	49211922	106522
EUR_58	0	EUR	114	49860747	50031530	170783
EUR_58	0	EUR	114	50079988	50086485	6497
EUR_58	0	EUR	114	50215570	50270346	54776
EUR_58	0	EUR	114	50283074	50289602	6528
EUR_58	0	EUR	114	50446207	50474545	28338
EUR_58	0	EUR	114	50474678	50560553	85875
EUR_58	0	EUR	114	50644699	50682125	37426
EUR_58	0	EUR	114	56606415	56623847	17432
EUR_58	0	EUR	114	56981282	57026186	44904
EUR_58	0	EUR	114	60552837	60609459	56622
EUR_58	0	EUR	114	62358424	62360148	1724
EUR_58	0	EUR	114	62384821	62405059	20238
EUR_58	0	EUR	114	62516312	62546166	29854
EUR_58	0	EUR	114	64690778	64713211	22433
EUR_58	0	EUR	114	64779628	64968332	188704
EUR_58	0	EUR	114	67271768	67371632	99864
EUR_58	0	EUR	114	67720425	67747325	26900
EUR_58	0	EUR	114	67947267	68008460	61193
EUR_58	0	EUR	114	68146842	68164991	18149
EUR_58	0	EUR	114	72313374	72338979	25605
EUR_58	0	EUR	114	74609427	74656895	47468
EUR_58	0	EUR	114	77940158	77981834	41676
EUR_58	0	EUR	114	79714947	79772869	57922
EUR_58	0	EUR	114	80817797	80831869	14072
EUR_58	0	EUR	114	87069518	87192258	122740
EUR_58	0	EUR	114	93177388	93208473	31085
EUR_58	0	EUR	114	96344658	96403383	58725
EUR_58	0	EUR	114	96599275	96660713	61438
EUR_58	0	EUR	114	96950026	96969240	19214
EUR_58	0	EUR	114	97295440	97321820	26380
EUR_58	0	EUR	115	5633934	5741613	107679
EUR_58	0	EUR	115	7801499	8020825	219326
EUR_58	0	EUR	115	10195098	10229013	33915
EUR_58	0	EUR	115	12436919	12518164	81245
EUR_58	0	EUR	115	12541608	12571424	29816
EUR_58	0	EUR	115	14713216	14731414	18198
EUR_58	0	EUR	115	15697742	15701244	3502
EUR_58	0	EUR	115	15701864	15740215	38351
EUR_58	0	EUR	115	17029181	17031678	2497
EUR_58	0	EUR	115	17318810	17323735	4925
EUR_58	0	EUR	115	21218489	21258286	39797
EUR_58	0	EUR	115	21346331	21582697	236366
EUR_58	0	EUR	115	21935834	21965772	29938
EUR_58	0	EUR	115	23480055	23525224	45169
EUR_58	0	EUR	115	23678834	23696381	17547
EUR_58	0	EUR	115	26915868	27028137	112269
EUR_58	0	EUR	115	29380470	29403219	22749
EUR_58	0	EUR	115	29755007	29767219	12212
EUR_58	0	EUR	115	31321108	31349680	28572
EUR_58	0	EUR	115	35866099	35904356	38257
EUR_58	0	EUR	115	43273165	43340494	67329
EUR_58	0	EUR	115	43800917	43813419	12502
EUR_58	0	EUR	115	46043417	46069871	26454
EUR_58	0	EUR	115	46821026	46878762	57736
EUR_58	0	EUR	115	47688826	47761411	72585
EUR_58	0	EUR	115	47965639	48089703	124064
EUR_58	0	EUR	115	48793399	48804986	11587
EUR_58	0	EUR	115	48952912	48960159	7247
EUR_58	0	EUR	115	49480075	49645607	165532
EUR_58	0	EUR	115	49966488	49995130	28642
EUR_58	0	EUR	115	50215570	50270346	54776
EUR_58	0	EUR	115	50283074	50289602	6528
EUR_58	0	EUR	115	50446207	50480411	34204
EUR_58	0	EUR	115	50659811	50684992	25181
EUR_58	0	EUR	115	54360569	54422822	62253
EUR_58	0	EUR	115	54570395	54580607	10212
EUR_58	0	EUR	115	56642327	56661029	18702
EUR_58	0	EUR	115	59025323	59087449	62126
EUR_58	0	EUR	115	60401729	60501936	100207
EUR_58	0	EUR	115	62298928	62360303	61375
EUR_58	0	EUR	115	63354466	63436101	81635
EUR_58	0	EUR	115	66942688	67022791	80103
EUR_58	0	EUR	115	67043600	67128290	84690
EUR_58	0	EUR	115	67648499	67659453	10954
EUR_58	0	EUR	115	68055902	68056789	887
EUR_58	0	EUR	115	68533102	68564643	31541
EUR_58	0	EUR	115	69283668	69315282	31614
EUR_58	0	EUR	115	70090968	70140681	49713
EUR_58	0	EUR	115	70178120	70180545	2425
EUR_58	0	EUR	115	71108569	71231131	122562
EUR_58	0	EUR	115	74185839	74195965	10126
EUR_58	0	EUR	115	74609427	74689986	80559
EUR_58	0	EUR	115	74695445	74723577	28132
EUR_58	0	EUR	115	76219599	76336677	117078
EUR_58	0	EUR	115	76736930	76763688	26758
EUR_58	0	EUR	115	79508567	79533168	24601
EUR_58	0	EUR	115	80351527	80355866	4339
EUR_58	0	EUR	115	80817797	80831869	14072
EUR_58	0	EUR	115	81329834	81357575	27741
EUR_58	0	EUR	115	84074915	84095270	20355
EUR_58	0	EUR	115	84193471	84272292	78821
EUR_58	0	EUR	115	84307433	84457650	150217
EUR_58	0	EUR	115	84483013	84508973	25960
EUR_58	0	EUR	115	88020002	88073004	53002
EUR_58	0	EUR	115	92657968	92893775	235807
EUR_58	0	EUR	115	96628171	96660713	32542
EUR_58	0	EUR	115	96938041	96985749	47708
EUR_58	0	EUR	115	97561435	97606042	44607
EUR_59	0	EUR	116	1658	38454	36796
EUR_59	0	EUR	116	2403879	2436497	32618
EUR_59	0	EUR	116	5623952	5720427	96475
EUR_59	0	EUR	116	7801499	7820138	18639
EUR_59	0	EUR	116	14599834	14699483	99649
EUR_59	0	EUR	116	15571100	15608201	37101
EUR_59	0	EUR	116	16960554	17021252	60698
EUR_59	0	EUR	116	19395138	19439044	43906
EUR_59	0	EUR	116	21168069	21168829	760
EUR_59	0	EUR	116	21179486	21230787	51301
EUR_59	0	EUR	116	21282427	21309916	27489
EUR_59	0	EUR	116	21476031	21565644	89613
EUR_59	0	EUR	116	21712454	21732547	20093
EUR_59	0	EUR	116	21737927	21739071	1144
EUR_59	0	EUR	116	21751783	21877833	126050
EUR_59	0	EUR	116	21935834	21965772	29938
EUR_59	0	EUR	116	23923937	24061376	137439
EUR_59	0	EUR	116	24655151	24693848	38697
EUR_59	0	EUR	116	28447913	28454759	6846
EUR_59	0	EUR	116	29750374	29765658	15284
EUR_59	0	EUR	116	31062988	31134052	71064
EUR_59	0	EUR	116	31190087	31216844	26757
EUR_59	0	EUR	116	31254911	31267996	13085
EUR_59	0	EUR	116	31340450	31398944	58494
EUR_59	0	EUR	116	31967174	31976562	9388
EUR_59	0	EUR	116	41082532	41103899	21367
EUR_59	0	EUR	116	43273165	43340494	67329
EUR_59	0	EUR	116	45064382	45093802	29420
EUR_59	0	EUR	116	45248451	45295441	46990
EUR_59	0	EUR	116	48988140	49057058	68918
EUR_59	0	EUR	116	49197898	49211922	14024
EUR_59	0	EUR	116	50079988	50148912	68924
EUR_59	0	EUR	116	50244656	50300721	56065
EUR_59	0	EUR	116	50505922	50514335	8413
EUR_59	0	EUR	116	50618884	50682125	63241
EUR_59	0	EUR	116	56642327	56661029	18702
EUR_59	0	EUR	116	60314986	60363981	48995
EUR_59	0	EUR	116	60675915	60681059	5144
EUR_59	0	EUR	116	60697771	60715320	17549
EUR_59	0	EUR	116	62145966	62212401	66435
EUR_59	0	EUR	116	62427365	62482787	55422
EUR_59	0	EUR	116	62516312	62546166	29854
EUR_59	0	EUR	116	64831271	64853959	22688
EUR_59	0	EUR	116	66827940	66897711	69771
EUR_59	0	EUR	116	68124552	68219989	95437
EUR_59	0	EUR	116	68511938	68556045	44107
EUR_59	0	EUR	116	69976346	70054764	78418
EUR_59	0	EUR	116	71343782	71387487	43705
EUR_59	0	EUR	116	72313374	72338979	25605
EUR_59	0	EUR	116	74269035	74332051	63016
EUR_59	0	EUR	116	75195082	75227717	32635
EUR_59	0	EUR	116	76321922	76350618	28696
EUR_59	0	EUR	116	78278359	78281355	2996
EUR_59	0	EUR	116	81329834	81397143	67309
EUR_59	0	EUR	116	82777601	82808198	30597
EUR_59	0	EUR	116	84120494	84134162	13668
EUR_59	0	EUR	116	84271016	84413705	142689
EUR_59	0	EUR	116	84762165	84809687	47522
EUR_59	0	EUR	116	86340983	86343443	2460
EUR_59	0	EUR	116	93177388	93227052	49664
EUR_59	0	EUR	116	93579639	93661778	82139
EUR_59	0	EUR	116	96629989	96795126	165137
EUR_59	0	EUR	116	96935175	96957114	21939
EUR_59	0	EUR	117	9913	16835	6922
EUR_59	0	EUR	117	257772	309123	51351
EUR_59	0	EUR	117	5693494	5720427	26933
EUR_59	0	EUR	117	5865668	5877135	11467
EUR_59	0	EUR	117	8040668	8074467	33799
EUR_59	0	EUR	117	12436919	12518164	81245
EUR_59	0	EUR	117	12541608	12571424	29816
EUR_59	0	EUR	117	12838563	12870468	31905
EUR_59	0	EUR	117	15607322	15740215	132893
EUR_59	0	EUR	117	17002809	17115665	112856
EUR_59	0	EUR	117	19569358	19651006	81648
EUR_59	0	EUR	117	19794816	19815522	20706
EUR_59	0	EUR	117	21793054	21854646	61592
EUR_59	0	EUR	117	21935834	21958294	22460
EUR_59	0	EUR	117	23507155	23562645	55490
EUR_59	0	EUR	117	23639213	23696381	57168
EUR_59	0	EUR	117	23995828	24019885	24057
EUR_59	0	EUR	117	24690259	24693848	3589
EUR_59	0	EUR	117	26941318	27027989	86671
EUR_59	0	EUR	117	28447913	28459172	11259
EUR_59	0	EUR	117	29750374	29765658	15284
EUR_59	0	EUR	117	31062988	31134052	71064
EUR_59	0	EUR	117	31190087	31216844	26757
EUR_59	0	EUR	117	31254911	31267996	13085
EUR_59	0	EUR	117	31340450	31464998	124548
EUR_59	0	EUR	117	32482310	32532337	50027
EUR_59	0	EUR	117	43321108	43337414	16306
EUR_59	0	EUR	117	43726568	43749060	22492
EUR_59	0	EUR	117	45065607	45093802	28195
EUR_59	0	EUR	117	46204155	46222689	18534
EUR_59	0	EUR	117	47573262	47611006	37744
EUR_59	0	EUR	117	48793399	48804986	11587
EUR_59	0	EUR	117	48948395	48955905	7510
EUR_59	0	EUR	117	48980390	48992275	11885
EUR_59	0	EUR	117	49056296	49084376	28080
EUR_59	0	EUR	117	49108894	49211922	103028
EUR_59	0	EUR	117	50079988	50086485	6497
EUR_59	0	EUR	117	50215570	50231640	16070
EUR_59	0	EUR	117	50244656	50300721	56065
EUR_59	0	EUR	117	50505922	50514335	8413
EUR_59	0	EUR	117	50654897	50675343	20446
EUR_59	0	EUR	117	51721135	51826252	105117
EUR_59	0	EUR	117	56660894	56661029	135
EUR_59	0	EUR	117	56998012	57026186	28174
EUR_59	0	EUR	117	59052228	59087449	35221
EUR_59	0	EUR	117	60314986	60367440	52454
EUR_59	0	EUR	117	60391758	60473482	81724
EUR_59	0	EUR	117	62363965	62421852	57887
EUR_59	0	EUR	117	62489657	62534250	44593
EUR_59	0	EUR	117	62735597	62763590	27993
EUR_59	0	EUR	117	64786335	64809344	23009
EUR_59	0	EUR	117	67993239	68056363	63124
EUR_59	0	EUR	117	69253738	69280158	26420
EUR_59	0	EUR	117	71121594	71294859	173265
EUR_59	0	EUR	117	74270667	74332051	61384
EUR_59	0	EUR	117	74634499	74635401	902
EUR_59	0	EUR	117	74651141	74789545	138404
EUR_59	0	EUR	117	76255850	76508147	252297
EUR_59	0	EUR	117	79724839	79803495	78656
EUR_59	0	EUR	117	82777601	82866809	89208
EUR_59	0	EUR	117	84051369	84087948	36579
EUR_59	0	EUR	117	84454434	84508973	54539
EUR_59	0	EUR	117	86183232	86262769	79537
EUR_59	0	EUR	117	88067512	88235236	167724
EUR_59	0	EUR	117	89233989	89360109	126120
EUR_59	0	EUR	117	93210081	93231856	21775
EUR_59	0	EUR	117	93673610	93686534	12924
EUR_59	0	EUR	117	95594113	95706836	112723
EUR_59	0	EUR	117	96229657	96276332	46675
EUR_59	0	EUR	117	96344658	96551349	206691
EUR_59	0	EUR	117	96628171	96660713	32542
EUR_59	0	EUR	117	96934735	96969240	34505
EUR_59	0	EUR	117	97149005	97170445	21440
EUR_59	0	EUR	117	97368034	97434688	66654
EUR_59	0	EUR	117	97516792	97606042	89250
EUR_60	0	EUR	118	1658	38454	36796
EUR_60	0	EUR	118	149110	218251	69141
EUR_60	0	EUR	118	4152972	4155031	2059
EUR_60	0	EUR	118	7801499	7815019	13520
EUR_60	0	EUR	118	7965531	7986929	21398
EUR_60	0	EUR	118	12438062	12482114	44052
EUR_60	0	EUR	118	14599834	14699483	99649
EUR_60	0	EUR	118	15607322	15640899	33577
EUR_60	0	EUR	118	19205162	19218710	13548
EUR_60	0	EUR	118	19375630	19454354	78724
EUR_60	0	EUR	118	19519830	19573587	53757
EUR_60	0	EUR	118	21562696	21649200	86504
EUR_60	0	EUR	118	21793054	21854646	61592
EUR_60	0	EUR	118	21935834	21958294	22460
EUR_60	0	EUR	118	23626899	23638658	11759
EUR_60	0	EUR	118	23874190	23901362	27172
EUR_60	0	EUR	118	27563461	27637833	74372
EUR_60	0	EUR	118	28447913	28496302	48389
EUR_60	0	EUR	118	29871842	29884548	12706
EUR_60	0	EUR	118	29981453	30020785	39332
EUR_60	0	EUR	118	30942828	30969476	26648
EUR_60	0	EUR	118	31321108	31349680	28572
EUR_60	0	EUR	118	41082532	41134854	52322
EUR_60	0	EUR	118	41698837	41768904	70067
EUR_60	0	EUR	118	43750662	43813419	62757
EUR_60	0	EUR	118	44915345	45007478	92133
EUR_60	0	EUR	118	46617726	46628408	10682
EUR_60	0	EUR	118	47874821	48095137	220316
EUR_60	0	EUR	118	48793399	48804986	11587
EUR_60	0	EUR	118	48980390	48992275	11885
EUR_60	0	EUR	118	49107941	49211922	103981
EUR_60	0	EUR	118	49693701	49737279	43578
EUR_60	0	EUR	118	49884766	49940575	55809
EUR_60	0	EUR	118	53307869	53387076	79207
EUR_60	0	EUR	118	60314986	60406009	91023
EUR_60	0	EUR	118	60522994	60623780	100786
EUR_60	0	EUR	118	60697771	60715320	17549
EUR_60	0	EUR	118	61977382	62000629	23247
EUR_60	0	EUR	118	63010595	63041174	30579
EUR_60	0	EUR	118	63177292	63277354	100062
EUR_60	0	EUR	118	64689850	64713211	23361
EUR_60	0	EUR	118	64779628	64968332	188704
EUR_60	0	EUR	118	67796826	67821788	24962
EUR_60	0	EUR	118	69228939	69230695	1756
EUR_60	0	EUR	118	71197734	71260612	62878
EUR_60	0	EUR	118	73164377	73165766	1389
EUR_60	0	EUR	118	74270667	74332051	61384
EUR_60	0	EUR	118	74634499	74635401	902
EUR_60	0	EUR	118	74661597	74663374	1777
EUR_60	0	EUR	118	78026183	78031382	5199
EUR_60	0	EUR	118	79759746	79763512	3766
EUR_60	0	EUR	118	82712051	82718602	6551
EUR_60	0	EUR	118	82850211	82867077	16866
EUR_60	0	EUR	118	84307433	84331408	23975
EUR_60	0	EUR	118	84779402	84797472	18070
EUR_60	0	EUR	118	86464439	86466441	2002
EUR_60	0	EUR	118	93210081	93293706	83625
EUR_60	0	EUR	118	96938041	96970993	32952
EUR_60	0	EUR	118	97670105	97695638	25533
EUR_60	0	EUR	119	1312802	1474375	161573
EUR_60	0	EUR	119	2267390	2417674	150284
EUR_60	0	EUR	119	5633934	5741613	107679
EUR_60	0	EUR	119	7974775	8034150	59375
EUR_60	0	EUR	119	10504963	10525722	20759
EUR_60	0	EUR	119	11806694	11836160	29466
EUR_60	0	EUR	119	12195294	12394574	199280
EUR_60	0	EUR	119	12517970	12541493	23523
EUR_60	0	EUR	119	13943659	14014184	70525
EUR_60	0	EUR	119	15675475	15740215	64740
EUR_60	0	EUR	119	16289550	16444740	155190
EUR_60	0	EUR	119	19445931	19447994	2063
EUR_60	0	EUR	119	23697124	23828153	131029
EUR_60	0	EUR	119	27595814	27803948	208134
EUR_60	0	EUR	119	28447913	28473925	26012
EUR_60	0	EUR	119	28909134	28912719	3585
EUR_60	0	EUR	119	30953172	30988149	34977
EUR_60	0	EUR	119	31118464	31136194	17730
EUR_60	0	EUR	119	31340450	31370213	29763
EUR_60	0	EUR	119	40952583	41034990	82407
EUR_60	0	EUR	119	43300726	43340494	39768
EUR_60	0	EUR	119	43751615	43808041	56426
EUR_60	0	EUR	119	45980594	46044606	64012
EUR_60	0	EUR	119	46135355	46167330	31975
EUR_60	0	EUR	119	46345940	46424629	78689
EUR_60	0	EUR	119	46603480	46692826	89346
EUR_60	0	EUR	119	46958473	46998835	40362
EUR_60	0	EUR	119	48806513	48831623	25110
EUR_60	0	EUR	119	49039217	49084376	45159
EUR_60	0	EUR	119	49091260	49211922	120662
EUR_60	0	EUR	119	49455843	49460677	4834
EUR_60	0	EUR	119	49488939	49645607	156668
EUR_60	0	EUR	119	50079988	50086485	6497
EUR_60	0	EUR	119	50215570	50231640	16070
EUR_60	0	EUR	119	50244656	50300721	56065
EUR_60	0	EUR	119	50505922	50514335	8413
EUR_60	0	EUR	119	50654897	50675343	20446
EUR_60	0	EUR	119	54327238	54429543	102305
EUR_60	0	EUR	119	54447874	54485919	38045
EUR_60	0	EUR	119	60314986	60366947	51961
EUR_60	0	EUR	119	60567912	60623780	55868
EUR_60	0	EUR	119	62427707	62455504	27797
EUR_60	0	EUR	119	63010595	63041174	30579
EUR_60	0	EUR	119	64690778	64713211	22433
EUR_60	0	EUR	119	64779628	64885947	106319
EUR_60	0	EUR	119	66900632	66900890	258
EUR_60	0	EUR	119	67099623	67113280	13657
EUR_60	0	EUR	119	69225884	69257859	31975
EUR_60	0	EUR	119	70314329	70323506	9177
EUR_60	0	EUR	119	71466177	71480877	14700
EUR_60	0	EUR	119	74070851	74114411	43560
EUR_60	0	EUR	119	74609427	74656895	47468
EUR_60	0	EUR	119	74733587	74756907	23320
EUR_60	0	EUR	119	80903139	80904640	1501
EUR_60	0	EUR	119	80947447	80965346	17899
EUR_60	0	EUR	119	82859836	82901545	41709
EUR_60	0	EUR	119	84174413	84347352	172939
EUR_60	0	EUR	119	84385265	84501788	116523
EUR_60	0	EUR	119	86999163	87004998	5835
EUR_60	0	EUR	119	96215188	96313082	97894
EUR_60	0	EUR	119	96935175	96957114	21939
