name	time	pop	left	right	length
EUR_1	50000	EUR	19127220	19527944	400724
EUR_1	50000	EUR	50960983	51219943	258960
EUR_1	50000	EUR	54542568	55565589	1023021
EUR_1	50000	EUR	59782108	59938917	156809
EUR_1	50000	EUR	95275454	96092356	816902
EUR_1	50000	EUR	482833	887166	404333
EUR_1	50000	EUR	9178348	9191865	13517
EUR_1	50000	EUR	47755037	48715368	960331
EUR_1	50000	EUR	62276039	62914084	638045
EUR_1	50000	EUR	84342084	84432573	90489
EUR_1	50000	EUR	88992283	89283098	290815
EUR_1	50000	EUR	96935175	98867955	1932780
EUR_2	50000	EUR	0	747704	747704
EUR_2	50000	EUR	17874426	18158774	284348
EUR_2	50000	EUR	46869363	49445009	2575646
EUR_2	50000	EUR	59609372	59762285	152913
EUR_2	50000	EUR	62976574	64048404	1071830
EUR_2	50000	EUR	74092259	74111582	19323
EUR_2	50000	EUR	75192676	75719284	526608
EUR_2	50000	EUR	83148795	83790282	641487
EUR_2	50000	EUR	84040452	85382299	1341847
EUR_3	50000	EUR	12978494	13749149	770655
EUR_3	50000	EUR	86954468	87115837	161369
EUR_3	50000	EUR	98247583	98867955	620372
EUR_3	50000	EUR	2390434	2548507	158073
EUR_3	50000	EUR	12386475	13748542	1362067
EUR_3	50000	EUR	16556677	16622461	65784
EUR_3	50000	EUR	27367141	27927317	560176
EUR_3	50000	EUR	35242896	36110972	868076
EUR_3	50000	EUR	80381576	81015903	634327
EUR_3	50000	EUR	92978633	94091139	1112506
EUR_3	50000	EUR	97826957	99781615	1954658
EUR_4	50000	EUR	31273240	32581466	1308226
EUR_4	50000	EUR	43066847	43892072	825225
EUR_4	50000	EUR	48187183	48905680	718497
EUR_4	50000	EUR	50017733	51025535	1007802
EUR_4	50000	EUR	64332882	64618542	285660
EUR_4	50000	EUR	81250649	81534639	283990
EUR_4	50000	EUR	84040452	85382299	1341847
EUR_4	50000	EUR	18842024	18924955	82931
EUR_4	50000	EUR	25499984	26121918	621934
EUR_4	50000	EUR	45919475	45981151	61676
EUR_4	50000	EUR	62447396	62679200	231804
EUR_4	50000	EUR	64648112	67079423	2431311
EUR_5	50000	EUR	975930	1414360	438430
EUR_5	50000	EUR	12604239	12776130	171891
EUR_5	50000	EUR	21053031	21290475	237444
EUR_5	50000	EUR	47573262	48321534	748272
EUR_5	50000	EUR	51721135	51826252	105117
EUR_5	50000	EUR	94031298	94767078	735780
EUR_5	50000	EUR	97229828	97235742	5914
EUR_5	50000	EUR	35329644	37781345	2451701
EUR_5	50000	EUR	54156560	54894861	738301
EUR_5	50000	EUR	60580754	61382986	802232
EUR_6	50000	EUR	88436	887166	798730
EUR_6	50000	EUR	3385702	4253081	867379
EUR_6	50000	EUR	56825387	58347750	1522363
EUR_6	50000	EUR	58008794	58023254	14460
EUR_6	50000	EUR	73247966	73607499	359533
EUR_6	50000	EUR	94687120	94828898	141778
EUR_7	50000	EUR	2266226	4693520	2427294
EUR_7	50000	EUR	10591174	10605170	13996
EUR_7	50000	EUR	15837982	16135699	297717
EUR_7	50000	EUR	30338563	31098617	760054
EUR_7	50000	EUR	38786996	40532520	1745524
EUR_7	50000	EUR	56477469	57053710	576241
EUR_7	50000	EUR	67104727	67378599	273872
EUR_7	50000	EUR	1969736	2103100	133364
EUR_7	50000	EUR	9178348	9374161	195813
EUR_7	50000	EUR	27780237	28550679	770442
EUR_7	50000	EUR	45779531	46004405	224874
EUR_7	50000	EUR	59079996	59875641	795645
EUR_7	50000	EUR	66329807	66362168	32361
EUR_7	50000	EUR	78000198	78333149	332951
EUR_7	50000	EUR	81939196	82257427	318231
EUR_7	50000	EUR	90252537	90798120	545583
EUR_7	50000	EUR	95275454	96092356	816902
EUR_8	50000	EUR	12303898	13277357	973459
EUR_8	50000	EUR	17935003	18493896	558893
EUR_8	50000	EUR	20919793	21048196	128403
EUR_8	50000	EUR	43750662	44088815	338153
EUR_8	50000	EUR	56477469	57053710	576241
EUR_8	50000	EUR	59099981	59113995	14014
EUR_8	50000	EUR	65538537	65722195	183658
EUR_8	50000	EUR	4059608	4333564	273956
EUR_8	50000	EUR	17698801	18310114	611313
EUR_8	50000	EUR	21539204	21965772	426568
EUR_8	50000	EUR	41286506	41675549	389043
EUR_8	50000	EUR	44156331	44161135	4804
EUR_8	50000	EUR	48206789	48715368	508579
EUR_8	50000	EUR	56544194	57182153	637959
EUR_8	50000	EUR	62266230	63883651	1617421
EUR_8	50000	EUR	77470010	77933016	463006
EUR_8	50000	EUR	96379317	96543344	164027
EUR_8	50000	EUR	99365042	99925173	560131
EUR_9	50000	EUR	0	299560	299560
EUR_9	50000	EUR	28771071	30124006	1352935
EUR_9	50000	EUR	56606415	56867904	261489
EUR_9	50000	EUR	67516377	67693426	177049
EUR_9	50000	EUR	82682910	82810328	127418
EUR_9	50000	EUR	2254479	2714275	459796
EUR_9	50000	EUR	36004064	36062268	58204
EUR_9	50000	EUR	48804742	48818489	13747
EUR_9	50000	EUR	72313374	72399948	86574
EUR_9	50000	EUR	85019375	85554609	535234
EUR_10	50000	EUR	32123254	32855838	732584
EUR_10	50000	EUR	49312143	49440694	128551
EUR_10	50000	EUR	54156560	54888926	732366
EUR_10	50000	EUR	84040452	84271381	230929
EUR_10	50000	EUR	10886437	11132879	246442
EUR_10	50000	EUR	12604239	14215670	1611431
EUR_10	50000	EUR	16556677	16674572	117895
EUR_10	50000	EUR	21935834	21965772	29938
EUR_10	50000	EUR	28909134	28912719	3585
EUR_10	50000	EUR	43501961	43571611	69650
EUR_10	50000	EUR	46941843	47383207	441364
EUR_10	50000	EUR	76810926	77160533	349607
EUR_11	40000	EUR	0	8597	8597
EUR_11	40000	EUR	4067245	4101969	34724
EUR_11	40000	EUR	14140059	14161746	21687
EUR_11	40000	EUR	19324499	19493755	169256
EUR_11	40000	EUR	20612442	21216187	603745
EUR_11	40000	EUR	21942088	21965772	23684
EUR_11	40000	EUR	32453173	32787200	334027
EUR_11	40000	EUR	39683884	39959656	275772
EUR_11	40000	EUR	43595172	43817028	221856
EUR_11	40000	EUR	49133746	49164811	31065
EUR_11	40000	EUR	64007129	64060264	53135
EUR_11	40000	EUR	67802545	67901463	98918
EUR_11	40000	EUR	96819904	97253692	433788
EUR_11	40000	EUR	5623952	5741613	117661
EUR_11	40000	EUR	9327703	9647147	319444
EUR_11	40000	EUR	12166455	12498767	332312
EUR_11	40000	EUR	19189424	19465227	275803
EUR_11	40000	EUR	27000566	27015533	14967
EUR_11	40000	EUR	29749217	30224445	475228
EUR_11	40000	EUR	36536523	36652775	116252
EUR_11	40000	EUR	43750662	43846571	95909
EUR_11	40000	EUR	60834393	60897919	63526
EUR_11	40000	EUR	64152513	64192154	39641
EUR_11	40000	EUR	70063263	70143173	79910
EUR_11	40000	EUR	73714003	74433313	719310
EUR_11	40000	EUR	74952867	74953952	1085
EUR_11	40000	EUR	79878461	80057565	179104
EUR_11	40000	EUR	80365634	80466548	100914
EUR_11	40000	EUR	84118542	84198948	80406
EUR_11	40000	EUR	84847586	85007611	160025
EUR_11	40000	EUR	86417646	86479474	61828
EUR_11	40000	EUR	93867328	93983424	116096
EUR_12	40000	EUR	4067245	4258696	191451
EUR_12	40000	EUR	5380293	5526855	146562
EUR_12	40000	EUR	5612289	5741613	129324
EUR_12	40000	EUR	13400034	13652558	252524
EUR_12	40000	EUR	13744802	13748542	3740
EUR_12	40000	EUR	19189424	19465227	275803
EUR_12	40000	EUR	22186191	22214748	28557
EUR_12	40000	EUR	27030183	27172878	142695
EUR_12	40000	EUR	31101337	31198091	96754
EUR_12	40000	EUR	31444098	31913161	469063
EUR_12	40000	EUR	46033726	46484138	450412
EUR_12	40000	EUR	50121706	50139700	17994
EUR_12	40000	EUR	57959433	58064278	104845
EUR_12	40000	EUR	62266230	62449988	183758
EUR_12	40000	EUR	78312904	78326890	13986
EUR_12	40000	EUR	80899922	80948602	48680
EUR_12	40000	EUR	84744924	84859626	114702
EUR_12	40000	EUR	21766544	22064725	298181
EUR_12	40000	EUR	23339358	23438353	98995
EUR_12	40000	EUR	31098605	31134052	35447
EUR_12	40000	EUR	48039880	48801513	761633
EUR_12	40000	EUR	49006754	49164811	158057
EUR_12	40000	EUR	50075754	50139700	63946
EUR_12	40000	EUR	53195740	53215009	19269
EUR_12	40000	EUR	55662959	55943914	280955
EUR_12	40000	EUR	56926210	56952580	26370
EUR_12	40000	EUR	59025323	59087449	62126
EUR_12	40000	EUR	62360857	62537606	176749
EUR_12	40000	EUR	62626144	63041174	415030
EUR_12	40000	EUR	64559645	64648825	89180
EUR_12	40000	EUR	67516377	67550551	34174
EUR_12	40000	EUR	71466211	71510785	44574
EUR_12	40000	EUR	73460990	73621956	160966
EUR_12	40000	EUR	76406273	76485346	79073
EUR_12	40000	EUR	79636078	79781838	145760
EUR_12	40000	EUR	96909677	97184963	275286
EUR_12	40000	EUR	97203189	97335488	132299
EUR_12	40000	EUR	98041545	98553700	512155
EUR_13	40000	EUR	5894459	5971269	76810
EUR_13	40000	EUR	9051485	9411162	359677
EUR_13	40000	EUR	11802975	11836160	33185
EUR_13	40000	EUR	12498821	13050169	551348
EUR_13	40000	EUR	29741238	29767219	25981
EUR_13	40000	EUR	43547085	43852571	305486
EUR_13	40000	EUR	46588754	46702870	114116
EUR_13	40000	EUR	47624392	47744901	120509
EUR_13	40000	EUR	57959433	58064278	104845
EUR_13	40000	EUR	60836692	60933571	96879
EUR_13	40000	EUR	63735447	64066021	330574
EUR_13	40000	EUR	72313374	72399948	86574
EUR_13	40000	EUR	74737587	74953952	216365
EUR_13	40000	EUR	81329834	81426284	96450
EUR_13	40000	EUR	84059860	84133615	73755
EUR_13	40000	EUR	84248591	84284876	36285
EUR_13	40000	EUR	9633606	10496018	862412
EUR_13	40000	EUR	12166455	12231489	65034
EUR_13	40000	EUR	13001397	13085270	83873
EUR_13	40000	EUR	14713216	14909313	196097
EUR_13	40000	EUR	19490258	19509281	19023
EUR_13	40000	EUR	20919793	21048196	128403
EUR_13	40000	EUR	30743485	30841267	97782
EUR_13	40000	EUR	48146977	48250037	103060
EUR_13	40000	EUR	50020142	50516476	496334
EUR_13	40000	EUR	55568745	55651082	82337
EUR_13	40000	EUR	59745200	59789210	44010
EUR_13	40000	EUR	60580754	60988138	407384
EUR_13	40000	EUR	61775819	61825359	49540
EUR_13	40000	EUR	62423497	62754209	330712
EUR_13	40000	EUR	64400103	64676127	276024
EUR_13	40000	EUR	65607977	66060924	452947
EUR_13	40000	EUR	69004995	69315282	310287
EUR_13	40000	EUR	73866047	74462618	596571
EUR_13	40000	EUR	82096594	82248911	152317
EUR_13	40000	EUR	82712051	83035646	323595
EUR_13	40000	EUR	84271016	84589581	318565
EUR_13	40000	EUR	88161185	88192866	31681
EUR_13	40000	EUR	89056501	89116106	59605
EUR_13	40000	EUR	90737504	90798120	60616
EUR_13	40000	EUR	92657968	92966114	308146
EUR_13	40000	EUR	95540547	95546050	5503
EUR_13	40000	EUR	97439953	97542615	102662
EUR_14	40000	EUR	0	38454	38454
EUR_14	40000	EUR	4067245	4101969	34724
EUR_14	40000	EUR	5748464	5800485	52021
EUR_14	40000	EUR	12166455	12300041	133586
EUR_14	40000	EUR	13229578	13565189	335611
EUR_14	40000	EUR	14713216	14904614	191398
EUR_14	40000	EUR	19490258	19815522	325264
EUR_14	40000	EUR	30174565	30224445	49880
EUR_14	40000	EUR	38601596	38684344	82748
EUR_14	40000	EUR	40884304	41067173	182869
EUR_14	40000	EUR	44688002	44811416	123414
EUR_14	40000	EUR	47069594	47141198	71604
EUR_14	40000	EUR	47624392	47744901	120509
EUR_14	40000	EUR	62363965	62460553	96588
EUR_14	40000	EUR	64025137	64066021	40884
EUR_14	40000	EUR	69991439	70318525	327086
EUR_14	40000	EUR	72313374	72399948	86574
EUR_14	40000	EUR	75018361	75213527	195166
EUR_14	40000	EUR	83543294	83547818	4524
EUR_14	40000	EUR	85014022	85039484	25462
EUR_14	40000	EUR	89360185	89463966	103781
EUR_14	40000	EUR	12350442	12929392	578950
EUR_14	40000	EUR	23507155	23676423	169268
EUR_14	40000	EUR	29578129	29606582	28453
EUR_14	40000	EUR	39781521	40486683	705162
EUR_14	40000	EUR	50001047	50063201	62154
EUR_14	40000	EUR	61672452	61750181	77729
EUR_14	40000	EUR	62266230	62443764	177534
EUR_14	40000	EUR	62493467	62546944	53477
EUR_14	40000	EUR	64213067	64332094	119027
EUR_14	40000	EUR	88064488	88163055	98567
EUR_14	40000	EUR	93824275	93983424	159149
EUR_15	40000	EUR	2546547	2868801	322254
EUR_15	40000	EUR	4067245	4576126	508881
EUR_15	40000	EUR	11827144	12386769	559625
EUR_15	40000	EUR	14032040	14295184	263144
EUR_15	40000	EUR	19553736	19815522	261786
EUR_15	40000	EUR	31358728	31564869	206141
EUR_15	40000	EUR	39683884	40019809	335925
EUR_15	40000	EUR	50121706	50139700	17994
EUR_15	40000	EUR	51721135	51826252	105117
EUR_15	40000	EUR	54298907	54463647	164740
EUR_15	40000	EUR	56739090	56867904	128814
EUR_15	40000	EUR	59931426	59938917	7491
EUR_15	40000	EUR	62266230	62516189	249959
EUR_15	40000	EUR	63290316	63549215	258899
EUR_15	40000	EUR	63947203	64035302	88099
EUR_15	40000	EUR	69991439	70318525	327086
EUR_15	40000	EUR	77152145	77201526	49381
EUR_15	40000	EUR	81956784	82014609	57825
EUR_15	40000	EUR	96454365	96606510	152145
EUR_15	40000	EUR	97137184	97229983	92799
EUR_15	40000	EUR	97580196	98146557	566361
EUR_15	40000	EUR	1368100	1622588	254488
EUR_15	40000	EUR	13071066	13369355	298289
EUR_15	40000	EUR	15480623	15577035	96412
EUR_15	40000	EUR	19451591	19484817	33226
EUR_15	40000	EUR	30528228	31263629	735401
EUR_15	40000	EUR	41082532	41386596	304064
EUR_15	40000	EUR	49589824	49637628	47804
EUR_15	40000	EUR	53185452	53248662	63210
EUR_15	40000	EUR	67673403	67733569	60166
EUR_15	40000	EUR	73344343	73621956	277613
EUR_15	40000	EUR	79636078	79837106	201028
EUR_15	40000	EUR	80169302	80492274	322972
EUR_15	40000	EUR	84744924	84859626	114702
EUR_15	40000	EUR	92491162	92750437	259275
EUR_15	40000	EUR	96909677	97184963	275286
EUR_15	40000	EUR	97203189	97335488	132299
EUR_15	40000	EUR	98041545	98553700	512155
EUR_16	40000	EUR	196934	206962	10028
EUR_16	40000	EUR	7991076	8157835	166759
EUR_16	40000	EUR	12592297	12645530	53233
EUR_16	40000	EUR	14032040	14295184	263144
EUR_16	40000	EUR	24541668	24875637	333969
EUR_16	40000	EUR	43066847	43382485	315638
EUR_16	40000	EUR	44182199	44353481	171282
EUR_16	40000	EUR	48137196	48501306	364110
EUR_16	40000	EUR	48730455	48852598	122143
EUR_16	40000	EUR	54201120	54258186	57066
EUR_16	40000	EUR	56739090	56867904	128814
EUR_16	40000	EUR	61435163	61520121	84958
EUR_16	40000	EUR	62266230	62301664	35434
EUR_16	40000	EUR	63616457	63767652	151195
EUR_16	40000	EUR	67802545	68008547	206002
EUR_16	40000	EUR	73344343	73621956	277613
EUR_16	40000	EUR	77940158	77981834	41676
EUR_16	40000	EUR	81789814	81974654	184840
EUR_16	40000	EUR	82084282	82192866	108584
EUR_16	40000	EUR	96808612	96983305	174693
EUR_16	40000	EUR	994187	1121593	127406
EUR_16	40000	EUR	5612289	5629543	17254
EUR_16	40000	EUR	12564547	13085270	520723
EUR_16	40000	EUR	28909134	28912719	3585
EUR_16	40000	EUR	48891623	49409796	518173
EUR_16	40000	EUR	49591055	49792315	201260
EUR_16	40000	EUR	56981282	57026186	44904
EUR_16	40000	EUR	60580754	60767465	186711
EUR_16	40000	EUR	61775819	62537606	761787
EUR_16	40000	EUR	62626144	63041174	415030
EUR_16	40000	EUR	64559645	64648825	89180
EUR_16	40000	EUR	67516377	67550551	34174
EUR_16	40000	EUR	73344343	73440646	96303
EUR_16	40000	EUR	76219599	76386209	166610
EUR_16	40000	EUR	82712051	83035646	323595
EUR_16	40000	EUR	96536306	97108754	572448
EUR_16	40000	EUR	97398476	98146557	748081
EUR_17	40000	EUR	11155402	11267811	112409
EUR_17	40000	EUR	13990229	14206093	215864
EUR_17	40000	EUR	14623115	14641335	18220
EUR_17	40000	EUR	22420714	22571400	150686
EUR_17	40000	EUR	27699854	27765523	65669
EUR_17	40000	EUR	29201265	29403219	201954
EUR_17	40000	EUR	33953984	34131064	177080
EUR_17	40000	EUR	35329644	35348990	19346
EUR_17	40000	EUR	37227560	37455443	227883
EUR_17	40000	EUR	43066847	43566857	500010
EUR_17	40000	EUR	44651613	44811416	159803
EUR_17	40000	EUR	49589824	49961812	371988
EUR_17	40000	EUR	50214714	50684992	470278
EUR_17	40000	EUR	55727235	55943914	216679
EUR_17	40000	EUR	56088795	56202989	114194
EUR_17	40000	EUR	62363965	62460553	96588
EUR_17	40000	EUR	62808129	62863488	55359
EUR_17	40000	EUR	69084451	69099903	15452
EUR_17	40000	EUR	79823819	80047802	223983
EUR_17	40000	EUR	88064488	88315643	251155
EUR_17	40000	EUR	96645441	96684466	39025
EUR_17	40000	EUR	1581345	1671703	90358
EUR_17	40000	EUR	10148513	10335169	186656
EUR_17	40000	EUR	11967943	12005846	37903
EUR_17	40000	EUR	12594483	12687739	93256
EUR_17	40000	EUR	12959122	12989272	30150
EUR_17	40000	EUR	17183404	17259360	75956
EUR_17	40000	EUR	22922311	23158720	236409
EUR_17	40000	EUR	23358116	23379796	21680
EUR_17	40000	EUR	30642174	30878325	236151
EUR_17	40000	EUR	39781521	40486683	705162
EUR_17	40000	EUR	44182199	44353481	171282
EUR_17	40000	EUR	46821026	46998835	177809
EUR_17	40000	EUR	49067936	49164811	96875
EUR_17	40000	EUR	54092263	54139664	47401
EUR_17	40000	EUR	55133951	55176093	42142
EUR_17	40000	EUR	57959433	58064278	104845
EUR_17	40000	EUR	60613717	60988138	374421
EUR_17	40000	EUR	67382553	67392164	9611
EUR_17	40000	EUR	67945509	68176869	231360
EUR_17	40000	EUR	70200024	70323506	123482
EUR_17	40000	EUR	77659474	77705895	46421
EUR_17	40000	EUR	81834623	81951234	116611
EUR_17	40000	EUR	84040452	84198948	158496
EUR_17	40000	EUR	96215188	97584976	1369788
EUR_18	40000	EUR	4067245	4132846	65601
EUR_18	40000	EUR	12480475	12687739	207264
EUR_18	40000	EUR	14501013	14758699	257686
EUR_18	40000	EUR	15526420	15701244	174824
EUR_18	40000	EUR	16651776	16663817	12041
EUR_18	40000	EUR	17587984	17857804	269820
EUR_18	40000	EUR	18494323	18604686	110363
EUR_18	40000	EUR	31068444	31233050	164606
EUR_18	40000	EUR	44651613	44817985	166372
EUR_18	40000	EUR	45003549	45007478	3929
EUR_18	40000	EUR	47876289	47900182	23893
EUR_18	40000	EUR	52049469	52092551	43082
EUR_18	40000	EUR	56606415	56867904	261489
EUR_18	40000	EUR	60834393	60897919	63526
EUR_18	40000	EUR	62060602	62076335	15733
EUR_18	40000	EUR	63947203	64066021	118818
EUR_18	40000	EUR	64076405	64481665	405260
EUR_18	40000	EUR	67529684	67733569	203885
EUR_18	40000	EUR	69976346	70323506	347160
EUR_18	40000	EUR	83699331	83845592	146261
EUR_18	40000	EUR	91198280	91198684	404
EUR_18	40000	EUR	28909134	28912719	3585
EUR_18	40000	EUR	46645242	46898836	253594
EUR_18	40000	EUR	48474462	48715368	240906
EUR_18	40000	EUR	53195740	53215009	19269
EUR_18	40000	EUR	53914631	53938830	24199
EUR_18	40000	EUR	55608330	55943914	335584
EUR_18	40000	EUR	56088795	56202989	114194
EUR_18	40000	EUR	63177292	63277354	100062
EUR_18	40000	EUR	73245291	73299538	54247
EUR_18	40000	EUR	76219599	76336677	117078
EUR_18	40000	EUR	76964560	77018398	53838
EUR_18	40000	EUR	83692011	83727774	35763
EUR_18	40000	EUR	96215188	97584976	1369788
EUR_19	40000	EUR	8771111	9042764	271653
EUR_19	40000	EUR	15607322	16041545	434223
EUR_19	40000	EUR	21398553	21428911	30358
EUR_19	40000	EUR	29749217	29884548	135331
EUR_19	40000	EUR	39093544	39182279	88735
EUR_19	40000	EUR	41227254	41386596	159342
EUR_19	40000	EUR	44182199	44353481	171282
EUR_19	40000	EUR	49170933	49589727	418794
EUR_19	40000	EUR	50121706	50139700	17994
EUR_19	40000	EUR	62067635	62243586	175951
EUR_19	40000	EUR	67432373	67704856	272483
EUR_19	40000	EUR	77152145	77201526	49381
EUR_19	40000	EUR	79228995	79380093	151098
EUR_19	40000	EUR	81849638	82014609	164971
EUR_19	40000	EUR	90308604	90651092	342488
EUR_19	40000	EUR	95113083	95769773	656690
EUR_19	40000	EUR	96935175	97293915	358740
EUR_19	40000	EUR	98090476	98553700	463224
EUR_19	40000	EUR	196934	206962	10028
EUR_19	40000	EUR	994187	1125339	131152
EUR_19	40000	EUR	13096243	13191657	95414
EUR_19	40000	EUR	14750581	14751815	1234
EUR_19	40000	EUR	14790075	14920107	130032
EUR_19	40000	EUR	19490258	19815522	325264
EUR_19	40000	EUR	22186351	22214748	28397
EUR_19	40000	EUR	29749217	30224445	475228
EUR_19	40000	EUR	31020964	31084206	63242
EUR_19	40000	EUR	43590054	43829551	239497
EUR_19	40000	EUR	45719414	45742393	22979
EUR_19	40000	EUR	49589824	50063201	473377
EUR_19	40000	EUR	56981282	57026186	44904
EUR_19	40000	EUR	62238541	62546944	308403
EUR_19	40000	EUR	70063263	70143173	79910
EUR_19	40000	EUR	77940158	77981834	41676
EUR_19	40000	EUR	83543294	84552343	1009049
EUR_19	40000	EUR	95144247	95179379	35132
EUR_19	40000	EUR	96087102	96192568	105466
EUR_19	40000	EUR	96344658	96679252	334594
EUR_20	40000	EUR	10536751	10559629	22878
EUR_20	40000	EUR	12959122	12963600	4478
EUR_20	40000	EUR	14713216	14909313	196097
EUR_20	40000	EUR	28909134	28912719	3585
EUR_20	40000	EUR	29741238	29767219	25981
EUR_20	40000	EUR	31785402	32403171	617769
EUR_20	40000	EUR	43066847	43382485	315638
EUR_20	40000	EUR	47868799	48035282	166483
EUR_20	40000	EUR	49798646	50063201	264555
EUR_20	40000	EUR	54190988	54258186	67198
EUR_20	40000	EUR	62266230	62344730	78500
EUR_20	40000	EUR	62756917	62794679	37762
EUR_20	40000	EUR	66901089	67015056	113967
EUR_20	40000	EUR	67141252	67765396	624144
EUR_20	40000	EUR	72313374	72399948	86574
EUR_20	40000	EUR	76664084	76797843	133759
EUR_20	40000	EUR	84074915	84083936	9021
EUR_20	40000	EUR	4059608	4161432	101824
EUR_20	40000	EUR	12235935	12299867	63932
EUR_20	40000	EUR	23358116	23438353	80237
EUR_20	40000	EUR	24835791	25051204	215413
EUR_20	40000	EUR	30743485	30841267	97782
EUR_20	40000	EUR	48891623	49409796	518173
EUR_20	40000	EUR	49591055	49792315	201260
EUR_20	40000	EUR	54183346	54258186	74840
EUR_20	40000	EUR	55925886	55943914	18028
EUR_20	40000	EUR	56795478	56867904	72426
EUR_20	40000	EUR	56983256	57026186	42930
EUR_20	40000	EUR	60834393	60897919	63526
EUR_20	40000	EUR	67529684	67733569	203885
EUR_20	40000	EUR	69976346	70323506	347160
EUR_20	40000	EUR	81789814	81974654	184840
EUR_20	40000	EUR	84040452	84198948	158496
EUR_20	40000	EUR	95127554	95397499	269945
EUR_20	40000	EUR	97200322	97235742	35420
EUR_21	30000	EUR	5689746	5741613	51867
EUR_21	30000	EUR	12592297	12592393	96
EUR_21	30000	EUR	16960554	17029159	68605
EUR_21	30000	EUR	22370098	22698639	328541
EUR_21	30000	EUR	23507155	23576056	68901
EUR_21	30000	EUR	30528228	30590405	62177
EUR_21	30000	EUR	43404146	43566857	162711
EUR_21	30000	EUR	43829906	43852571	22665
EUR_21	30000	EUR	44058762	44080181	21419
EUR_21	30000	EUR	45485530	45495004	9474
EUR_21	30000	EUR	45919475	46069871	150396
EUR_21	30000	EUR	48273976	48321534	47558
EUR_21	30000	EUR	49050712	49139016	88304
EUR_21	30000	EUR	51821951	52045718	223767
EUR_21	30000	EUR	53001895	53302464	300569
EUR_21	30000	EUR	54422321	54463647	41326
EUR_21	30000	EUR	54568733	54580607	11874
EUR_21	30000	EUR	54779751	54834542	54791
EUR_21	30000	EUR	55505150	55603453	98303
EUR_21	30000	EUR	63177292	63277354	100062
EUR_21	30000	EUR	63330030	63427526	97496
EUR_21	30000	EUR	67824287	67905310	81023
EUR_21	30000	EUR	70314329	70323506	9177
EUR_21	30000	EUR	70425266	70471952	46686
EUR_21	30000	EUR	73344343	73621956	277613
EUR_21	30000	EUR	74118442	74159054	40612
EUR_21	30000	EUR	78278359	78281355	2996
EUR_21	30000	EUR	84971245	84989654	18409
EUR_21	30000	EUR	89458586	89463966	5380
EUR_21	30000	EUR	91097171	91171662	74491
EUR_21	30000	EUR	92657968	92893775	235807
EUR_21	30000	EUR	96344658	96460323	115665
EUR_21	30000	EUR	97145171	97374985	229814
EUR_21	30000	EUR	2267390	2436497	169107
EUR_21	30000	EUR	4066689	4333564	266875
EUR_21	30000	EUR	8846483	8958572	112089
EUR_21	30000	EUR	9629012	9637337	8325
EUR_21	30000	EUR	17260702	17323735	63033
EUR_21	30000	EUR	28909134	28912719	3585
EUR_21	30000	EUR	31091633	31263629	171996
EUR_21	30000	EUR	35919099	36017172	98073
EUR_21	30000	EUR	39531946	39913649	381703
EUR_21	30000	EUR	44002732	44033993	31261
EUR_21	30000	EUR	44497681	44701885	204204
EUR_21	30000	EUR	50214714	50344415	129701
EUR_21	30000	EUR	54241431	54294851	53420
EUR_21	30000	EUR	61849129	62021622	172493
EUR_21	30000	EUR	62266230	62587991	321761
EUR_21	30000	EUR	64559645	64648825	89180
EUR_21	30000	EUR	64682627	64755238	72611
EUR_21	30000	EUR	65392456	65443601	51145
EUR_21	30000	EUR	67943453	68176869	233416
EUR_21	30000	EUR	70176832	70336637	159805
EUR_21	30000	EUR	72313374	72399948	86574
EUR_21	30000	EUR	83745607	84000212	254605
EUR_21	30000	EUR	84271016	84589581	318565
EUR_21	30000	EUR	93210081	93437672	227591
EUR_21	30000	EUR	95713081	95757302	44221
EUR_21	30000	EUR	96935175	96957114	21939
EUR_21	30000	EUR	97145555	97229983	84428
EUR_21	30000	EUR	97398476	97581104	182628
EUR_22	30000	EUR	0	11076	11076
EUR_22	30000	EUR	4122069	4333564	211495
EUR_22	30000	EUR	10185883	10351635	165752
EUR_22	30000	EUR	12592297	12592393	96
EUR_22	30000	EUR	19316850	19544916	228066
EUR_22	30000	EUR	21586791	21973157	386366
EUR_22	30000	EUR	23793798	23946866	153068
EUR_22	30000	EUR	29201265	29403219	201954
EUR_22	30000	EUR	39475823	39545103	69280
EUR_22	30000	EUR	40040672	40169297	128625
EUR_22	30000	EUR	41252118	41267617	15499
EUR_22	30000	EUR	43816300	43852571	36271
EUR_22	30000	EUR	44183609	44244547	60938
EUR_22	30000	EUR	48540943	48602191	61248
EUR_22	30000	EUR	53195740	53215009	19269
EUR_22	30000	EUR	55283447	55557649	274202
EUR_22	30000	EUR	55683186	55935283	252097
EUR_22	30000	EUR	56606415	56695626	89211
EUR_22	30000	EUR	56981282	57026186	44904
EUR_22	30000	EUR	62427365	62539886	112521
EUR_22	30000	EUR	62584114	62820719	236605
EUR_22	30000	EUR	63089221	63269352	180131
EUR_22	30000	EUR	63334896	63563994	229098
EUR_22	30000	EUR	64034761	64066021	31260
EUR_22	30000	EUR	64332882	64447738	114856
EUR_22	30000	EUR	67360462	67404467	44005
EUR_22	30000	EUR	67581165	67704856	123691
EUR_22	30000	EUR	80747385	80896589	149204
EUR_22	30000	EUR	82979134	83035646	56512
EUR_22	30000	EUR	84271016	84423669	152653
EUR_22	30000	EUR	85810254	85965919	155665
EUR_22	30000	EUR	86183232	86324407	141175
EUR_22	30000	EUR	91097171	91160908	63737
EUR_22	30000	EUR	95964529	96045606	81077
EUR_22	30000	EUR	96882609	97166881	284272
EUR_22	30000	EUR	3994924	4124617	129693
EUR_22	30000	EUR	10148513	10351635	203122
EUR_22	30000	EUR	13471709	13475364	3655
EUR_22	30000	EUR	15872423	16041545	169122
EUR_22	30000	EUR	23249672	23362675	113003
EUR_22	30000	EUR	23678834	23696381	17547
EUR_22	30000	EUR	27190538	27244932	54394
EUR_22	30000	EUR	30736728	31015180	278452
EUR_22	30000	EUR	43547085	43559878	12793
EUR_22	30000	EUR	44253582	44347094	93512
EUR_22	30000	EUR	45719414	45742393	22979
EUR_22	30000	EUR	48942765	49071287	128522
EUR_22	30000	EUR	49807803	50340188	532385
EUR_22	30000	EUR	53195740	53215009	19269
EUR_22	30000	EUR	55283447	55557649	274202
EUR_22	30000	EUR	60401573	60942404	540831
EUR_22	30000	EUR	61881873	62460553	578680
EUR_22	30000	EUR	62808129	62863488	55359
EUR_22	30000	EUR	71108569	71427923	319354
EUR_22	30000	EUR	79917556	79977985	60429
EUR_22	30000	EUR	84074915	84095270	20355
EUR_22	30000	EUR	84174413	84347352	172939
EUR_22	30000	EUR	86340983	86466441	125458
EUR_22	30000	EUR	96476805	96558722	81917
EUR_22	30000	EUR	97133123	97478654	345531
EUR_22	30000	EUR	97607910	97690675	82765
EUR_23	30000	EUR	8846483	8958572	112089
EUR_23	30000	EUR	9390723	9477829	87106
EUR_23	30000	EUR	10310816	10559629	248813
EUR_23	30000	EUR	13070757	13085270	14513
EUR_23	30000	EUR	15607322	15638885	31563
EUR_23	30000	EUR	15697742	15701244	3502
EUR_23	30000	EUR	21335089	21404271	69182
EUR_23	30000	EUR	22024903	22064725	39822
EUR_23	30000	EUR	22947870	23374530	426660
EUR_23	30000	EUR	28909134	28912719	3585
EUR_23	30000	EUR	29201265	29403219	201954
EUR_23	30000	EUR	31159137	31446569	287432
EUR_23	30000	EUR	39475823	39537203	61380
EUR_23	30000	EUR	41227254	41386596	159342
EUR_23	30000	EUR	43066847	43291736	224889
EUR_23	30000	EUR	43547085	43587658	40573
EUR_23	30000	EUR	44199789	44353481	153692
EUR_23	30000	EUR	49589824	49712639	122815
EUR_23	30000	EUR	50494917	50499105	4188
EUR_23	30000	EUR	50834852	50964254	129402
EUR_23	30000	EUR	51721135	51756063	34928
EUR_23	30000	EUR	56606415	56661029	54614
EUR_23	30000	EUR	64007129	64060264	53135
EUR_23	30000	EUR	64632417	65025826	393409
EUR_23	30000	EUR	67529684	67733569	203885
EUR_23	30000	EUR	78312824	78326890	14066
EUR_23	30000	EUR	82740735	83035646	294911
EUR_23	30000	EUR	84586314	84597943	11629
EUR_23	30000	EUR	85960165	86128721	168556
EUR_23	30000	EUR	92601762	92958238	356476
EUR_23	30000	EUR	96873067	96946119	73052
EUR_23	30000	EUR	97516792	97643848	127056
EUR_23	30000	EUR	15926488	15963051	36563
EUR_23	30000	EUR	18850191	18885640	35449
EUR_23	30000	EUR	19316850	19544916	228066
EUR_23	30000	EUR	21586791	21973157	386366
EUR_23	30000	EUR	23849387	24132984	283597
EUR_23	30000	EUR	25018279	25033225	14946
EUR_23	30000	EUR	29836876	29907334	70458
EUR_23	30000	EUR	29960808	30107253	146445
EUR_23	30000	EUR	32469772	32532337	62565
EUR_23	30000	EUR	37289843	37455443	165600
EUR_23	30000	EUR	48540943	48602191	61248
EUR_23	30000	EUR	53195740	53215009	19269
EUR_23	30000	EUR	55283447	55557649	274202
EUR_23	30000	EUR	55683186	55935283	252097
EUR_23	30000	EUR	56606415	56695626	89211
EUR_23	30000	EUR	56981282	57026186	44904
EUR_23	30000	EUR	62427365	62539886	112521
EUR_23	30000	EUR	62584114	62820719	236605
EUR_23	30000	EUR	67051350	67063283	11933
EUR_23	30000	EUR	67726807	67879641	152834
EUR_23	30000	EUR	71347780	71460948	113168
EUR_23	30000	EUR	74609427	74823103	213676
EUR_23	30000	EUR	80700295	80813234	112939
EUR_23	30000	EUR	84271503	84372525	101022
EUR_23	30000	EUR	84634596	84859626	225030
EUR_23	30000	EUR	85810254	85965919	155665
EUR_23	30000	EUR	87069518	87079833	10315
EUR_23	30000	EUR	89337683	89463966	126283
EUR_23	30000	EUR	97100087	97478654	378567
EUR_23	30000	EUR	98187403	98216504	29101
EUR_24	30000	EUR	5922397	5971269	48872
EUR_24	30000	EUR	11926927	11927735	808
EUR_24	30000	EUR	15864253	16036609	172356
EUR_24	30000	EUR	16235802	16340550	104748
EUR_24	30000	EUR	19524348	19815522	291174
EUR_24	30000	EUR	22024903	22064725	39822
EUR_24	30000	EUR	23454655	23632090	177435
EUR_24	30000	EUR	28453419	28568059	114640
EUR_24	30000	EUR	29749217	29804612	55395
EUR_24	30000	EUR	39475823	39545103	69280
EUR_24	30000	EUR	44200642	44431264	230622
EUR_24	30000	EUR	45292333	45333059	40726
EUR_24	30000	EUR	48273976	48321534	47558
EUR_24	30000	EUR	48942765	49071287	128522
EUR_24	30000	EUR	49807803	50340188	532385
EUR_24	30000	EUR	50621631	50675343	53712
EUR_24	30000	EUR	52966223	53302464	336241
EUR_24	30000	EUR	60675915	60703119	27204
EUR_24	30000	EUR	60836692	60933571	96879
EUR_24	30000	EUR	62048759	62460553	411794
EUR_24	30000	EUR	64034761	64066021	31260
EUR_24	30000	EUR	67720425	67829293	108868
EUR_24	30000	EUR	68126213	68219989	93776
EUR_24	30000	EUR	69533022	69656422	123400
EUR_24	30000	EUR	71294860	71374978	80118
EUR_24	30000	EUR	84223686	84589581	365895
EUR_24	30000	EUR	86340983	86466441	125458
EUR_24	30000	EUR	93210081	93437672	227591
EUR_24	30000	EUR	97739562	97944812	205250
EUR_24	30000	EUR	618499	697581	79082
EUR_24	30000	EUR	4066689	4156369	89680
EUR_24	30000	EUR	5612289	5741613	129324
EUR_24	30000	EUR	10531119	10559629	28510
EUR_24	30000	EUR	11187362	11267811	80449
EUR_24	30000	EUR	12959122	12989272	30150
EUR_24	30000	EUR	17321152	17323735	2583
EUR_24	30000	EUR	19490258	19802409	312151
EUR_24	30000	EUR	33959989	34131064	171075
EUR_24	30000	EUR	43816300	43830917	14617
EUR_24	30000	EUR	44780031	44803559	23528
EUR_24	30000	EUR	48978592	49071287	92695
EUR_24	30000	EUR	49591055	49961812	370757
EUR_24	30000	EUR	54035533	54200124	164591
EUR_24	30000	EUR	56981282	57026186	44904
EUR_24	30000	EUR	57744838	57747881	3043
EUR_24	30000	EUR	62427365	62685357	257992
EUR_24	30000	EUR	66915791	67022791	107000
EUR_24	30000	EUR	67043600	67098584	54984
EUR_24	30000	EUR	84271016	84589581	318565
EUR_24	30000	EUR	96707027	97130504	423477
EUR_24	30000	EUR	97407632	97478654	71022
EUR_24	30000	EUR	97607910	97690675	82765
EUR_25	30000	EUR	4067245	4101969	34724
EUR_25	30000	EUR	5623952	5741613	117661
EUR_25	30000	EUR	13302325	13565189	262864
EUR_25	30000	EUR	17225383	17323735	98352
EUR_25	30000	EUR	19490258	19765406	275148
EUR_25	30000	EUR	19772407	19815522	43115
EUR_25	30000	EUR	23695264	23842450	147186
EUR_25	30000	EUR	29749217	29765658	16441
EUR_25	30000	EUR	30423096	30559727	136631
EUR_25	30000	EUR	31048766	31113036	64270
EUR_25	30000	EUR	43750662	43813419	62757
EUR_25	30000	EUR	48700664	48801513	100849
EUR_25	30000	EUR	49006754	49164811	158057
EUR_25	30000	EUR	49914410	50340188	425778
EUR_25	30000	EUR	51719606	52045718	326112
EUR_25	30000	EUR	54094408	54146876	52468
EUR_25	30000	EUR	61849129	61857137	8008
EUR_25	30000	EUR	64162479	64213081	50602
EUR_25	30000	EUR	64302697	64350135	47438
EUR_25	30000	EUR	68126213	68219989	93776
EUR_25	30000	EUR	72313374	72399948	86574
EUR_25	30000	EUR	83752999	83819773	66774
EUR_25	30000	EUR	84252820	84291822	39002
EUR_25	30000	EUR	84527801	84730925	203124
EUR_25	30000	EUR	96935175	96957114	21939
EUR_25	30000	EUR	11155402	11267811	112409
EUR_25	30000	EUR	12635579	12649905	14326
EUR_25	30000	EUR	13486470	13493099	6629
EUR_25	30000	EUR	19205162	19465227	260065
EUR_25	30000	EUR	28909134	28912719	3585
EUR_25	30000	EUR	30665466	30768369	102903
EUR_25	30000	EUR	31342191	31358443	16252
EUR_25	30000	EUR	43750662	43813419	62757
EUR_25	30000	EUR	46821026	46998835	177809
EUR_25	30000	EUR	48547355	48602191	54836
EUR_25	30000	EUR	51819962	51826252	6290
EUR_25	30000	EUR	54163206	54185177	21971
EUR_25	30000	EUR	56767806	56867904	100098
EUR_25	30000	EUR	62480689	62662553	181864
EUR_25	30000	EUR	63947203	64060264	113061
EUR_25	30000	EUR	66848687	66882708	34021
EUR_25	30000	EUR	67516377	67550551	34174
EUR_25	30000	EUR	70314329	70323506	9177
EUR_25	30000	EUR	70425266	70471952	46686
EUR_25	30000	EUR	74609427	74682927	73500
EUR_25	30000	EUR	77940158	77946857	6699
EUR_25	30000	EUR	83543294	83583418	40124
EUR_25	30000	EUR	95645985	95706836	60851
EUR_25	30000	EUR	96707027	97130504	423477
EUR_26	30000	EUR	2267390	2417674	150284
EUR_26	30000	EUR	8916078	8958572	42494
EUR_26	30000	EUR	10444060	10559629	115569
EUR_26	30000	EUR	11221129	11267811	46682
EUR_26	30000	EUR	11804630	11836160	31530
EUR_26	30000	EUR	16872759	16905629	32870
EUR_26	30000	EUR	22370098	22698639	328541
EUR_26	30000	EUR	25625985	25633422	7437
EUR_26	30000	EUR	30982404	31134052	151648
EUR_26	30000	EUR	35895719	35972564	76845
EUR_26	30000	EUR	41449292	41509643	60351
EUR_26	30000	EUR	41698837	41826713	127876
EUR_26	30000	EUR	44183609	44244547	60938
EUR_26	30000	EUR	49862547	49901292	38745
EUR_26	30000	EUR	62607089	62686121	79032
EUR_26	30000	EUR	63258645	63264053	5408
EUR_26	30000	EUR	63354466	63409484	55018
EUR_26	30000	EUR	67529684	67733569	203885
EUR_26	30000	EUR	71153579	71427923	274344
EUR_26	30000	EUR	84252820	84291822	39002
EUR_26	30000	EUR	88064488	88315643	251155
EUR_26	30000	EUR	93579639	93686534	106895
EUR_26	30000	EUR	96935175	96957114	21939
EUR_26	30000	EUR	5359828	5407808	47980
EUR_26	30000	EUR	10444060	10559629	115569
EUR_26	30000	EUR	11221129	11267811	46682
EUR_26	30000	EUR	11804630	11836160	31530
EUR_26	30000	EUR	12741429	12870468	129039
EUR_26	30000	EUR	12980691	12987083	6392
EUR_26	30000	EUR	13096243	13191657	95414
EUR_26	30000	EUR	19189424	19205647	16223
EUR_26	30000	EUR	19445931	19450661	4730
EUR_26	30000	EUR	21705358	21973157	267799
EUR_26	30000	EUR	27566433	27654115	87682
EUR_26	30000	EUR	28909134	28912719	3585
EUR_26	30000	EUR	30128454	30224445	95991
EUR_26	30000	EUR	30382455	30429186	46731
EUR_26	30000	EUR	31204110	31446569	242459
EUR_26	30000	EUR	33352525	33405018	52493
EUR_26	30000	EUR	40559832	40561321	1489
EUR_26	30000	EUR	41698837	41826713	127876
EUR_26	30000	EUR	44497681	44701885	204204
EUR_26	30000	EUR	47888202	48027620	139418
EUR_26	30000	EUR	50524394	50562004	37610
EUR_26	30000	EUR	56642327	56661029	18702
EUR_26	30000	EUR	60697771	60881646	183875
EUR_26	30000	EUR	62102957	62801895	698938
EUR_26	30000	EUR	62808129	62863488	55359
EUR_26	30000	EUR	64569161	64648825	79664
EUR_26	30000	EUR	67529684	67733569	203885
EUR_26	30000	EUR	73483646	73508952	25306
EUR_26	30000	EUR	73920589	74226288	305699
EUR_26	30000	EUR	74345860	74386200	40340
EUR_26	30000	EUR	78312824	78326890	14066
EUR_26	30000	EUR	79636078	79638765	2687
EUR_26	30000	EUR	84495585	84737569	241984
EUR_26	30000	EUR	96344658	96969240	624582
EUR_27	30000	EUR	0	38454	38454
EUR_27	30000	EUR	4066689	4332737	266048
EUR_27	30000	EUR	8864829	8958572	93743
EUR_27	30000	EUR	13242637	13485576	242939
EUR_27	30000	EUR	14713216	14909313	196097
EUR_27	30000	EUR	15949210	16036609	87399
EUR_27	30000	EUR	16235802	16340550	104748
EUR_27	30000	EUR	19191247	19392515	201268
EUR_27	30000	EUR	23695264	23842450	147186
EUR_27	30000	EUR	25018279	25033225	14946
EUR_27	30000	EUR	26757616	26868609	110993
EUR_27	30000	EUR	29201265	29403219	201954
EUR_27	30000	EUR	30665466	31134052	468586
EUR_27	30000	EUR	37289843	37455443	165600
EUR_27	30000	EUR	39537711	39545103	7392
EUR_27	30000	EUR	40040672	40284557	243885
EUR_27	30000	EUR	46167446	46287015	119569
EUR_27	30000	EUR	48240560	48246225	5665
EUR_27	30000	EUR	49862547	49901292	38745
EUR_27	30000	EUR	50295201	50482087	186886
EUR_27	30000	EUR	50807678	50926023	118345
EUR_27	30000	EUR	53081737	53085025	3288
EUR_27	30000	EUR	54035533	54138742	103209
EUR_27	30000	EUR	54171480	54211157	39677
EUR_27	30000	EUR	57959433	58064278	104845
EUR_27	30000	EUR	60697771	60881646	183875
EUR_27	30000	EUR	62266230	62456836	190606
EUR_27	30000	EUR	64632417	65025826	393409
EUR_27	30000	EUR	67720425	68059654	339229
EUR_27	30000	EUR	84040452	84198948	158496
EUR_27	30000	EUR	96429121	96581202	152081
EUR_27	30000	EUR	96954897	97469085	514188
EUR_27	30000	EUR	2458971	2636526	177555
EUR_27	30000	EUR	5515391	5560949	45558
EUR_27	30000	EUR	12592297	12592393	96
EUR_27	30000	EUR	13070331	13111111	40780
EUR_27	30000	EUR	16265965	16340550	74585
EUR_27	30000	EUR	19568716	19815522	246806
EUR_27	30000	EUR	21384205	21428911	44706
EUR_27	30000	EUR	28909134	28912719	3585
EUR_27	30000	EUR	30423096	30559727	136631
EUR_27	30000	EUR	31061901	31226316	164415
EUR_27	30000	EUR	39537711	39545103	7392
EUR_27	30000	EUR	40040672	40284557	243885
EUR_27	30000	EUR	41449292	41517844	68552
EUR_27	30000	EUR	43256147	43477546	221399
EUR_27	30000	EUR	44361001	44404700	43699
EUR_27	30000	EUR	48793399	48832663	39264
EUR_27	30000	EUR	50505922	50514335	8413
EUR_27	30000	EUR	50618884	50682125	63241
EUR_27	30000	EUR	54094408	54258186	163778
EUR_27	30000	EUR	55727235	55744919	17684
EUR_27	30000	EUR	60391758	60626445	234687
EUR_27	30000	EUR	62781664	62797882	16218
EUR_27	30000	EUR	62860595	62872790	12195
EUR_27	30000	EUR	67651819	67724777	72958
EUR_27	30000	EUR	68126213	68219989	93776
EUR_27	30000	EUR	69004995	69315282	310287
EUR_27	30000	EUR	69530905	69699605	168700
EUR_27	30000	EUR	70094238	70144147	49909
EUR_27	30000	EUR	79917556	79977985	60429
EUR_27	30000	EUR	81962315	82042725	80410
EUR_27	30000	EUR	93926019	93983424	57405
EUR_27	30000	EUR	97212058	97478654	266596
EUR_28	30000	EUR	0	809	809
EUR_28	30000	EUR	2640024	2868801	228777
EUR_28	30000	EUR	11187362	11243926	56564
EUR_28	30000	EUR	12585693	12631962	46269
EUR_28	30000	EUR	15697742	15701244	3502
EUR_28	30000	EUR	19023843	19050864	27021
EUR_28	30000	EUR	21164886	21168829	3943
EUR_28	30000	EUR	21179486	21230787	51301
EUR_28	30000	EUR	21282427	21445145	162718
EUR_28	30000	EUR	23849387	24132984	283597
EUR_28	30000	EUR	30382455	30559727	177272
EUR_28	30000	EUR	43750662	43785095	34433
EUR_28	30000	EUR	45719414	45742393	22979
EUR_28	30000	EUR	46891052	46956192	65140
EUR_28	30000	EUR	48891623	48952633	61010
EUR_28	30000	EUR	50208059	50340188	132129
EUR_28	30000	EUR	50505922	50514335	8413
EUR_28	30000	EUR	50618884	50682125	63241
EUR_28	30000	EUR	54035533	54138742	103209
EUR_28	30000	EUR	54171480	54211157	39677
EUR_28	30000	EUR	55365672	55376432	10760
EUR_28	30000	EUR	63156537	63227147	70610
EUR_28	30000	EUR	67726807	67777415	50608
EUR_28	30000	EUR	68047846	68053372	5526
EUR_28	30000	EUR	71294860	71374978	80118
EUR_28	30000	EUR	78312824	78326890	14066
EUR_28	30000	EUR	79917556	79977985	60429
EUR_28	30000	EUR	84271016	84589581	318565
EUR_28	30000	EUR	86183232	86324407	141175
EUR_28	30000	EUR	92657968	92683228	25260
EUR_28	30000	EUR	95964529	95999039	34510
EUR_28	30000	EUR	96454365	96969240	514875
EUR_28	30000	EUR	97306339	97335488	29149
EUR_28	30000	EUR	9913	38454	28541
EUR_28	30000	EUR	1550996	1622588	71592
EUR_28	30000	EUR	11155402	11267811	112409
EUR_28	30000	EUR	12999504	13067942	68438
EUR_28	30000	EUR	19445931	19527944	82013
EUR_28	30000	EUR	21160526	21190857	30331
EUR_28	30000	EUR	31091633	31263629	171996
EUR_28	30000	EUR	39101936	39182279	80343
EUR_28	30000	EUR	41327269	41386596	59327
EUR_28	30000	EUR	48095070	48145084	50014
EUR_28	30000	EUR	50532431	50604242	71811
EUR_28	30000	EUR	50889308	50964254	74946
EUR_28	30000	EUR	54298907	54310566	11659
EUR_28	30000	EUR	59931426	59938917	7491
EUR_28	30000	EUR	62427365	62685357	257992
EUR_28	30000	EUR	64007129	64060264	53135
EUR_28	30000	EUR	65392456	65439431	46975
EUR_28	30000	EUR	67516377	67550551	34174
EUR_28	30000	EUR	73471543	73621956	150413
EUR_28	30000	EUR	76212053	76354315	142262
EUR_28	30000	EUR	78128495	78236096	107601
EUR_28	30000	EUR	79636078	79848351	212273
EUR_28	30000	EUR	82896432	82994729	98297
EUR_28	30000	EUR	86417646	86479474	61828
EUR_28	30000	EUR	86998307	87018305	19998
EUR_28	30000	EUR	96454365	96969240	514875
EUR_28	30000	EUR	97306339	97335488	29149
EUR_28	30000	EUR	97794614	97798893	4279
EUR_28	30000	EUR	97979927	98017859	37932
EUR_29	30000	EUR	5399268	5408555	9287
EUR_29	30000	EUR	5905143	5971269	66126
EUR_29	30000	EUR	8864829	8958572	93743
EUR_29	30000	EUR	9561534	9647147	85613
EUR_29	30000	EUR	10162900	10265441	102541
EUR_29	30000	EUR	11187362	11267811	80449
EUR_29	30000	EUR	12981357	13067942	86585
EUR_29	30000	EUR	15678424	15857544	179120
EUR_29	30000	EUR	16872759	16989582	116823
EUR_29	30000	EUR	19528439	19815522	287083
EUR_29	30000	EUR	20925981	20952589	26608
EUR_29	30000	EUR	39475823	39545103	69280
EUR_29	30000	EUR	41082532	41386596	304064
EUR_29	30000	EUR	48793399	48832663	39264
EUR_29	30000	EUR	52677619	52686699	9080
EUR_29	30000	EUR	54233402	54294851	61449
EUR_29	30000	EUR	54690356	54696544	6188
EUR_29	30000	EUR	62266230	62266246	16
EUR_29	30000	EUR	62495143	62723125	227982
EUR_29	30000	EUR	64559645	64648825	89180
EUR_29	30000	EUR	80106200	80125347	19147
EUR_29	30000	EUR	80307017	80378472	71455
EUR_29	30000	EUR	84736507	84743813	7306
EUR_29	30000	EUR	96518753	96606510	87757
EUR_29	30000	EUR	0	38454	38454
EUR_29	30000	EUR	5399268	5408555	9287
EUR_29	30000	EUR	12959122	12989272	30150
EUR_29	30000	EUR	21618309	21813506	195197
EUR_29	30000	EUR	28909134	28912719	3585
EUR_29	30000	EUR	30912874	31464998	552124
EUR_29	30000	EUR	33352525	33355723	3198
EUR_29	30000	EUR	43750662	43813419	62757
EUR_29	30000	EUR	46821026	46823389	2363
EUR_29	30000	EUR	46994412	46998835	4423
EUR_29	30000	EUR	48281196	48289227	8031
EUR_29	30000	EUR	49589824	50063201	473377
EUR_29	30000	EUR	54201120	54258186	57066
EUR_29	30000	EUR	55891681	55941600	49919
EUR_29	30000	EUR	59129042	59164124	35082
EUR_29	30000	EUR	60314986	60413741	98755
EUR_29	30000	EUR	60675915	60703119	27204
EUR_29	30000	EUR	60755631	60810384	54753
EUR_29	30000	EUR	62679237	62680258	1021
EUR_29	30000	EUR	63010595	63041174	30579
EUR_29	30000	EUR	63239582	63647089	407507
EUR_29	30000	EUR	75059598	75227717	168119
EUR_29	30000	EUR	78278359	78281355	2996
EUR_29	30000	EUR	84040452	84198948	158496
EUR_29	30000	EUR	84736507	84743813	7306
EUR_29	30000	EUR	87069518	87192258	122740
EUR_29	30000	EUR	93579639	93686534	106895
EUR_29	30000	EUR	96344658	96425362	80704
EUR_29	30000	EUR	97137184	97229983	92799
EUR_29	30000	EUR	97398476	97544557	146081
EUR_30	30000	EUR	11221129	11267811	46682
EUR_30	30000	EUR	12000620	12020001	19381
EUR_30	30000	EUR	12166455	12231489	65034
EUR_30	30000	EUR	12992838	13085270	92432
EUR_30	30000	EUR	14026402	14461446	435044
EUR_30	30000	EUR	15678424	15857544	179120
EUR_30	30000	EUR	16872759	16989582	116823
EUR_30	30000	EUR	21117076	21160897	43821
EUR_30	30000	EUR	21935834	21956345	20511
EUR_30	30000	EUR	27236668	27471494	234826
EUR_30	30000	EUR	27834349	27890638	56289
EUR_30	30000	EUR	41449292	41509643	60351
EUR_30	30000	EUR	43816300	43852571	36271
EUR_30	30000	EUR	44183609	44244547	60938
EUR_30	30000	EUR	48311900	48321534	9634
EUR_30	30000	EUR	50214714	50344415	129701
EUR_30	30000	EUR	56606415	56661029	54614
EUR_30	30000	EUR	62196179	62520941	324762
EUR_30	30000	EUR	63947203	64060264	113061
EUR_30	30000	EUR	69976346	70136356	160010
EUR_30	30000	EUR	74609427	74823103	213676
EUR_30	30000	EUR	77940158	77981834	41676
EUR_30	30000	EUR	81834623	81951234	116611
EUR_30	30000	EUR	82141070	82248911	107841
EUR_30	30000	EUR	84495585	84623210	127625
EUR_30	30000	EUR	86183232	86324407	141175
EUR_30	30000	EUR	93210081	93437672	227591
EUR_30	30000	EUR	96215188	96313082	97894
EUR_30	30000	EUR	228095	317557	89462
EUR_30	30000	EUR	12592297	12592393	96
EUR_30	30000	EUR	18850191	18885640	35449
EUR_30	30000	EUR	21384205	21428911	44706
EUR_30	30000	EUR	29749217	29765658	16441
EUR_30	30000	EUR	30423096	30559727	136631
EUR_30	30000	EUR	31048766	31088907	40141
EUR_30	30000	EUR	31969356	31978344	8988
EUR_30	30000	EUR	39537711	39545103	7392
EUR_30	30000	EUR	43750662	43813419	62757
EUR_30	30000	EUR	45330879	45413157	82278
EUR_30	30000	EUR	50537720	50543169	5449
EUR_30	30000	EUR	54156560	54429543	272983
EUR_30	30000	EUR	54447874	54728631	280757
EUR_30	30000	EUR	60836692	60933571	96879
EUR_30	30000	EUR	64559645	64648825	89180
EUR_30	30000	EUR	69612781	69699605	86824
EUR_30	30000	EUR	70094238	70144147	49909
EUR_30	30000	EUR	73245291	73299538	54247
EUR_30	30000	EUR	78278359	78281355	2996
EUR_30	30000	EUR	80757955	80896589	138634
EUR_30	30000	EUR	95540547	95706836	166289
EUR_30	30000	EUR	96344658	96460323	115665
EUR_31	20000	EUR	0	38454	38454
EUR_31	20000	EUR	292297	305368	13071
EUR_31	20000	EUR	7801499	7901153	99654
EUR_31	20000	EUR	10310816	10559629	248813
EUR_31	20000	EUR	11221129	11267811	46682
EUR_31	20000	EUR	12957537	12972366	14829
EUR_31	20000	EUR	15697742	15701244	3502
EUR_31	20000	EUR	16997514	17323735	326221
EUR_31	20000	EUR	19771179	19815522	44343
EUR_31	20000	EUR	21414350	21547886	133536
EUR_31	20000	EUR	21574468	21582697	8229
EUR_31	20000	EUR	21887939	21936915	48976
EUR_31	20000	EUR	23919670	24053709	134039
EUR_31	20000	EUR	28447913	28554899	106986
EUR_31	20000	EUR	29749217	29774921	25704
EUR_31	20000	EUR	29853109	29884548	31439
EUR_31	20000	EUR	31118293	31265497	147204
EUR_31	20000	EUR	31340450	31464998	124548
EUR_31	20000	EUR	31810551	31836096	25545
EUR_31	20000	EUR	39475823	39545103	69280
EUR_31	20000	EUR	41277406	41386596	109190
EUR_31	20000	EUR	47646745	47728980	82235
EUR_31	20000	EUR	48993613	49139016	145403
EUR_31	20000	EUR	49683183	49823430	140247
EUR_31	20000	EUR	50079988	50086485	6497
EUR_31	20000	EUR	50213660	50246763	33103
EUR_31	20000	EUR	50316944	50340188	23244
EUR_31	20000	EUR	53185452	53248662	63210
EUR_31	20000	EUR	60391758	60473482	81724
EUR_31	20000	EUR	62352839	62421852	69013
EUR_31	20000	EUR	62584114	62723208	139094
EUR_31	20000	EUR	62781664	63092804	311140
EUR_31	20000	EUR	63345194	63367008	21814
EUR_31	20000	EUR	64007129	64060264	53135
EUR_31	20000	EUR	64843420	64968332	124912
EUR_31	20000	EUR	67726807	68219989	493182
EUR_31	20000	EUR	71214523	71270702	56179
EUR_31	20000	EUR	74609427	74673535	64108
EUR_31	20000	EUR	78312824	78319054	6230
EUR_31	20000	EUR	80106200	80125347	19147
EUR_31	20000	EUR	80307017	80378472	71455
EUR_31	20000	EUR	81329834	81395863	66029
EUR_31	20000	EUR	84271016	84487039	216023
EUR_31	20000	EUR	84581093	84609377	28284
EUR_31	20000	EUR	86974749	87115837	141088
EUR_31	20000	EUR	92728134	92911223	183089
EUR_31	20000	EUR	96505046	96551349	46303
EUR_31	20000	EUR	96664028	96969240	305212
EUR_31	20000	EUR	5612289	5741613	129324
EUR_31	20000	EUR	12957537	13085270	127733
EUR_31	20000	EUR	13845423	13904570	59147
EUR_31	20000	EUR	15585791	15632929	47138
EUR_31	20000	EUR	15697742	15701244	3502
EUR_31	20000	EUR	15903220	16019493	116273
EUR_31	20000	EUR	17056564	17323735	267171
EUR_31	20000	EUR	19445931	19447994	2063
EUR_31	20000	EUR	19720323	19815522	95199
EUR_31	20000	EUR	23614282	23695974	81692
EUR_31	20000	EUR	28447913	28454759	6846
EUR_31	20000	EUR	29146149	29190448	44299
EUR_31	20000	EUR	29201265	29403219	201954
EUR_31	20000	EUR	43726568	43817028	90460
EUR_31	20000	EUR	44000162	44062496	62334
EUR_31	20000	EUR	44319048	44353481	34433
EUR_31	20000	EUR	47624392	47758303	133911
EUR_31	20000	EUR	48909503	48987001	77498
EUR_31	20000	EUR	50199687	50220042	20355
EUR_31	20000	EUR	50446207	50560553	114346
EUR_31	20000	EUR	50644699	50682125	37426
EUR_31	20000	EUR	53307869	53413728	105859
EUR_31	20000	EUR	60314986	60367058	52072
EUR_31	20000	EUR	61563808	61565203	1395
EUR_31	20000	EUR	62266230	62266246	16
EUR_31	20000	EUR	62495143	62723125	227982
EUR_31	20000	EUR	63177292	63277354	100062
EUR_31	20000	EUR	63345194	63367008	21814
EUR_31	20000	EUR	64007129	64060264	53135
EUR_31	20000	EUR	64204604	64213081	8477
EUR_31	20000	EUR	64569161	64648825	79664
EUR_31	20000	EUR	69533022	69656422	123400
EUR_31	20000	EUR	70090968	70143173	52205
EUR_31	20000	EUR	70314329	70323506	9177
EUR_31	20000	EUR	70425266	70471952	46686
EUR_31	20000	EUR	71411050	71427923	16873
EUR_31	20000	EUR	80106200	80125347	19147
EUR_31	20000	EUR	80307017	80378472	71455
EUR_31	20000	EUR	84307433	84446481	139048
EUR_31	20000	EUR	85268776	85314478	45702
EUR_31	20000	EUR	93241661	93437672	196011
EUR_31	20000	EUR	93789189	93971419	182230
EUR_31	20000	EUR	95681624	95884049	202425
EUR_32	20000	EUR	171404	187050	15646
EUR_32	20000	EUR	293630	317557	23927
EUR_32	20000	EUR	8004685	8026219	21534
EUR_32	20000	EUR	9628779	9647147	18368
EUR_32	20000	EUR	15920084	16041545	121461
EUR_32	20000	EUR	19373601	19465227	91626
EUR_32	20000	EUR	21282427	21582697	300270
EUR_32	20000	EUR	22370098	22371767	1669
EUR_32	20000	EUR	23308637	23325355	16718
EUR_32	20000	EUR	26802769	27028137	225368
EUR_32	20000	EUR	37958228	37981646	23418
EUR_32	20000	EUR	39499118	39538059	38941
EUR_32	20000	EUR	41294820	41386596	91776
EUR_32	20000	EUR	43768000	43813419	45419
EUR_32	20000	EUR	47600170	47701270	101100
EUR_32	20000	EUR	47721867	47761411	39544
EUR_32	20000	EUR	50075754	50079837	4083
EUR_32	20000	EUR	50214714	50600707	385993
EUR_32	20000	EUR	53914631	53938830	24199
EUR_32	20000	EUR	56606415	56661029	54614
EUR_32	20000	EUR	59025323	59087449	62126
EUR_32	20000	EUR	62442246	62456836	14590
EUR_32	20000	EUR	62976599	63021458	44859
EUR_32	20000	EUR	63404118	63430652	26534
EUR_32	20000	EUR	63510487	63775905	265418
EUR_32	20000	EUR	67726807	67922192	195385
EUR_32	20000	EUR	69273103	69296795	23692
EUR_32	20000	EUR	70178120	70180545	2425
EUR_32	20000	EUR	74609427	74663374	53947
EUR_32	20000	EUR	79804244	79813758	9514
EUR_32	20000	EUR	80346144	80378472	32328
EUR_32	20000	EUR	82392396	82400999	8603
EUR_32	20000	EUR	84586314	84597943	11629
EUR_32	20000	EUR	87069518	87079833	10315
EUR_32	20000	EUR	92657968	92893775	235807
EUR_32	20000	EUR	93364712	93374394	9682
EUR_32	20000	EUR	93579639	93661251	81612
EUR_32	20000	EUR	95665719	95725152	59433
EUR_32	20000	EUR	96622952	96969240	346288
EUR_32	20000	EUR	97184785	97235404	50619
EUR_32	20000	EUR	0	11076	11076
EUR_32	20000	EUR	2267390	2436497	169107
EUR_32	20000	EUR	8922196	8953694	31498
EUR_32	20000	EUR	10310816	10371329	60513
EUR_32	20000	EUR	12195294	12394574	199280
EUR_32	20000	EUR	12909514	12975665	66151
EUR_32	20000	EUR	21299608	21392501	92893
EUR_32	20000	EUR	23348628	23374530	25902
EUR_32	20000	EUR	23675106	23744358	69252
EUR_32	20000	EUR	24052627	24070707	18080
EUR_32	20000	EUR	24713899	24800868	86969
EUR_32	20000	EUR	26820043	26827636	7593
EUR_32	20000	EUR	28447913	28554899	106986
EUR_32	20000	EUR	29871842	29884548	12706
EUR_32	20000	EUR	44556562	44692189	135627
EUR_32	20000	EUR	45919475	46077353	157878
EUR_32	20000	EUR	48109321	48354749	245428
EUR_32	20000	EUR	48540943	48602191	61248
EUR_32	20000	EUR	48894894	48952633	57739
EUR_32	20000	EUR	49807803	50340188	532385
EUR_32	20000	EUR	50537759	50573069	35310
EUR_32	20000	EUR	53307869	53323885	16016
EUR_32	20000	EUR	60577974	60618684	40710
EUR_32	20000	EUR	62060602	62076335	15733
EUR_32	20000	EUR	62266230	62275522	9292
EUR_32	20000	EUR	62371186	62664593	293407
EUR_32	20000	EUR	62672738	62791767	119029
EUR_32	20000	EUR	64007129	64060264	53135
EUR_32	20000	EUR	64635938	64775972	140034
EUR_32	20000	EUR	67529684	67733569	203885
EUR_32	20000	EUR	67996165	68234683	238518
EUR_32	20000	EUR	69063156	69087335	24179
EUR_32	20000	EUR	69976346	70136356	160010
EUR_32	20000	EUR	70406536	70442419	35883
EUR_32	20000	EUR	71108569	71336069	227500
EUR_32	20000	EUR	73920589	74226288	305699
EUR_32	20000	EUR	74345860	74386200	40340
EUR_32	20000	EUR	80307017	80378472	71455
EUR_32	20000	EUR	80774687	80831869	57182
EUR_32	20000	EUR	84586314	84597943	11629
EUR_32	20000	EUR	86459570	86466441	6871
EUR_32	20000	EUR	93177388	93213384	35996
EUR_32	20000	EUR	93609865	93654906	45041
EUR_32	20000	EUR	95549067	95706836	157769
EUR_32	20000	EUR	97120986	97188820	67834
EUR_33	20000	EUR	19482	38454	18972
EUR_33	20000	EUR	5515391	5560949	45558
EUR_33	20000	EUR	10310816	10559629	248813
EUR_33	20000	EUR	13473030	13550872	77842
EUR_33	20000	EUR	15678424	15764951	86527
EUR_33	20000	EUR	15783413	15857544	74131
EUR_33	20000	EUR	16235802	16340550	104748
EUR_33	20000	EUR	19490258	19640640	150382
EUR_33	20000	EUR	21489581	21724233	234652
EUR_33	20000	EUR	21771683	21914523	142840
EUR_33	20000	EUR	21975735	22064725	88990
EUR_33	20000	EUR	23414479	23438353	23874
EUR_33	20000	EUR	28447913	28554899	106986
EUR_33	20000	EUR	29146149	29190448	44299
EUR_33	20000	EUR	29201265	29403219	201954
EUR_33	20000	EUR	29749217	29751787	2570
EUR_33	20000	EUR	29885100	30020785	135685
EUR_33	20000	EUR	31061901	31134052	72151
EUR_33	20000	EUR	44233876	44244547	10671
EUR_33	20000	EUR	44422772	44641229	218457
EUR_33	20000	EUR	45296556	45413157	116601
EUR_33	20000	EUR	47588227	47619485	31258
EUR_33	20000	EUR	47800452	47867455	67003
EUR_33	20000	EUR	48777473	48788773	11300
EUR_33	20000	EUR	49018324	49139016	120692
EUR_33	20000	EUR	49139324	49164811	25487
EUR_33	20000	EUR	50151559	50299995	148436
EUR_33	20000	EUR	51819962	51826252	6290
EUR_33	20000	EUR	56606415	56688585	82170
EUR_33	20000	EUR	56981282	57026186	44904
EUR_33	20000	EUR	60612044	60623780	11736
EUR_33	20000	EUR	61881873	62262900	381027
EUR_33	20000	EUR	62455976	62546944	90968
EUR_33	20000	EUR	62672738	63021458	348720
EUR_33	20000	EUR	66915791	67022791	107000
EUR_33	20000	EUR	67043600	67371632	328032
EUR_33	20000	EUR	67726807	67861249	134442
EUR_33	20000	EUR	71153579	71427923	274344
EUR_33	20000	EUR	79636078	79662887	26809
EUR_33	20000	EUR	79744728	79815448	70720
EUR_33	20000	EUR	80700295	80813234	112939
EUR_33	20000	EUR	80829772	80896500	66728
EUR_33	20000	EUR	81906745	81951234	44489
EUR_33	20000	EUR	84133095	84136758	3663
EUR_33	20000	EUR	85268776	85314478	45702
EUR_33	20000	EUR	93639360	93686534	47174
EUR_33	20000	EUR	5865668	5891953	26285
EUR_33	20000	EUR	12195294	12351606	156312
EUR_33	20000	EUR	12741429	12832004	90575
EUR_33	20000	EUR	13471709	13549834	78125
EUR_33	20000	EUR	16925040	17152004	226964
EUR_33	20000	EUR	21164886	21168829	3943
EUR_33	20000	EUR	21467411	21549370	81959
EUR_33	20000	EUR	23614282	23655464	41182
EUR_33	20000	EUR	23831885	23853580	21695
EUR_33	20000	EUR	24713899	24800868	86969
EUR_33	20000	EUR	27030183	27120057	89874
EUR_33	20000	EUR	29201265	29403219	201954
EUR_33	20000	EUR	39475823	39537203	61380
EUR_33	20000	EUR	40211027	40249065	38038
EUR_33	20000	EUR	44351028	44353481	2453
EUR_33	20000	EUR	45719414	45722822	3408
EUR_33	20000	EUR	46821026	46892165	71139
EUR_33	20000	EUR	47874821	48273370	398549
EUR_33	20000	EUR	48942765	49139016	196251
EUR_33	20000	EUR	49422646	49501602	78956
EUR_33	20000	EUR	50079988	50086485	6497
EUR_33	20000	EUR	50468145	50607406	139261
EUR_33	20000	EUR	56739090	56867904	128814
EUR_33	20000	EUR	59794583	59870587	76004
EUR_33	20000	EUR	60360602	60618684	258082
EUR_33	20000	EUR	62482898	62546166	63268
EUR_33	20000	EUR	62570596	62648920	78324
EUR_33	20000	EUR	62707428	62886738	179310
EUR_33	20000	EUR	64018404	64060264	41860
EUR_33	20000	EUR	64275342	64277727	2385
EUR_33	20000	EUR	66667736	66867964	200228
EUR_33	20000	EUR	67581165	67629756	48591
EUR_33	20000	EUR	67669977	67733569	63592
EUR_33	20000	EUR	71343174	71430180	87006
EUR_33	20000	EUR	80852781	80961424	108643
EUR_33	20000	EUR	82777601	83035646	258045
EUR_33	20000	EUR	93210081	93297339	87258
EUR_33	20000	EUR	96743876	96969240	225364
EUR_33	20000	EUR	97184785	97321820	137035
EUR_34	20000	EUR	24100	38454	14354
EUR_34	20000	EUR	5905143	5971269	66126
EUR_34	20000	EUR	10310816	10371329	60513
EUR_34	20000	EUR	11221129	11267811	46682
EUR_34	20000	EUR	12957537	12972366	14829
EUR_34	20000	EUR	15697742	15701244	3502
EUR_34	20000	EUR	16997514	17323735	326221
EUR_34	20000	EUR	19771179	19815522	44343
EUR_34	20000	EUR	21414350	21547886	133536
EUR_34	20000	EUR	21574468	21582697	8229
EUR_34	20000	EUR	21887939	21936915	48976
EUR_34	20000	EUR	23919670	24053709	134039
EUR_34	20000	EUR	28447913	28554899	106986
EUR_34	20000	EUR	29749217	29774921	25704
EUR_34	20000	EUR	29853109	29884548	31439
EUR_34	20000	EUR	31118293	31265497	147204
EUR_34	20000	EUR	31340450	31464998	124548
EUR_34	20000	EUR	31810551	31836096	25545
EUR_34	20000	EUR	41747380	41782913	35533
EUR_34	20000	EUR	45321666	45413157	91491
EUR_34	20000	EUR	48181642	48225224	43582
EUR_34	20000	EUR	48773745	48823805	50060
EUR_34	20000	EUR	49025304	49042187	16883
EUR_34	20000	EUR	49043466	49075471	32005
EUR_34	20000	EUR	50094550	50340188	245638
EUR_34	20000	EUR	50594292	50682125	87833
EUR_34	20000	EUR	51721135	51756063	34928
EUR_34	20000	EUR	53359909	53413728	53819
EUR_34	20000	EUR	54352751	54424698	71947
EUR_34	20000	EUR	54732365	54740924	8559
EUR_34	20000	EUR	59025323	59087449	62126
EUR_34	20000	EUR	62442246	62456836	14590
EUR_34	20000	EUR	64018404	64060264	41860
EUR_34	20000	EUR	64275342	64277727	2385
EUR_34	20000	EUR	66848687	66882708	34021
EUR_34	20000	EUR	67516377	67550551	34174
EUR_34	20000	EUR	67890847	68012425	121578
EUR_34	20000	EUR	68202321	68219989	17668
EUR_34	20000	EUR	68543110	68564643	21533
EUR_34	20000	EUR	69004995	69072506	67511
EUR_34	20000	EUR	69262441	69296795	34354
EUR_34	20000	EUR	70178120	70180545	2425
EUR_34	20000	EUR	70314329	70323506	9177
EUR_34	20000	EUR	70425266	70471952	46686
EUR_34	20000	EUR	71411050	71427923	16873
EUR_34	20000	EUR	74185839	74211177	25338
EUR_34	20000	EUR	74704171	74781759	77588
EUR_34	20000	EUR	81847136	81856204	9068
EUR_34	20000	EUR	84278449	84347352	68903
EUR_34	20000	EUR	86439603	86466441	26838
EUR_34	20000	EUR	89251444	89360109	108665
EUR_34	20000	EUR	96488824	96551349	62525
EUR_34	20000	EUR	97120986	97188820	67834
EUR_34	20000	EUR	0	38454	38454
EUR_34	20000	EUR	4067245	4155031	87786
EUR_34	20000	EUR	5738269	5741613	3344
EUR_34	20000	EUR	8922196	8953694	31498
EUR_34	20000	EUR	13070757	13085270	14513
EUR_34	20000	EUR	19602327	19640640	38313
EUR_34	20000	EUR	28592294	28668202	75908
EUR_34	20000	EUR	30665466	30875320	209854
EUR_34	20000	EUR	30929417	30992298	62881
EUR_34	20000	EUR	32052642	32104320	51678
EUR_34	20000	EUR	43750662	43813419	62757
EUR_34	20000	EUR	44438534	44513938	75404
EUR_34	20000	EUR	48181642	48246225	64583
EUR_34	20000	EUR	48974035	49018779	44744
EUR_34	20000	EUR	49051657	49139016	87359
EUR_34	20000	EUR	50807678	50964254	156576
EUR_34	20000	EUR	51721135	51737158	16023
EUR_34	20000	EUR	55891681	55941600	49919
EUR_34	20000	EUR	56642327	56661029	18702
EUR_34	20000	EUR	56981282	57026186	44904
EUR_34	20000	EUR	59025323	59087449	62126
EUR_34	20000	EUR	60466872	60623780	156908
EUR_34	20000	EUR	60697825	60703119	5294
EUR_34	20000	EUR	62791039	63227147	436108
EUR_34	20000	EUR	64843420	64968332	124912
EUR_34	20000	EUR	66786821	66800432	13611
EUR_34	20000	EUR	66848687	66900890	52203
EUR_34	20000	EUR	69586157	69604190	18033
EUR_34	20000	EUR	78656227	78660130	3903
EUR_34	20000	EUR	79636078	79803495	167417
EUR_34	20000	EUR	81849638	81877251	27613
EUR_34	20000	EUR	84271016	84589581	318565
EUR_34	20000	EUR	92582365	92911223	328858
EUR_34	20000	EUR	96215188	96313082	97894
EUR_34	20000	EUR	96628171	96829111	200940
EUR_34	20000	EUR	97100087	97197935	97848
EUR_34	20000	EUR	97398476	97597298	198822
EUR_35	20000	EUR	0	187050	187050
EUR_35	20000	EUR	293630	317557	23927
EUR_35	20000	EUR	5351614	5514753	163139
EUR_35	20000	EUR	7764477	7852331	87854
EUR_35	20000	EUR	10358872	10559629	200757
EUR_35	20000	EUR	13473030	13521112	48082
EUR_35	20000	EUR	15678424	15743283	64859
EUR_35	20000	EUR	23841284	24070707	229423
EUR_35	20000	EUR	25625985	25637091	11106
EUR_35	20000	EUR	27030183	27120057	89874
EUR_35	20000	EUR	28730691	28751710	21019
EUR_35	20000	EUR	31005915	31042242	36327
EUR_35	20000	EUR	31342564	31464998	122434
EUR_35	20000	EUR	32730745	32787200	56455
EUR_35	20000	EUR	35945899	36017172	71273
EUR_35	20000	EUR	43760561	43813419	52858
EUR_35	20000	EUR	49630087	49662298	32211
EUR_35	20000	EUR	50094550	50108086	13536
EUR_35	20000	EUR	50287644	50340188	52544
EUR_35	20000	EUR	54352751	54422822	70071
EUR_35	20000	EUR	60314986	60623780	308794
EUR_35	20000	EUR	60675915	60703119	27204
EUR_35	20000	EUR	62781664	62797882	16218
EUR_35	20000	EUR	62860595	63151646	291051
EUR_35	20000	EUR	64050970	64066021	15051
EUR_35	20000	EUR	64699193	64699609	416
EUR_35	20000	EUR	67096300	67168090	71790
EUR_35	20000	EUR	67726807	67774483	47676
EUR_35	20000	EUR	71214523	71270702	56179
EUR_35	20000	EUR	80106200	80125347	19147
EUR_35	20000	EUR	80307017	80378472	71455
EUR_35	20000	EUR	80790902	80831869	40967
EUR_35	20000	EUR	84271016	84371174	100158
EUR_35	20000	EUR	86418855	86466441	47586
EUR_35	20000	EUR	91097171	91116161	18990
EUR_35	20000	EUR	93210081	93434333	224252
EUR_35	20000	EUR	97529637	97597298	67661
EUR_35	20000	EUR	5399268	5408555	9287
EUR_35	20000	EUR	10310816	10371329	60513
EUR_35	20000	EUR	10547168	10559629	12461
EUR_35	20000	EUR	12436919	12649905	212986
EUR_35	20000	EUR	13070757	13085270	14513
EUR_35	20000	EUR	15892928	16041545	148617
EUR_35	20000	EUR	16872759	17212846	340087
EUR_35	20000	EUR	19490258	19651006	160748
EUR_35	20000	EUR	21282427	21365066	82639
EUR_35	20000	EUR	23325683	23438353	112670
EUR_35	20000	EUR	23849387	24068408	219021
EUR_35	20000	EUR	29201265	29262122	60857
EUR_35	20000	EUR	29853109	29884548	31439
EUR_35	20000	EUR	31203931	31261283	57352
EUR_35	20000	EUR	31270356	31349680	79324
EUR_35	20000	EUR	39536610	39556838	20228
EUR_35	20000	EUR	41082532	41103899	21367
EUR_35	20000	EUR	45292333	45335213	42880
EUR_35	20000	EUR	46821026	46878762	57736
EUR_35	20000	EUR	47573262	47867455	294193
EUR_35	20000	EUR	48828898	48852598	23700
EUR_35	20000	EUR	49063282	49211922	148640
EUR_35	20000	EUR	49835442	49931459	96017
EUR_35	20000	EUR	50079988	50180511	100523
EUR_35	20000	EUR	50265072	50340188	75116
EUR_35	20000	EUR	54352751	54429543	76792
EUR_35	20000	EUR	54447874	54482640	34766
EUR_35	20000	EUR	55662959	55943914	280955
EUR_35	20000	EUR	62495143	62651348	156205
EUR_35	20000	EUR	62670131	62820719	150588
EUR_35	20000	EUR	63356933	63605906	248973
EUR_35	20000	EUR	64007129	64060264	53135
EUR_35	20000	EUR	64689850	64713211	23361
EUR_35	20000	EUR	64779628	64968332	188704
EUR_35	20000	EUR	67516377	67693426	177049
EUR_35	20000	EUR	69004995	69092409	87414
EUR_35	20000	EUR	69976346	70136356	160010
EUR_35	20000	EUR	70425266	70471952	46686
EUR_35	20000	EUR	71153579	71419702	266123
EUR_35	20000	EUR	74185839	74211177	25338
EUR_35	20000	EUR	78278359	78281355	2996
EUR_35	20000	EUR	80751058	80831869	80811
EUR_35	20000	EUR	82777601	82858642	81041
EUR_35	20000	EUR	84040452	84198948	158496
EUR_35	20000	EUR	84586314	84597943	11629
EUR_35	20000	EUR	86361900	86399809	37909
EUR_35	20000	EUR	92728134	92911223	183089
EUR_35	20000	EUR	95261532	95309603	48071
EUR_35	20000	EUR	96677706	96969240	291534
EUR_35	20000	EUR	97670105	97850405	180300
EUR_36	20000	EUR	11155402	11226347	70945
EUR_36	20000	EUR	12405520	12649905	244385
EUR_36	20000	EUR	12959122	12989272	30150
EUR_36	20000	EUR	15686234	15701244	15010
EUR_36	20000	EUR	15783892	15884079	100187
EUR_36	20000	EUR	16960554	17115665	155111
EUR_36	20000	EUR	19395138	19439044	43906
EUR_36	20000	EUR	19490258	19640640	150382
EUR_36	20000	EUR	19703413	19752209	48796
EUR_36	20000	EUR	21166394	21195469	29075
EUR_36	20000	EUR	22947870	23014908	67038
EUR_36	20000	EUR	23264640	23438353	173713
EUR_36	20000	EUR	23454655	23632090	177435
EUR_36	20000	EUR	23841284	23878136	36852
EUR_36	20000	EUR	29853109	29884548	31439
EUR_36	20000	EUR	30528228	30655575	127347
EUR_36	20000	EUR	31402082	31464998	62916
EUR_36	20000	EUR	31810551	31996286	185735
EUR_36	20000	EUR	40125941	40169297	43356
EUR_36	20000	EUR	44361001	44404700	43699
EUR_36	20000	EUR	45292333	45413157	120824
EUR_36	20000	EUR	47874821	48095137	220316
EUR_36	20000	EUR	48980390	49071287	90897
EUR_36	20000	EUR	49138915	49139016	101
EUR_36	20000	EUR	49593845	49778991	185146
EUR_36	20000	EUR	49938053	50340188	402135
EUR_36	20000	EUR	53185452	53248662	63210
EUR_36	20000	EUR	59025323	59060025	34702
EUR_36	20000	EUR	60859224	60933571	74347
EUR_36	20000	EUR	62270017	62407580	137563
EUR_36	20000	EUR	64993828	65025826	31998
EUR_36	20000	EUR	67632239	67659453	27214
EUR_36	20000	EUR	71343174	71370919	27745
EUR_36	20000	EUR	73189891	73191693	1802
EUR_36	20000	EUR	74609427	74620157	10730
EUR_36	20000	EUR	77940158	77981834	41676
EUR_36	20000	EUR	79508567	79577121	68554
EUR_36	20000	EUR	81009858	81095721	85863
EUR_36	20000	EUR	83543294	83583418	40124
EUR_36	20000	EUR	84174413	84347352	172939
EUR_36	20000	EUR	84385265	84423669	38404
EUR_36	20000	EUR	93436001	93437672	1671
EUR_36	20000	EUR	95127554	95309603	182049
EUR_36	20000	EUR	5515391	5560949	45558
EUR_36	20000	EUR	8846483	8958572	112089
EUR_36	20000	EUR	11741022	11810853	69831
EUR_36	20000	EUR	12405520	12649905	244385
EUR_36	20000	EUR	12959122	12984105	24983
EUR_36	20000	EUR	13990229	14094824	104595
EUR_36	20000	EUR	14643309	14747360	104051
EUR_36	20000	EUR	15585791	15632929	47138
EUR_36	20000	EUR	15697742	15701244	3502
EUR_36	20000	EUR	19659204	19765406	106202
EUR_36	20000	EUR	23766186	23784377	18191
EUR_36	20000	EUR	31203931	31261283	57352
EUR_36	20000	EUR	31270356	31349680	79324
EUR_36	20000	EUR	40559832	40561321	1489
EUR_36	20000	EUR	41236994	41386596	149602
EUR_36	20000	EUR	43760561	43813419	52858
EUR_36	20000	EUR	45274093	45295441	21348
EUR_36	20000	EUR	47722097	47744901	22804
EUR_36	20000	EUR	48455942	48675545	219603
EUR_36	20000	EUR	48883624	48956042	72418
EUR_36	20000	EUR	49214391	49270017	55626
EUR_36	20000	EUR	50199687	50220042	20355
EUR_36	20000	EUR	50333952	50340188	6236
EUR_36	20000	EUR	50524394	50546250	21856
EUR_36	20000	EUR	50572126	50682125	109999
EUR_36	20000	EUR	51721135	51756063	34928
EUR_36	20000	EUR	53359909	53413728	53819
EUR_36	20000	EUR	59129042	59164124	35082
EUR_36	20000	EUR	62266230	62343666	77436
EUR_36	20000	EUR	66667736	67022791	355055
EUR_36	20000	EUR	67043600	67160970	117370
EUR_36	20000	EUR	74609427	74689986	80559
EUR_36	20000	EUR	74695445	74723577	28132
EUR_36	20000	EUR	79714947	79717095	2148
EUR_36	20000	EUR	79834311	79835487	1176
EUR_36	20000	EUR	80852781	80961424	108643
EUR_36	20000	EUR	82779823	82867077	87254
EUR_36	20000	EUR	84454434	84589581	135147
EUR_37	20000	EUR	0	110433	110433
EUR_37	20000	EUR	2297916	2447327	149411
EUR_37	20000	EUR	5515391	5560949	45558
EUR_37	20000	EUR	11309495	11324870	15375
EUR_37	20000	EUR	12480475	12595681	115206
EUR_37	20000	EUR	12957537	13029529	71992
EUR_37	20000	EUR	15617938	15701244	83306
EUR_37	20000	EUR	15783892	15821860	37968
EUR_37	20000	EUR	19206296	19308093	101797
EUR_37	20000	EUR	23519809	23696381	176572
EUR_37	20000	EUR	27030183	27075416	45233
EUR_37	20000	EUR	28588373	28683533	95160
EUR_37	20000	EUR	29741785	29763985	22200
EUR_37	20000	EUR	31213935	31253915	39980
EUR_37	20000	EUR	46948492	47043436	94944
EUR_37	20000	EUR	47654777	47684388	29611
EUR_37	20000	EUR	47867299	47891572	24273
EUR_37	20000	EUR	49844125	49874186	30061
EUR_37	20000	EUR	50199687	50220042	20355
EUR_37	20000	EUR	50333952	50340188	6236
EUR_37	20000	EUR	50524394	50546634	22240
EUR_37	20000	EUR	54352751	54422822	70071
EUR_37	20000	EUR	55907255	55941600	34345
EUR_37	20000	EUR	59745200	59762191	16991
EUR_37	20000	EUR	61563808	61569183	5375
EUR_37	20000	EUR	62266230	62343666	77436
EUR_37	20000	EUR	67632239	67659453	27214
EUR_37	20000	EUR	67993239	68098049	104810
EUR_37	20000	EUR	68543110	68564643	21533
EUR_37	20000	EUR	69004995	69072506	67511
EUR_37	20000	EUR	69262441	69296795	34354
EUR_37	20000	EUR	70178120	70180545	2425
EUR_37	20000	EUR	73344343	73357038	12695
EUR_37	20000	EUR	82777601	83035646	258045
EUR_37	20000	EUR	84271016	84311979	40963
EUR_37	20000	EUR	84570415	84809687	239272
EUR_37	20000	EUR	87069518	87192258	122740
EUR_37	20000	EUR	98197427	98216504	19077
EUR_37	20000	EUR	0	38454	38454
EUR_37	20000	EUR	1291609	1354736	63127
EUR_37	20000	EUR	1443312	1474375	31063
EUR_37	20000	EUR	2267390	2305620	38230
EUR_37	20000	EUR	11926927	11927735	808
EUR_37	20000	EUR	12971780	13085270	113490
EUR_37	20000	EUR	13175672	13190842	15170
EUR_37	20000	EUR	15585791	15689989	104198
EUR_37	20000	EUR	16335668	16340550	4882
EUR_37	20000	EUR	19395138	19417914	22776
EUR_37	20000	EUR	23941733	24132984	191251
EUR_37	20000	EUR	25625985	25637091	11106
EUR_37	20000	EUR	28447913	28454759	6846
EUR_37	20000	EUR	28909134	28912719	3585
EUR_37	20000	EUR	29741238	29767219	25981
EUR_37	20000	EUR	30592221	30655575	63354
EUR_37	20000	EUR	31194898	31233050	38152
EUR_37	20000	EUR	31387106	31415119	28013
EUR_37	20000	EUR	31953948	32129155	175207
EUR_37	20000	EUR	43768000	43813419	45419
EUR_37	20000	EUR	44486264	44811416	325152
EUR_37	20000	EUR	49138915	49139016	101
EUR_37	20000	EUR	50594292	50682125	87833
EUR_37	20000	EUR	51739382	51756063	16681
EUR_37	20000	EUR	56981282	57026186	44904
EUR_37	20000	EUR	59745200	59789210	44010
EUR_37	20000	EUR	59858820	59875965	17145
EUR_37	20000	EUR	60587632	60595221	7589
EUR_37	20000	EUR	60836692	60933571	96879
EUR_37	20000	EUR	61991743	62430091	438348
EUR_37	20000	EUR	62571477	62571923	446
EUR_37	20000	EUR	62672738	62763590	90852
EUR_37	20000	EUR	67096300	67168090	71790
EUR_37	20000	EUR	67726807	67774483	47676
EUR_37	20000	EUR	69253738	69314431	60693
EUR_37	20000	EUR	69976346	70136356	160010
EUR_37	20000	EUR	71108569	71509363	400794
EUR_37	20000	EUR	72348347	72391607	43260
EUR_37	20000	EUR	73164377	73191693	27316
EUR_37	20000	EUR	74609427	74663374	53947
EUR_37	20000	EUR	77940158	77981834	41676
EUR_37	20000	EUR	78128495	78236096	107601
EUR_37	20000	EUR	82778902	83035646	256744
EUR_37	20000	EUR	84586314	84597943	11629
EUR_37	20000	EUR	86284062	86324407	40345
EUR_37	20000	EUR	87914298	87992882	78584
EUR_37	20000	EUR	95681624	95770835	89211
EUR_37	20000	EUR	96089909	96133921	44012
EUR_37	20000	EUR	96580037	96678817	98780
EUR_38	20000	EUR	8004685	8026219	21534
EUR_38	20000	EUR	10318920	10559629	240709
EUR_38	20000	EUR	12353636	12432602	78966
EUR_38	20000	EUR	14713216	14799065	85849
EUR_38	20000	EUR	14839438	14894976	55538
EUR_38	20000	EUR	18850191	18885640	35449
EUR_38	20000	EUR	19650300	19765406	115106
EUR_38	20000	EUR	21489581	21558457	68876
EUR_38	20000	EUR	23414479	23438353	23874
EUR_38	20000	EUR	23678834	23696381	17547
EUR_38	20000	EUR	23923937	24132984	209047
EUR_38	20000	EUR	28447913	28454759	6846
EUR_38	20000	EUR	32052642	32104320	51678
EUR_38	20000	EUR	35825437	35904356	78919
EUR_38	20000	EUR	43066847	43071200	4353
EUR_38	20000	EUR	43768000	43813419	45419
EUR_38	20000	EUR	50020142	50183908	163766
EUR_38	20000	EUR	50807678	50885012	77334
EUR_38	20000	EUR	51721135	51737158	16023
EUR_38	20000	EUR	54082858	54110395	27537
EUR_38	20000	EUR	54156560	54229443	72883
EUR_38	20000	EUR	55662959	55943914	280955
EUR_38	20000	EUR	59745200	59789210	44010
EUR_38	20000	EUR	62031429	62268658	237229
EUR_38	20000	EUR	62363965	62460553	96588
EUR_38	20000	EUR	64632417	64777381	144964
EUR_38	20000	EUR	66713300	66867964	154664
EUR_38	20000	EUR	67106601	67147046	40445
EUR_38	20000	EUR	67726807	68131443	404636
EUR_38	20000	EUR	71153579	71427923	274344
EUR_38	20000	EUR	74638673	74738201	99528
EUR_38	20000	EUR	76457074	76485346	28272
EUR_38	20000	EUR	79714947	79717095	2148
EUR_38	20000	EUR	79834311	79835487	1176
EUR_38	20000	EUR	80307017	80378472	71455
EUR_38	20000	EUR	82682910	82761538	78628
EUR_38	20000	EUR	84271016	84550993	279977
EUR_38	20000	EUR	84553831	84589581	35750
EUR_38	20000	EUR	87069518	87099768	30250
EUR_38	20000	EUR	88064488	88291850	227362
EUR_38	20000	EUR	95549067	95706836	157769
EUR_38	20000	EUR	97227283	97229983	2700
EUR_38	20000	EUR	97398476	97442009	43533
EUR_38	20000	EUR	97499614	97573671	74057
EUR_38	20000	EUR	97587101	97698044	110943
EUR_38	20000	EUR	97711629	97766796	55167
EUR_38	20000	EUR	0	38454	38454
EUR_38	20000	EUR	12674660	12687739	13079
EUR_38	20000	EUR	12909514	13008521	99007
EUR_38	20000	EUR	14731136	14762675	31539
EUR_38	20000	EUR	15678424	15747671	69247
EUR_38	20000	EUR	19438596	19544916	106320
EUR_38	20000	EUR	23454655	23632090	177435
EUR_38	20000	EUR	23841284	24070707	229423
EUR_38	20000	EUR	31342564	31464998	122434
EUR_38	20000	EUR	41241594	41386596	145002
EUR_38	20000	EUR	43750662	43813419	62757
EUR_38	20000	EUR	44422772	44647773	225001
EUR_38	20000	EUR	47800452	47867455	67003
EUR_38	20000	EUR	48281283	48321534	40251
EUR_38	20000	EUR	48942765	49071287	128522
EUR_38	20000	EUR	53175827	53302464	126637
EUR_38	20000	EUR	54352751	54422822	70071
EUR_38	20000	EUR	55891681	55941600	49919
EUR_38	20000	EUR	60314986	60406009	91023
EUR_38	20000	EUR	62015446	62232042	216596
EUR_38	20000	EUR	62266230	62343666	77436
EUR_38	20000	EUR	62968245	63031514	63269
EUR_38	20000	EUR	64740348	64968332	227984
EUR_38	20000	EUR	66942688	67022791	80103
EUR_38	20000	EUR	67043600	67142501	98901
EUR_38	20000	EUR	67581165	67629756	48591
EUR_38	20000	EUR	67669977	67733569	63592
EUR_38	20000	EUR	67750394	68089779	339385
EUR_38	20000	EUR	68118814	68219989	101175
EUR_38	20000	EUR	69208907	69257859	48952
EUR_38	20000	EUR	69976346	70054691	78345
EUR_38	20000	EUR	73344343	73485420	141077
EUR_38	20000	EUR	78656227	78660130	3903
EUR_38	20000	EUR	79636078	79803495	167417
EUR_38	20000	EUR	81849638	81877251	27613
EUR_38	20000	EUR	84271016	84550993	279977
EUR_38	20000	EUR	84808933	84859626	50693
EUR_38	20000	EUR	85268776	85278069	9293
EUR_38	20000	EUR	86183232	86324407	141175
EUR_38	20000	EUR	93268366	93378771	110405
EUR_38	20000	EUR	93627195	93686534	59339
EUR_38	20000	EUR	95261709	95309603	47894
EUR_39	20000	EUR	2550449	2686846	136397
EUR_39	20000	EUR	11221129	11267811	46682
EUR_39	20000	EUR	15678424	15857544	179120
EUR_39	20000	EUR	19490258	19651006	160748
EUR_39	20000	EUR	19771627	19815522	43895
EUR_39	20000	EUR	21540239	21544907	4668
EUR_39	20000	EUR	23297565	23324559	26994
EUR_39	20000	EUR	24532214	24693848	161634
EUR_39	20000	EUR	30528228	30571548	43320
EUR_39	20000	EUR	31213935	31415119	201184
EUR_39	20000	EUR	39475823	39537203	61380
EUR_39	20000	EUR	43356490	43477546	121056
EUR_39	20000	EUR	44991454	45007478	16024
EUR_39	20000	EUR	47868799	47937970	69171
EUR_39	20000	EUR	49716678	49797331	80653
EUR_39	20000	EUR	50040990	50057292	16302
EUR_39	20000	EUR	50244656	50300721	56065
EUR_39	20000	EUR	54156560	54196054	39494
EUR_39	20000	EUR	64332882	64372547	39665
EUR_39	20000	EUR	68202321	68219989	17668
EUR_39	20000	EUR	68501694	68520890	19196
EUR_39	20000	EUR	70178120	70180545	2425
EUR_39	20000	EUR	74185839	74211177	25338
EUR_39	20000	EUR	83543294	83583418	40124
EUR_39	20000	EUR	84271016	84550993	279977
EUR_39	20000	EUR	86183232	86324407	141175
EUR_39	20000	EUR	92744634	92958238	213604
EUR_39	20000	EUR	96770166	96981080	210914
EUR_39	20000	EUR	0	38454	38454
EUR_39	20000	EUR	8850520	8958572	108052
EUR_39	20000	EUR	10162900	10335169	172269
EUR_39	20000	EUR	15617938	15701244	83306
EUR_39	20000	EUR	17304972	17323735	18763
EUR_39	20000	EUR	20925981	20952589	26608
EUR_39	20000	EUR	21737927	21914523	176596
EUR_39	20000	EUR	23697124	23853580	156456
EUR_39	20000	EUR	27563461	27803948	240487
EUR_39	20000	EUR	28909134	28912719	3585
EUR_39	20000	EUR	29749217	29751787	2570
EUR_39	20000	EUR	29885100	30020785	135685
EUR_39	20000	EUR	30423096	30559727	136631
EUR_39	20000	EUR	31333164	31349680	16516
EUR_39	20000	EUR	33352525	33353174	649
EUR_39	20000	EUR	43750662	43785095	34433
EUR_39	20000	EUR	44915345	45093802	178457
EUR_39	20000	EUR	46009455	46088595	79140
EUR_39	20000	EUR	46167446	46287015	119569
EUR_39	20000	EUR	49883096	49948915	65819
EUR_39	20000	EUR	50020142	50183908	163766
EUR_39	20000	EUR	50256105	50340188	84083
EUR_39	20000	EUR	50524394	50562004	37610
EUR_39	20000	EUR	55365672	55376432	10760
EUR_39	20000	EUR	56606415	56670627	64212
EUR_39	20000	EUR	59025323	59078409	53086
EUR_39	20000	EUR	59745200	59789210	44010
EUR_39	20000	EUR	62508611	62571923	63312
EUR_39	20000	EUR	62707968	62779708	71740
EUR_39	20000	EUR	67099623	67160970	61347
EUR_39	20000	EUR	67948972	67981950	32978
EUR_39	20000	EUR	68044654	68219989	175335
EUR_39	20000	EUR	74704171	74756907	52736
EUR_39	20000	EUR	79636078	79803495	167417
EUR_39	20000	EUR	84040452	84198948	158496
EUR_39	20000	EUR	84609284	84609377	93
EUR_39	20000	EUR	88992283	89057856	65573
EUR_39	20000	EUR	93579639	93686534	106895
EUR_40	20000	EUR	0	38454	38454
EUR_40	20000	EUR	4067245	4155031	87786
EUR_40	20000	EUR	8023767	8074467	50700
EUR_40	20000	EUR	10310816	10371329	60513
EUR_40	20000	EUR	14599834	14744959	145125
EUR_40	20000	EUR	15678424	15747671	69247
EUR_40	20000	EUR	19524348	19575541	51193
EUR_40	20000	EUR	19690441	19765406	74965
EUR_40	20000	EUR	19772407	19815522	43115
EUR_40	20000	EUR	21525308	21558457	33149
EUR_40	20000	EUR	23480055	23525224	45169
EUR_40	20000	EUR	23678834	23696381	17547
EUR_40	20000	EUR	23923937	24061376	137439
EUR_40	20000	EUR	26757616	26827636	70020
EUR_40	20000	EUR	28588373	28683533	95160
EUR_40	20000	EUR	29146149	29190448	44299
EUR_40	20000	EUR	29201265	29403219	201954
EUR_40	20000	EUR	30838706	31157362	318656
EUR_40	20000	EUR	39475823	39537203	61380
EUR_40	20000	EUR	39707666	39718127	10461
EUR_40	20000	EUR	43183684	43291736	108052
EUR_40	20000	EUR	43547085	43587658	40573
EUR_40	20000	EUR	45980594	46304829	324235
EUR_40	20000	EUR	48181642	48250239	68597
EUR_40	20000	EUR	49050712	49139016	88304
EUR_40	20000	EUR	49430402	49494606	64204
EUR_40	20000	EUR	50214714	50260453	45739
EUR_40	20000	EUR	50437336	50573069	135733
EUR_40	20000	EUR	62489657	62546166	56509
EUR_40	20000	EUR	63010595	63029376	18781
EUR_40	20000	EUR	63379754	63414083	34329
EUR_40	20000	EUR	64993828	65025826	31998
EUR_40	20000	EUR	67632239	67659453	27214
EUR_40	20000	EUR	71343174	71376679	33505
EUR_40	20000	EUR	74185839	74211177	25338
EUR_40	20000	EUR	78128495	78236096	107601
EUR_40	20000	EUR	81009858	81037997	28139
EUR_40	20000	EUR	82779823	82867077	87254
EUR_40	20000	EUR	84586314	84597943	11629
EUR_40	20000	EUR	93364712	93374394	9682
EUR_40	20000	EUR	93579639	93661251	81612
EUR_40	20000	EUR	96344658	96374783	30125
EUR_40	20000	EUR	96488824	96551349	62525
EUR_40	20000	EUR	96822588	97142026	319438
EUR_40	20000	EUR	97198885	97229983	31098
EUR_40	20000	EUR	97398476	97760106	361630
EUR_40	20000	EUR	4069425	4124617	55192
EUR_40	20000	EUR	5399268	5408555	9287
EUR_40	20000	EUR	5914836	5971269	56433
EUR_40	20000	EUR	10162900	10351635	188735
EUR_40	20000	EUR	15678424	15857544	179120
EUR_40	20000	EUR	19490258	19765406	275148
EUR_40	20000	EUR	23197494	23266685	69191
EUR_40	20000	EUR	23348628	23374530	25902
EUR_40	20000	EUR	23678834	23696381	17547
EUR_40	20000	EUR	28588373	28683533	95160
EUR_40	20000	EUR	29249415	29392323	142908
EUR_40	20000	EUR	29885100	29898500	13400
EUR_40	20000	EUR	31340450	31464998	124548
EUR_40	20000	EUR	43547085	43587658	40573
EUR_40	20000	EUR	43777503	43813419	35916
EUR_40	20000	EUR	44243666	44287999	44333
EUR_40	20000	EUR	48793777	48801513	7736
EUR_40	20000	EUR	49006754	49152213	145459
EUR_40	20000	EUR	49422646	49692685	270039
EUR_40	20000	EUR	50654897	50675343	20446
EUR_40	20000	EUR	55876234	55943914	67680
EUR_40	20000	EUR	59025323	59087449	62126
EUR_40	20000	EUR	62266230	62267857	1627
EUR_40	20000	EUR	63010595	63041174	30579
EUR_40	20000	EUR	64213067	64326150	113083
EUR_40	20000	EUR	66769643	67022791	253148
EUR_40	20000	EUR	67043600	67160970	117370
EUR_40	20000	EUR	67720425	67747325	26900
EUR_40	20000	EUR	67947267	68012425	65158
EUR_40	20000	EUR	68209047	68341894	132847
EUR_40	20000	EUR	70305880	70333718	27838
EUR_40	20000	EUR	71108569	71229807	121238
EUR_40	20000	EUR	71361559	71413896	52337
EUR_40	20000	EUR	73164377	73263490	99113
EUR_40	20000	EUR	74609427	74738201	128774
EUR_40	20000	EUR	79636078	79835487	199409
EUR_40	20000	EUR	84480189	84589581	109392
EUR_40	20000	EUR	86383947	86466441	82494
EUR_40	20000	EUR	93639360	93686534	47174
EUR_41	10000	EUR	8004685	8026219	21534
EUR_41	10000	EUR	10455256	10468821	13565
EUR_41	10000	EUR	10544104	10559629	15525
EUR_41	10000	EUR	15686234	15701244	15010
EUR_41	10000	EUR	15783892	15884079	100187
EUR_41	10000	EUR	21438457	21523118	84661
EUR_41	10000	EUR	21525308	21558457	33149
EUR_41	10000	EUR	23330380	23342897	12517
EUR_41	10000	EUR	23358116	23371760	13644
EUR_41	10000	EUR	26802769	27028137	225368
EUR_41	10000	EUR	28447913	28454759	6846
EUR_41	10000	EUR	29885100	30020785	135685
EUR_41	10000	EUR	30678684	30730344	51660
EUR_41	10000	EUR	31391393	31407691	16298
EUR_41	10000	EUR	41236830	41330550	93720
EUR_41	10000	EUR	43321108	43337414	16306
EUR_41	10000	EUR	45919475	46077353	157878
EUR_41	10000	EUR	47722097	47744901	22804
EUR_41	10000	EUR	48197806	48250239	52433
EUR_41	10000	EUR	48942765	49071287	128522
EUR_41	10000	EUR	49663690	49778991	115301
EUR_41	10000	EUR	49938053	50340188	402135
EUR_41	10000	EUR	50524394	50562004	37610
EUR_41	10000	EUR	53185716	53302464	116748
EUR_41	10000	EUR	54156560	54190763	34203
EUR_41	10000	EUR	54241431	54294851	53420
EUR_41	10000	EUR	55662959	55747582	84623
EUR_41	10000	EUR	55892211	56019725	127514
EUR_41	10000	EUR	59129042	59164124	35082
EUR_41	10000	EUR	60391758	60473482	81724
EUR_41	10000	EUR	62336325	62520941	184616
EUR_41	10000	EUR	63177292	63277354	100062
EUR_41	10000	EUR	63345194	63367008	21814
EUR_41	10000	EUR	63974015	64013981	39966
EUR_41	10000	EUR	64050970	64066021	15051
EUR_41	10000	EUR	64259771	64326150	66379
EUR_41	10000	EUR	64559645	64648825	89180
EUR_41	10000	EUR	66778829	66897711	118882
EUR_41	10000	EUR	67469783	67486153	16370
EUR_41	10000	EUR	67720425	67747325	26900
EUR_41	10000	EUR	68003563	68012425	8862
EUR_41	10000	EUR	69253738	69315282	61544
EUR_41	10000	EUR	73920589	74226288	305699
EUR_41	10000	EUR	74345860	74386200	40340
EUR_41	10000	EUR	78020485	78031382	10897
EUR_41	10000	EUR	80315709	80378472	62763
EUR_41	10000	EUR	81329834	81344715	14881
EUR_41	10000	EUR	84295406	84313163	17757
EUR_41	10000	EUR	84332987	84347352	14365
EUR_41	10000	EUR	84685999	84711549	25550
EUR_41	10000	EUR	87069518	87106230	36712
EUR_41	10000	EUR	87163493	87192258	28765
EUR_41	10000	EUR	92882226	92958238	76012
EUR_41	10000	EUR	96404550	96451210	46660
EUR_41	10000	EUR	196934	206962	10028
EUR_41	10000	EUR	5738269	5741613	3344
EUR_41	10000	EUR	10310816	10495746	184930
EUR_41	10000	EUR	10504963	10559629	54666
EUR_41	10000	EUR	11221129	11267811	46682
EUR_41	10000	EUR	12436919	12518164	81245
EUR_41	10000	EUR	12541608	12571424	29816
EUR_41	10000	EUR	13943659	14132248	188589
EUR_41	10000	EUR	14875145	14894976	19831
EUR_41	10000	EUR	15607322	15740215	132893
EUR_41	10000	EUR	17056564	17097884	41320
EUR_41	10000	EUR	19427224	19446442	19218
EUR_41	10000	EUR	19733630	19736517	2887
EUR_41	10000	EUR	21411938	21462608	50670
EUR_41	10000	EUR	23414479	23438353	23874
EUR_41	10000	EUR	23868725	24070707	201982
EUR_41	10000	EUR	26979753	27027989	48236
EUR_41	10000	EUR	29256822	29403219	146397
EUR_41	10000	EUR	29750374	29765658	15284
EUR_41	10000	EUR	31213935	31392900	178965
EUR_41	10000	EUR	41338812	41346194	7382
EUR_41	10000	EUR	43321108	43338312	17204
EUR_41	10000	EUR	43750662	43785095	34433
EUR_41	10000	EUR	45023383	45093802	70419
EUR_41	10000	EUR	47672056	47744901	72845
EUR_41	10000	EUR	48273976	48321534	47558
EUR_41	10000	EUR	48793399	48832663	39264
EUR_41	10000	EUR	49051657	49139016	87359
EUR_41	10000	EUR	49720102	50516476	796374
EUR_41	10000	EUR	50654897	50675343	20446
EUR_41	10000	EUR	55551653	55651082	99429
EUR_41	10000	EUR	62197424	62243667	46243
EUR_41	10000	EUR	62342962	62520941	177979
EUR_41	10000	EUR	62709351	62791767	82416
EUR_41	10000	EUR	63248927	63268388	19461
EUR_41	10000	EUR	64275342	64277727	2385
EUR_41	10000	EUR	64831271	64865609	34338
EUR_41	10000	EUR	64893591	65025826	132235
EUR_41	10000	EUR	67257538	67267114	9576
EUR_41	10000	EUR	68074057	68089779	15722
EUR_41	10000	EUR	68118814	68219989	101175
EUR_41	10000	EUR	69004995	69064534	59539
EUR_41	10000	EUR	69230927	69315282	84355
EUR_41	10000	EUR	71187459	71214726	27267
EUR_41	10000	EUR	73920589	74226288	305699
EUR_41	10000	EUR	74345860	74386200	40340
EUR_41	10000	EUR	74688510	74802304	113794
EUR_41	10000	EUR	76219599	76223870	4271
EUR_41	10000	EUR	79970884	79977985	7101
EUR_41	10000	EUR	80817797	80831869	14072
EUR_41	10000	EUR	80947447	80965346	17899
EUR_41	10000	EUR	81883517	81919375	35858
EUR_41	10000	EUR	82392396	82400999	8603
EUR_41	10000	EUR	84454434	84508973	54539
EUR_41	10000	EUR	84573291	84607732	34441
EUR_41	10000	EUR	86340983	86466441	125458
EUR_41	10000	EUR	92821323	92870243	48920
EUR_41	10000	EUR	95702824	95706836	4012
EUR_41	10000	EUR	97100087	97197807	97720
EUR_41	10000	EUR	97198885	97229983	31098
EUR_41	10000	EUR	97398476	97743855	345379
EUR_42	10000	EUR	0	4995	4995
EUR_42	10000	EUR	132067	255268	123201
EUR_42	10000	EUR	5865668	5971269	105601
EUR_42	10000	EUR	7764477	7852331	87854
EUR_42	10000	EUR	8023767	8074467	50700
EUR_42	10000	EUR	10162900	10335169	172269
EUR_42	10000	EUR	11221129	11267811	46682
EUR_42	10000	EUR	12195294	12394574	199280
EUR_42	10000	EUR	12957537	13029529	71992
EUR_42	10000	EUR	13955319	13957627	2308
EUR_42	10000	EUR	16387387	16444740	57353
EUR_42	10000	EUR	16960554	17115665	155111
EUR_42	10000	EUR	19373820	19426196	52376
EUR_42	10000	EUR	23358922	23367462	8540
EUR_42	10000	EUR	25625985	25637091	11106
EUR_42	10000	EUR	28588373	28683533	95160
EUR_42	10000	EUR	29146149	29159010	12861
EUR_42	10000	EUR	29397444	29403219	5775
EUR_42	10000	EUR	30528228	30562678	34450
EUR_42	10000	EUR	30817529	30844438	26909
EUR_42	10000	EUR	41241594	41362133	120539
EUR_42	10000	EUR	43750662	43756156	5494
EUR_42	10000	EUR	44299125	44428884	129759
EUR_42	10000	EUR	44915345	44959674	44329
EUR_42	10000	EUR	45965073	45977166	12093
EUR_42	10000	EUR	45994681	46044606	49925
EUR_42	10000	EUR	46254910	46287015	32105
EUR_42	10000	EUR	47722097	47744901	22804
EUR_42	10000	EUR	48240560	48246225	5665
EUR_42	10000	EUR	48793777	48801513	7736
EUR_42	10000	EUR	49396758	49409796	13038
EUR_42	10000	EUR	49471639	49501602	29963
EUR_42	10000	EUR	49656815	49751578	94763
EUR_42	10000	EUR	54732365	54740924	8559
EUR_42	10000	EUR	55684852	55943914	259062
EUR_42	10000	EUR	60314986	60354433	39447
EUR_42	10000	EUR	60391758	60473482	81724
EUR_42	10000	EUR	60697771	60715320	17549
EUR_42	10000	EUR	62336325	62520941	184616
EUR_42	10000	EUR	62709351	62791767	82416
EUR_42	10000	EUR	63248927	63268388	19461
EUR_42	10000	EUR	63530056	63775905	245849
EUR_42	10000	EUR	64831271	64865609	34338
EUR_42	10000	EUR	66778829	66897711	118882
EUR_42	10000	EUR	68340349	68341913	1564
EUR_42	10000	EUR	72366999	72393031	26032
EUR_42	10000	EUR	79834311	79835487	1176
EUR_42	10000	EUR	82819697	82867077	47380
EUR_42	10000	EUR	84307433	84476006	168573
EUR_42	10000	EUR	87069518	87191727	122209
EUR_42	10000	EUR	92821323	92870243	48920
EUR_42	10000	EUR	95549067	95706836	157769
EUR_42	10000	EUR	96252522	96313082	60560
EUR_42	10000	EUR	9913	10215	302
EUR_42	10000	EUR	7801499	7843158	41659
EUR_42	10000	EUR	9629012	9637337	8325
EUR_42	10000	EUR	10455256	10468821	13565
EUR_42	10000	EUR	12235935	12597188	361253
EUR_42	10000	EUR	13061051	13085270	24219
EUR_42	10000	EUR	13476436	13549834	73398
EUR_42	10000	EUR	17012776	17077983	65207
EUR_42	10000	EUR	20627652	20693514	65862
EUR_42	10000	EUR	21166394	21195469	29075
EUR_42	10000	EUR	23507155	23562645	55490
EUR_42	10000	EUR	26795639	26827636	31997
EUR_42	10000	EUR	29307623	29344643	37020
EUR_42	10000	EUR	29885100	29906215	21115
EUR_42	10000	EUR	30678684	30725822	47138
EUR_42	10000	EUR	30838706	30960757	122051
EUR_42	10000	EUR	31332044	31383101	51057
EUR_42	10000	EUR	31929110	31976562	47452
EUR_42	10000	EUR	33352525	33355723	3198
EUR_42	10000	EUR	35842665	35850326	7661
EUR_42	10000	EUR	39536610	39538252	1642
EUR_42	10000	EUR	40040672	40088009	47337
EUR_42	10000	EUR	41236994	41386596	149602
EUR_42	10000	EUR	41808814	41826713	17899
EUR_42	10000	EUR	44243666	44287999	44333
EUR_42	10000	EUR	44991454	45007478	16024
EUR_42	10000	EUR	45303182	45348218	45036
EUR_42	10000	EUR	45980594	46052925	72331
EUR_42	10000	EUR	47624392	47686374	61982
EUR_42	10000	EUR	49107941	49211922	103981
EUR_42	10000	EUR	49807803	50150613	342810
EUR_42	10000	EUR	50292505	50340188	47683
EUR_42	10000	EUR	56606415	56638521	32106
EUR_42	10000	EUR	60314986	60501936	186950
EUR_42	10000	EUR	61977382	62000629	23247
EUR_42	10000	EUR	62427707	62455504	27797
EUR_42	10000	EUR	62629480	62710548	81068
EUR_42	10000	EUR	63354466	63455982	101516
EUR_42	10000	EUR	64213067	64326150	113083
EUR_42	10000	EUR	64690778	64713211	22433
EUR_42	10000	EUR	64779628	64968332	188704
EUR_42	10000	EUR	65424838	65439431	14593
EUR_42	10000	EUR	67516377	67550551	34174
EUR_42	10000	EUR	67707244	67778978	71734
EUR_42	10000	EUR	67885028	67943437	58409
EUR_42	10000	EUR	68079150	68089779	10629
EUR_42	10000	EUR	68118814	68153675	34861
EUR_42	10000	EUR	68543110	68564643	21533
EUR_42	10000	EUR	70045788	70062616	16828
EUR_42	10000	EUR	71148579	71377452	228873
EUR_42	10000	EUR	72366999	72393031	26032
EUR_42	10000	EUR	73483646	73508952	25306
EUR_42	10000	EUR	74609427	74637502	28075
EUR_42	10000	EUR	74745525	74796715	51190
EUR_42	10000	EUR	78278359	78281355	2996
EUR_42	10000	EUR	79636078	79679325	43247
EUR_42	10000	EUR	80315709	80378472	62763
EUR_42	10000	EUR	81329834	81344715	14881
EUR_42	10000	EUR	84642857	84859626	216769
EUR_42	10000	EUR	93322571	93382850	60279
EUR_42	10000	EUR	97647484	97743855	96371
EUR_43	10000	EUR	5673598	5741613	68015
EUR_43	10000	EUR	7801499	8034150	232651
EUR_43	10000	EUR	10196585	10229013	32428
EUR_43	10000	EUR	12957537	13029529	71992
EUR_43	10000	EUR	14599834	14699483	99649
EUR_43	10000	EUR	15571100	15608201	37101
EUR_43	10000	EUR	15682412	15721551	39139
EUR_43	10000	EUR	15929044	15971895	42851
EUR_43	10000	EUR	19445931	19447994	2063
EUR_43	10000	EUR	24003989	24040521	36532
EUR_43	10000	EUR	27070686	27120057	49371
EUR_43	10000	EUR	28447913	28459172	11259
EUR_43	10000	EUR	31391393	31407691	16298
EUR_43	10000	EUR	37289843	37367274	77431
EUR_43	10000	EUR	44460384	44480695	20311
EUR_43	10000	EUR	45980594	46052925	72331
EUR_43	10000	EUR	48112263	48116147	3884
EUR_43	10000	EUR	49006754	49067165	60411
EUR_43	10000	EUR	49693701	49778991	85290
EUR_43	10000	EUR	49938053	50340188	402135
EUR_43	10000	EUR	51819962	51826252	6290
EUR_43	10000	EUR	54241939	54429543	187604
EUR_43	10000	EUR	54447874	54485919	38045
EUR_43	10000	EUR	54732365	54740924	8559
EUR_43	10000	EUR	55365672	55376432	10760
EUR_43	10000	EUR	55662959	55747582	84623
EUR_43	10000	EUR	59025323	59087449	62126
EUR_43	10000	EUR	62358424	62360148	1724
EUR_43	10000	EUR	62384821	62405059	20238
EUR_43	10000	EUR	62529172	62534818	5646
EUR_43	10000	EUR	62679237	62680258	1021
EUR_43	10000	EUR	62693596	62710548	16952
EUR_43	10000	EUR	62714390	62886738	172348
EUR_43	10000	EUR	63239582	63277354	37772
EUR_43	10000	EUR	63537912	63766562	228650
EUR_43	10000	EUR	64635938	64655885	19947
EUR_43	10000	EUR	67726807	67774483	47676
EUR_43	10000	EUR	69004995	69072506	67511
EUR_43	10000	EUR	69262441	69296795	34354
EUR_43	10000	EUR	70314329	70323506	9177
EUR_43	10000	EUR	71343174	71376679	33505
EUR_43	10000	EUR	72313374	72338979	25605
EUR_43	10000	EUR	74638673	74653919	15246
EUR_43	10000	EUR	74704171	74756907	52736
EUR_43	10000	EUR	78128495	78213775	85280
EUR_43	10000	EUR	80307017	80378472	71455
EUR_43	10000	EUR	84040452	84086635	46183
EUR_43	10000	EUR	84454434	84508973	54539
EUR_43	10000	EUR	84573291	84607732	34441
EUR_43	10000	EUR	86340983	86430822	89839
EUR_43	10000	EUR	96215188	96273194	58006
EUR_43	10000	EUR	96879365	97130504	251139
EUR_43	10000	EUR	97207860	97375516	167656
EUR_43	10000	EUR	8846483	8958572	112089
EUR_43	10000	EUR	10162900	10351635	188735
EUR_43	10000	EUR	11221129	11260836	39707
EUR_43	10000	EUR	12195294	12247244	51950
EUR_43	10000	EUR	12405520	12614071	208551
EUR_43	10000	EUR	12957537	13085270	127733
EUR_43	10000	EUR	14599834	14744959	145125
EUR_43	10000	EUR	15571100	15608201	37101
EUR_43	10000	EUR	21164886	21168829	3943
EUR_43	10000	EUR	21735053	21774213	39160
EUR_43	10000	EUR	21919460	21966961	47501
EUR_43	10000	EUR	23960602	24013504	52902
EUR_43	10000	EUR	28447913	28459172	11259
EUR_43	10000	EUR	30085525	30116933	31408
EUR_43	10000	EUR	30831946	30861389	29443
EUR_43	10000	EUR	31213935	31267996	54061
EUR_43	10000	EUR	31340450	31464998	124548
EUR_43	10000	EUR	32007672	32101976	94304
EUR_43	10000	EUR	35825437	35922358	96921
EUR_43	10000	EUR	39475823	39545103	69280
EUR_43	10000	EUR	39871917	39890454	18537
EUR_43	10000	EUR	41082532	41103899	21367
EUR_43	10000	EUR	43750662	43756156	5494
EUR_43	10000	EUR	44299125	44431264	132139
EUR_43	10000	EUR	45274093	45295441	21348
EUR_43	10000	EUR	45948492	45999654	51162
EUR_43	10000	EUR	47624392	47758303	133911
EUR_43	10000	EUR	48181642	48250239	68597
EUR_43	10000	EUR	48793399	48804986	11587
EUR_43	10000	EUR	48952912	49075471	122559
EUR_43	10000	EUR	49114975	49211922	96947
EUR_43	10000	EUR	49212244	49243818	31574
EUR_43	10000	EUR	50079988	50086485	6497
EUR_43	10000	EUR	50215570	50270346	54776
EUR_43	10000	EUR	50505922	50514335	8413
EUR_43	10000	EUR	50618884	50682125	63241
EUR_43	10000	EUR	54739518	54740924	1406
EUR_43	10000	EUR	56606415	56661029	54614
EUR_43	10000	EUR	56996794	57026186	29392
EUR_43	10000	EUR	60675915	60703119	27204
EUR_43	10000	EUR	62482898	62546166	63268
EUR_43	10000	EUR	62570596	62648920	78324
EUR_43	10000	EUR	62707428	62741636	34208
EUR_43	10000	EUR	63461724	63488070	26346
EUR_43	10000	EUR	64007129	64060264	53135
EUR_43	10000	EUR	64213067	64326150	113083
EUR_43	10000	EUR	64420562	64447738	27176
EUR_43	10000	EUR	68176301	68234683	58382
EUR_43	10000	EUR	69976346	70056767	80421
EUR_43	10000	EUR	70314329	70323506	9177
EUR_43	10000	EUR	70425266	70432857	7591
EUR_43	10000	EUR	73920589	74176524	255935
EUR_43	10000	EUR	74185839	74195965	10126
EUR_43	10000	EUR	74614046	74797490	183444
EUR_43	10000	EUR	76219599	76223870	4271
EUR_43	10000	EUR	77180956	77201979	21023
EUR_43	10000	EUR	78278359	78281355	2996
EUR_43	10000	EUR	79636078	79803495	167417
EUR_43	10000	EUR	81329834	81357575	27741
EUR_43	10000	EUR	82804246	82944067	139821
EUR_43	10000	EUR	84074915	84136758	61843
EUR_43	10000	EUR	84276859	84281776	4917
EUR_43	10000	EUR	84480189	84483142	2953
EUR_43	10000	EUR	86183232	86262769	79537
EUR_43	10000	EUR	96628171	96657524	29353
EUR_43	10000	EUR	96928157	96969240	41083
EUR_43	10000	EUR	97149005	97170445	21440
EUR_43	10000	EUR	97368034	97434688	66654
EUR_43	10000	EUR	97516792	97606042	89250
EUR_44	10000	EUR	0	24714	24714
EUR_44	10000	EUR	1443312	1474375	31063
EUR_44	10000	EUR	5883957	5891953	7996
EUR_44	10000	EUR	8009348	8063843	54495
EUR_44	10000	EUR	10310816	10435263	124447
EUR_44	10000	EUR	10455256	10468821	13565
EUR_44	10000	EUR	11741022	11836160	95138
EUR_44	10000	EUR	12195294	12394574	199280
EUR_44	10000	EUR	12517970	12560953	42983
EUR_44	10000	EUR	12959122	12989272	30150
EUR_44	10000	EUR	14623115	14669505	46390
EUR_44	10000	EUR	15638515	15740215	101700
EUR_44	10000	EUR	17889314	17924864	35550
EUR_44	10000	EUR	19445630	19544916	99286
EUR_44	10000	EUR	21386882	21774213	387331
EUR_44	10000	EUR	21919460	21966961	47501
EUR_44	10000	EUR	23507155	23578786	71631
EUR_44	10000	EUR	24787278	24800868	13590
EUR_44	10000	EUR	27030183	27120057	89874
EUR_44	10000	EUR	29749217	29751787	2570
EUR_44	10000	EUR	29885100	29938261	53161
EUR_44	10000	EUR	30048478	30113486	65008
EUR_44	10000	EUR	30678684	30730344	51660
EUR_44	10000	EUR	39536610	39538252	1642
EUR_44	10000	EUR	44469895	44701885	231990
EUR_44	10000	EUR	45064382	45131072	66690
EUR_44	10000	EUR	46821026	46854432	33406
EUR_44	10000	EUR	48181642	48246225	64583
EUR_44	10000	EUR	48291187	48321534	30347
EUR_44	10000	EUR	48942765	48992520	49755
EUR_44	10000	EUR	49135738	49184575	48837
EUR_44	10000	EUR	49422646	49489442	66796
EUR_44	10000	EUR	50256105	50340188	84083
EUR_44	10000	EUR	53185716	53302464	116748
EUR_44	10000	EUR	55365672	55376432	10760
EUR_44	10000	EUR	56642327	56661029	18702
EUR_44	10000	EUR	60314986	60335891	20905
EUR_44	10000	EUR	60587632	60595221	7589
EUR_44	10000	EUR	62312014	62343666	31652
EUR_44	10000	EUR	63418847	63437406	18559
EUR_44	10000	EUR	64669031	64775972	106941
EUR_44	10000	EUR	66778829	66850193	71364
EUR_44	10000	EUR	67890847	68012425	121578
EUR_44	10000	EUR	68340349	68341913	1564
EUR_44	10000	EUR	69253738	69254774	1036
EUR_44	10000	EUR	69262441	69296795	34354
EUR_44	10000	EUR	71334879	71336069	1190
EUR_44	10000	EUR	73920589	74226288	305699
EUR_44	10000	EUR	74345860	74386200	40340
EUR_44	10000	EUR	78278359	78281355	2996
EUR_44	10000	EUR	80307017	80378472	71455
EUR_44	10000	EUR	80884825	80887060	2235
EUR_44	10000	EUR	81329834	81359351	29517
EUR_44	10000	EUR	84271016	84413705	142689
EUR_44	10000	EUR	86446184	86468527	22343
EUR_44	10000	EUR	89233989	89360109	126120
EUR_44	10000	EUR	96344658	96351295	6637
EUR_44	10000	EUR	97295440	97321820	26380
EUR_44	10000	EUR	1443312	1474375	31063
EUR_44	10000	EUR	5738269	5741613	3344
EUR_44	10000	EUR	7764477	7852331	87854
EUR_44	10000	EUR	9629012	9637337	8325
EUR_44	10000	EUR	10162900	10265441	102541
EUR_44	10000	EUR	10504963	10525722	20759
EUR_44	10000	EUR	12446254	12649905	203651
EUR_44	10000	EUR	12689167	12733612	44445
EUR_44	10000	EUR	14760094	14813343	53249
EUR_44	10000	EUR	15571100	15608201	37101
EUR_44	10000	EUR	15682412	15721551	39139
EUR_44	10000	EUR	15929044	15971895	42851
EUR_44	10000	EUR	17067299	17323735	256436
EUR_44	10000	EUR	21935834	21965772	29938
EUR_44	10000	EUR	23678834	23696381	17547
EUR_44	10000	EUR	27030183	27120057	89874
EUR_44	10000	EUR	28447913	28454759	6846
EUR_44	10000	EUR	29749217	29774921	25704
EUR_44	10000	EUR	31952278	31976562	24284
EUR_44	10000	EUR	35825437	35920140	94703
EUR_44	10000	EUR	36536523	36541861	5338
EUR_44	10000	EUR	41190630	41244487	53857
EUR_44	10000	EUR	45965073	45977166	12093
EUR_44	10000	EUR	47624392	47634129	9737
EUR_44	10000	EUR	47874821	48095137	220316
EUR_44	10000	EUR	48273976	48321534	47558
EUR_44	10000	EUR	48942765	49071287	128522
EUR_44	10000	EUR	50090268	50262383	172115
EUR_44	10000	EUR	50289012	50456856	167844
EUR_44	10000	EUR	50514235	50542598	28363
EUR_44	10000	EUR	50654897	50675343	20446
EUR_44	10000	EUR	56981282	57026186	44904
EUR_44	10000	EUR	59025323	59087449	62126
EUR_44	10000	EUR	61977382	62000629	23247
EUR_44	10000	EUR	62427365	62685357	257992
EUR_44	10000	EUR	62900098	62995054	94956
EUR_44	10000	EUR	63239582	63277354	37772
EUR_44	10000	EUR	63330030	63370527	40497
EUR_44	10000	EUR	63947203	64060264	113061
EUR_44	10000	EUR	64877575	64919684	42109
EUR_44	10000	EUR	67242926	67246845	3919
EUR_44	10000	EUR	67683259	67732388	49129
EUR_44	10000	EUR	67796826	67809401	12575
EUR_44	10000	EUR	69976346	70056767	80421
EUR_44	10000	EUR	70314329	70323506	9177
EUR_44	10000	EUR	70425266	70432857	7591
EUR_44	10000	EUR	74165046	74332051	167005
EUR_44	10000	EUR	74661597	74663374	1777
EUR_44	10000	EUR	78278359	78281355	2996
EUR_44	10000	EUR	80790902	80831869	40967
EUR_44	10000	EUR	81009858	81010866	1008
EUR_44	10000	EUR	81329834	81344715	14881
EUR_44	10000	EUR	82777601	82808198	30597
EUR_44	10000	EUR	84174413	84277374	102961
EUR_44	10000	EUR	86960175	87018305	58130
EUR_44	10000	EUR	96344658	96551349	206691
EUR_44	10000	EUR	96731151	96795126	63975
EUR_44	10000	EUR	96935175	96957114	21939
EUR_45	10000	EUR	0	24714	24714
EUR_45	10000	EUR	5633934	5741613	107679
EUR_45	10000	EUR	7801499	8034150	232651
EUR_45	10000	EUR	10310816	10371329	60513
EUR_45	10000	EUR	11221129	11267811	46682
EUR_45	10000	EUR	12436919	12518164	81245
EUR_45	10000	EUR	12541608	12571424	29816
EUR_45	10000	EUR	13943659	14132248	188589
EUR_45	10000	EUR	14713216	14731414	18198
EUR_45	10000	EUR	15678424	15743283	64859
EUR_45	10000	EUR	21166394	21195469	29075
EUR_45	10000	EUR	21525308	21533742	8434
EUR_45	10000	EUR	23348628	23374530	25902
EUR_45	10000	EUR	23472367	23562645	90278
EUR_45	10000	EUR	24837759	24857143	19384
EUR_45	10000	EUR	25625985	25637091	11106
EUR_45	10000	EUR	27030183	27120057	89874
EUR_45	10000	EUR	30085525	30116933	31408
EUR_45	10000	EUR	31340450	31464998	124548
EUR_45	10000	EUR	33352525	33353174	649
EUR_45	10000	EUR	35842665	35878546	35881
EUR_45	10000	EUR	43774531	43842289	67758
EUR_45	10000	EUR	45274093	45295441	21348
EUR_45	10000	EUR	46644585	46669897	25312
EUR_45	10000	EUR	48806513	48831623	25110
EUR_45	10000	EUR	49074315	49126531	52216
EUR_45	10000	EUR	49641162	49707032	65870
EUR_45	10000	EUR	50079988	50148912	68924
EUR_45	10000	EUR	50214714	50504747	290033
EUR_45	10000	EUR	55372681	55376432	3751
EUR_45	10000	EUR	59749311	59778531	29220
EUR_45	10000	EUR	60361404	60623780	262376
EUR_45	10000	EUR	60836692	60850995	14303
EUR_45	10000	EUR	62363965	62421852	57887
EUR_45	10000	EUR	62454345	62460553	6208
EUR_45	10000	EUR	62587181	62648920	61739
EUR_45	10000	EUR	62707428	62851872	144444
EUR_45	10000	EUR	63488006	63488070	64
EUR_45	10000	EUR	67778276	67782844	4568
EUR_45	10000	EUR	67993239	68056363	63124
EUR_45	10000	EUR	70425266	70452650	27384
EUR_45	10000	EUR	71343174	71376679	33505
EUR_45	10000	EUR	73920589	74112795	192206
EUR_45	10000	EUR	74704171	74781759	77588
EUR_45	10000	EUR	78626655	78660130	33475
EUR_45	10000	EUR	80925593	80961424	35831
EUR_45	10000	EUR	82740735	82787554	46819
EUR_45	10000	EUR	91097171	91116161	18990
EUR_45	10000	EUR	96344658	96968880	624222
EUR_45	10000	EUR	97428913	97507231	78318
EUR_45	10000	EUR	97591041	97612012	20971
EUR_45	10000	EUR	98420167	98443847	23680
EUR_45	10000	EUR	5515391	5560949	45558
EUR_45	10000	EUR	5689746	5710946	21200
EUR_45	10000	EUR	10504963	10559629	54666
EUR_45	10000	EUR	12446254	12649905	203651
EUR_45	10000	EUR	13943659	14132248	188589
EUR_45	10000	EUR	15666565	15672229	5664
EUR_45	10000	EUR	16998973	17115665	116692
EUR_45	10000	EUR	19445931	19447994	2063
EUR_45	10000	EUR	19700871	19708863	7992
EUR_45	10000	EUR	21218489	21258286	39797
EUR_45	10000	EUR	23414479	23438353	23874
EUR_45	10000	EUR	27030183	27120057	89874
EUR_45	10000	EUR	28730691	28751710	21019
EUR_45	10000	EUR	29310108	29386346	76238
EUR_45	10000	EUR	29749217	29774921	25704
EUR_45	10000	EUR	29853109	29862527	9418
EUR_45	10000	EUR	30528228	30561025	32797
EUR_45	10000	EUR	30931120	31134052	202932
EUR_45	10000	EUR	31340450	31464998	124548
EUR_45	10000	EUR	31953948	32101976	148028
EUR_45	10000	EUR	44915345	45077292	161947
EUR_45	10000	EUR	45737512	45742393	4881
EUR_45	10000	EUR	46215539	46222689	7150
EUR_45	10000	EUR	47978647	47988634	9987
EUR_45	10000	EUR	48181642	48250239	68597
EUR_45	10000	EUR	48806513	48831623	25110
EUR_45	10000	EUR	48993613	49054357	60744
EUR_45	10000	EUR	49648154	50108086	459932
EUR_45	10000	EUR	50199687	50220042	20355
EUR_45	10000	EUR	50336407	50340188	3781
EUR_45	10000	EUR	50505922	50514335	8413
EUR_45	10000	EUR	50618884	50682125	63241
EUR_45	10000	EUR	55372681	55376432	3751
EUR_45	10000	EUR	59025323	59087449	62126
EUR_45	10000	EUR	60836692	60850995	14303
EUR_45	10000	EUR	62290128	62360303	70175
EUR_45	10000	EUR	62571477	62571923	446
EUR_45	10000	EUR	62672738	62763590	90852
EUR_45	10000	EUR	63354466	63517969	163503
EUR_45	10000	EUR	64620624	64648825	28201
EUR_45	10000	EUR	67516377	67530122	13745
EUR_45	10000	EUR	68176301	68234683	58382
EUR_45	10000	EUR	70178120	70180545	2425
EUR_45	10000	EUR	70314329	70323506	9177
EUR_45	10000	EUR	70425266	70432857	7591
EUR_45	10000	EUR	71187459	71336069	148610
EUR_45	10000	EUR	74165046	74174221	9175
EUR_45	10000	EUR	74638673	74738201	99528
EUR_45	10000	EUR	82712051	82804103	92052
EUR_45	10000	EUR	82937424	83035646	98222
EUR_45	10000	EUR	84051369	84087948	36579
EUR_45	10000	EUR	84307433	84476006	168573
EUR_45	10000	EUR	85095833	85104111	8278
EUR_45	10000	EUR	93588756	93660617	71861
EUR_45	10000	EUR	96928157	96969240	41083
EUR_45	10000	EUR	97149005	97170445	21440
EUR_45	10000	EUR	97368034	97434688	66654
EUR_45	10000	EUR	97516792	97606042	89250
EUR_46	10000	EUR	0	38454	38454
EUR_46	10000	EUR	2311146	2417674	106528
EUR_46	10000	EUR	8037923	8069680	31757
EUR_46	10000	EUR	8846483	8958572	112089
EUR_46	10000	EUR	10195098	10208942	13844
EUR_46	10000	EUR	10547312	10559629	12317
EUR_46	10000	EUR	11155402	11162329	6927
EUR_46	10000	EUR	12436919	12498874	61955
EUR_46	10000	EUR	14719006	14731414	12408
EUR_46	10000	EUR	15678424	15743283	64859
EUR_46	10000	EUR	15920084	15929214	9130
EUR_46	10000	EUR	21489581	21558457	68876
EUR_46	10000	EUR	21935834	21965772	29938
EUR_46	10000	EUR	24003989	24040521	36532
EUR_46	10000	EUR	26757616	27016672	259056
EUR_46	10000	EUR	29256822	29403219	146397
EUR_46	10000	EUR	41241594	41253549	11955
EUR_46	10000	EUR	43768000	43785095	17095
EUR_46	10000	EUR	44243666	44287999	44333
EUR_46	10000	EUR	45980594	46044606	64012
EUR_46	10000	EUR	46254910	46287015	32105
EUR_46	10000	EUR	48273976	48321534	47558
EUR_46	10000	EUR	48988140	49057058	68918
EUR_46	10000	EUR	49915595	50063922	148327
EUR_46	10000	EUR	50135685	50340188	204503
EUR_46	10000	EUR	50481676	50682125	200449
EUR_46	10000	EUR	53307869	53387076	79207
EUR_46	10000	EUR	60391758	60473482	81724
EUR_46	10000	EUR	62707428	62886738	179310
EUR_46	10000	EUR	63197303	63217814	20511
EUR_46	10000	EUR	63974015	64013981	39966
EUR_46	10000	EUR	64050970	64066021	15051
EUR_46	10000	EUR	64259771	64326150	66379
EUR_46	10000	EUR	65392456	65439431	46975
EUR_46	10000	EUR	67726807	67774483	47676
EUR_46	10000	EUR	68511602	68551456	39854
EUR_46	10000	EUR	69004995	69072506	67511
EUR_46	10000	EUR	70314329	70323506	9177
EUR_46	10000	EUR	71501268	71509363	8095
EUR_46	10000	EUR	74704171	74781759	77588
EUR_46	10000	EUR	77940158	77981834	41676
EUR_46	10000	EUR	84457805	84508973	51168
EUR_46	10000	EUR	85268776	85314478	45702
EUR_46	10000	EUR	86183232	86262769	79537
EUR_46	10000	EUR	95549067	95706836	157769
EUR_46	10000	EUR	96344658	96391048	46390
EUR_46	10000	EUR	97100087	97197807	97720
EUR_46	10000	EUR	97198885	97229983	31098
EUR_46	10000	EUR	97368034	97434688	66654
EUR_46	10000	EUR	97516792	97606042	89250
EUR_46	10000	EUR	994187	1035072	40885
EUR_46	10000	EUR	5623952	5720427	96475
EUR_46	10000	EUR	8009348	8069680	60332
EUR_46	10000	EUR	10162900	10335169	172269
EUR_46	10000	EUR	12402534	12421454	18920
EUR_46	10000	EUR	13096243	13191657	95414
EUR_46	10000	EUR	15607322	15740215	132893
EUR_46	10000	EUR	17270851	17273048	2197
EUR_46	10000	EUR	19569358	19651006	81648
EUR_46	10000	EUR	21489581	21558457	68876
EUR_46	10000	EUR	23480055	23525224	45169
EUR_46	10000	EUR	23678834	23696381	17547
EUR_46	10000	EUR	23923937	24061376	137439
EUR_46	10000	EUR	26757616	26872978	115362
EUR_46	10000	EUR	28447913	28473925	26012
EUR_46	10000	EUR	29755007	29767219	12212
EUR_46	10000	EUR	30557628	30641876	84248
EUR_46	10000	EUR	31303461	31362466	59005
EUR_46	10000	EUR	31869080	31976562	107482
EUR_46	10000	EUR	43321108	43338312	17204
EUR_46	10000	EUR	48152063	48429959	277896
EUR_46	10000	EUR	49716678	49797331	80653
EUR_46	10000	EUR	50079988	50086485	6497
EUR_46	10000	EUR	50215570	50270346	54776
EUR_46	10000	EUR	50505922	50514335	8413
EUR_46	10000	EUR	50618884	50682125	63241
EUR_46	10000	EUR	54393191	54424698	31507
EUR_46	10000	EUR	55692248	55747582	55334
EUR_46	10000	EUR	55892211	56019725	127514
EUR_46	10000	EUR	60314986	60406009	91023
EUR_46	10000	EUR	60675915	60703119	27204
EUR_46	10000	EUR	62363965	62421852	57887
EUR_46	10000	EUR	62584114	62613178	29064
EUR_46	10000	EUR	62727287	62886738	159451
EUR_46	10000	EUR	63418847	63437406	18559
EUR_46	10000	EUR	64275342	64277727	2385
EUR_46	10000	EUR	64689850	64713211	23361
EUR_46	10000	EUR	64779628	64968332	188704
EUR_46	10000	EUR	68176301	68234683	58382
EUR_46	10000	EUR	70314329	70323506	9177
EUR_46	10000	EUR	71214523	71270702	56179
EUR_46	10000	EUR	73344343	73357038	12695
EUR_46	10000	EUR	77940158	77981834	41676
EUR_46	10000	EUR	81962315	82042725	80410
EUR_46	10000	EUR	86448717	86466441	17724
EUR_46	10000	EUR	93241661	93307742	66081
EUR_46	10000	EUR	93926019	93935697	9678
EUR_46	10000	EUR	95549067	95706836	157769
EUR_46	10000	EUR	96344658	96391048	46390
EUR_46	10000	EUR	97100087	97197807	97720
EUR_46	10000	EUR	97198885	97229983	31098
EUR_46	10000	EUR	97398476	97743855	345379
EUR_47	10000	EUR	994187	1035072	40885
EUR_47	10000	EUR	8023767	8024855	1088
EUR_47	10000	EUR	12217850	12231489	13639
EUR_47	10000	EUR	12283210	12367555	84345
EUR_47	10000	EUR	15617938	15652655	34717
EUR_47	10000	EUR	19528439	19583445	55006
EUR_47	10000	EUR	23507155	23562645	55490
EUR_47	10000	EUR	24655151	24693848	38697
EUR_47	10000	EUR	26757616	26827636	70020
EUR_47	10000	EUR	27582949	27637833	54884
EUR_47	10000	EUR	31039633	31176694	137061
EUR_47	10000	EUR	31303461	31362466	59005
EUR_47	10000	EUR	31413310	31464998	51688
EUR_47	10000	EUR	32052821	32101976	49155
EUR_47	10000	EUR	41808814	41826713	17899
EUR_47	10000	EUR	43750662	43798852	48190
EUR_47	10000	EUR	44253582	44269926	16344
EUR_47	10000	EUR	44299125	44431264	132139
EUR_47	10000	EUR	46430949	46432260	1311
EUR_47	10000	EUR	47624392	47760170	135778
EUR_47	10000	EUR	49006754	49067165	60411
EUR_47	10000	EUR	49693701	49778991	85290
EUR_47	10000	EUR	49938053	50340188	402135
EUR_47	10000	EUR	55662959	55747582	84623
EUR_47	10000	EUR	55892211	56019725	127514
EUR_47	10000	EUR	59025323	59087449	62126
EUR_47	10000	EUR	61881873	62049844	167971
EUR_47	10000	EUR	62266230	62343666	77436
EUR_47	10000	EUR	63212342	63220501	8159
EUR_47	10000	EUR	64620624	64648825	28201
EUR_47	10000	EUR	66667736	66822356	154620
EUR_47	10000	EUR	67982434	67997999	15565
EUR_47	10000	EUR	68044654	68168599	123945
EUR_47	10000	EUR	71334879	71336069	1190
EUR_47	10000	EUR	78020485	78031382	10897
EUR_47	10000	EUR	78278359	78281355	2996
EUR_47	10000	EUR	80751058	80830440	79382
EUR_47	10000	EUR	80947447	80965346	17899
EUR_47	10000	EUR	86934249	87004998	70749
EUR_47	10000	EUR	93789189	93826724	37535
EUR_47	10000	EUR	96344658	96478190	133532
EUR_47	10000	EUR	96599275	96652091	52816
EUR_47	10000	EUR	96652259	96688015	35756
EUR_47	10000	EUR	96906437	96969240	62803
EUR_47	10000	EUR	97149005	97170445	21440
EUR_47	10000	EUR	97516792	97544370	27578
EUR_47	10000	EUR	1443312	1474375	31063
EUR_47	10000	EUR	5865668	5971269	105601
EUR_47	10000	EUR	8004685	8026219	21534
EUR_47	10000	EUR	8846483	8958572	112089
EUR_47	10000	EUR	10162900	10265441	102541
EUR_47	10000	EUR	10504963	10525722	20759
EUR_47	10000	EUR	12195294	12296077	100783
EUR_47	10000	EUR	13864408	13957627	93219
EUR_47	10000	EUR	14623115	14669505	46390
EUR_47	10000	EUR	15607322	15740215	132893
EUR_47	10000	EUR	16985162	17115665	130503
EUR_47	10000	EUR	17270851	17295109	24258
EUR_47	10000	EUR	21737927	21766730	28803
EUR_47	10000	EUR	21773238	21828855	55617
EUR_47	10000	EUR	23626899	23638658	11759
EUR_47	10000	EUR	28447913	28454759	6846
EUR_47	10000	EUR	29249415	29316758	67343
EUR_47	10000	EUR	29885100	30020785	135685
EUR_47	10000	EUR	30528228	30590405	62177
EUR_47	10000	EUR	31391393	31407691	16298
EUR_47	10000	EUR	31862751	31930228	67477
EUR_47	10000	EUR	41190630	41244487	53857
EUR_47	10000	EUR	45948492	45999654	51162
EUR_47	10000	EUR	46238893	46277873	38980
EUR_47	10000	EUR	48957046	48987944	30898
EUR_47	10000	EUR	49094046	49139016	44970
EUR_47	10000	EUR	49206724	49211922	5198
EUR_47	10000	EUR	49807803	50150613	342810
EUR_47	10000	EUR	50292505	50340188	47683
EUR_47	10000	EUR	54352751	54424698	71947
EUR_47	10000	EUR	55736070	55767126	31056
EUR_47	10000	EUR	59040258	59081813	41555
EUR_47	10000	EUR	59749311	59778531	29220
EUR_47	10000	EUR	62489657	62546944	57287
EUR_47	10000	EUR	63400955	63488070	87115
EUR_47	10000	EUR	67516377	67544360	27983
EUR_47	10000	EUR	67885356	68012425	127069
EUR_47	10000	EUR	68060953	68219989	159036
EUR_47	10000	EUR	70459841	70471952	12111
EUR_47	10000	EUR	74640430	74642331	1901
EUR_47	10000	EUR	81849638	81877251	27613
EUR_47	10000	EUR	82902329	83015877	113548
EUR_47	10000	EUR	84074915	84136758	61843
EUR_47	10000	EUR	84338892	84476006	137114
EUR_47	10000	EUR	92671111	92820212	149101
EUR_47	10000	EUR	96580037	96652091	72054
EUR_47	10000	EUR	96652259	96679642	27383
EUR_47	10000	EUR	96968543	96969240	697
EUR_48	10000	EUR	10607	24714	14107
EUR_48	10000	EUR	257772	317557	59785
EUR_48	10000	EUR	994187	1035072	40885
EUR_48	10000	EUR	5948579	5963046	14467
EUR_48	10000	EUR	8922196	8953694	31498
EUR_48	10000	EUR	10310816	10559629	248813
EUR_48	10000	EUR	13864885	13899355	34470
EUR_48	10000	EUR	14760094	14813343	53249
EUR_48	10000	EUR	15678424	15743283	64859
EUR_48	10000	EUR	19347750	19378646	30896
EUR_48	10000	EUR	19445931	19447994	2063
EUR_48	10000	EUR	21282427	21582697	300270
EUR_48	10000	EUR	23472367	23533637	61270
EUR_48	10000	EUR	24049960	24061376	11416
EUR_48	10000	EUR	24837759	24857143	19384
EUR_48	10000	EUR	25625985	25637091	11106
EUR_48	10000	EUR	27563461	27652140	88679
EUR_48	10000	EUR	30838706	30998466	159760
EUR_48	10000	EUR	31048766	31088907	40141
EUR_48	10000	EUR	31127128	31197466	70338
EUR_48	10000	EUR	32453173	32511362	58189
EUR_48	10000	EUR	35842665	35978953	136288
EUR_48	10000	EUR	41698837	41705026	6189
EUR_48	10000	EUR	43768000	43770888	2888
EUR_48	10000	EUR	44299125	44431264	132139
EUR_48	10000	EUR	44991454	45001814	10360
EUR_48	10000	EUR	45326266	45335213	8947
EUR_48	10000	EUR	47624392	47760170	135778
EUR_48	10000	EUR	47917773	48089703	171930
EUR_48	10000	EUR	48181642	48246225	64583
EUR_48	10000	EUR	48291187	48321534	30347
EUR_48	10000	EUR	48942765	49098256	155491
EUR_48	10000	EUR	49716678	49823430	106752
EUR_48	10000	EUR	50079988	50086485	6497
EUR_48	10000	EUR	50097255	50255701	158446
EUR_48	10000	EUR	50651894	50675343	23449
EUR_48	10000	EUR	56646775	56670627	23852
EUR_48	10000	EUR	59749311	59778531	29220
EUR_48	10000	EUR	60340797	60366947	26150
EUR_48	10000	EUR	60675915	60703119	27204
EUR_48	10000	EUR	62358424	62360148	1724
EUR_48	10000	EUR	62384821	62405059	20238
EUR_48	10000	EUR	62529172	62534818	5646
EUR_48	10000	EUR	62679237	62680258	1021
EUR_48	10000	EUR	62742890	62886738	143848
EUR_48	10000	EUR	63177292	63220501	43209
EUR_48	10000	EUR	63687742	63775905	88163
EUR_48	10000	EUR	64993828	65025826	31998
EUR_48	10000	EUR	66942688	67022791	80103
EUR_48	10000	EUR	67043600	67142501	98901
EUR_48	10000	EUR	68501694	68552706	51012
EUR_48	10000	EUR	69004995	69072506	67511
EUR_48	10000	EUR	69230927	69315282	84355
EUR_48	10000	EUR	70314329	70323506	9177
EUR_48	10000	EUR	71501268	71509363	8095
EUR_48	10000	EUR	74185839	74211177	25338
EUR_48	10000	EUR	74638673	74738201	99528
EUR_48	10000	EUR	80106200	80125347	19147
EUR_48	10000	EUR	80307017	80378472	71455
EUR_48	10000	EUR	84495585	84512149	16564
EUR_48	10000	EUR	89347311	89360109	12798
EUR_48	10000	EUR	96404550	96451210	46660
EUR_48	10000	EUR	0	38454	38454
EUR_48	10000	EUR	2550449	2651211	100762
EUR_48	10000	EUR	5738269	5741613	3344
EUR_48	10000	EUR	8846483	8933755	87272
EUR_48	10000	EUR	9051485	9091881	40396
EUR_48	10000	EUR	10195098	10229013	33915
EUR_48	10000	EUR	10310816	10371329	60513
EUR_48	10000	EUR	11782696	11836160	53464
EUR_48	10000	EUR	12971780	12992919	21139
EUR_48	10000	EUR	15651184	15701244	50060
EUR_48	10000	EUR	15783892	15821860	37968
EUR_48	10000	EUR	18850191	18885640	35449
EUR_48	10000	EUR	19205162	19218710	13548
EUR_48	10000	EUR	19375630	19454354	78724
EUR_48	10000	EUR	19519830	19724249	204419
EUR_48	10000	EUR	21471760	21526260	54500
EUR_48	10000	EUR	21737927	21766730	28803
EUR_48	10000	EUR	23480055	23517332	37277
EUR_48	10000	EUR	24655151	24663032	7881
EUR_48	10000	EUR	29885100	30020785	135685
EUR_48	10000	EUR	35842665	36017172	174507
EUR_48	10000	EUR	40040672	40088009	47337
EUR_48	10000	EUR	43750662	43798852	48190
EUR_48	10000	EUR	46345940	46424629	78689
EUR_48	10000	EUR	46603480	46692826	89346
EUR_48	10000	EUR	47672056	47744901	72845
EUR_48	10000	EUR	48240560	48246225	5665
EUR_48	10000	EUR	49039217	49084376	45159
EUR_48	10000	EUR	49720102	50042489	322387
EUR_48	10000	EUR	50079988	50086485	6497
EUR_48	10000	EUR	50256105	50315884	59779
EUR_48	10000	EUR	51721135	51733712	12577
EUR_48	10000	EUR	55663984	55704084	40100
EUR_48	10000	EUR	55891681	55921875	30194
EUR_48	10000	EUR	56981282	57026186	44904
EUR_48	10000	EUR	60569371	60623780	54409
EUR_48	10000	EUR	62266230	62343666	77436
EUR_48	10000	EUR	63177292	63245436	68144
EUR_48	10000	EUR	64786335	64809344	23009
EUR_48	10000	EUR	66942688	67022791	80103
EUR_48	10000	EUR	67043600	67142501	98901
EUR_48	10000	EUR	67516377	67558609	42232
EUR_48	10000	EUR	67890847	68012425	121578
EUR_48	10000	EUR	68186638	68219989	33351
EUR_48	10000	EUR	68543110	68564643	21533
EUR_48	10000	EUR	69004995	69072506	67511
EUR_48	10000	EUR	69292970	69296795	3825
EUR_48	10000	EUR	70459841	70471952	12111
EUR_48	10000	EUR	74071046	74226288	155242
EUR_48	10000	EUR	74345860	74386200	40340
EUR_48	10000	EUR	74614046	74797490	183444
EUR_48	10000	EUR	78278359	78281355	2996
EUR_48	10000	EUR	82712051	82804103	92052
EUR_48	10000	EUR	84051369	84087948	36579
EUR_48	10000	EUR	84307433	84476006	168573
EUR_48	10000	EUR	95549067	95706836	157769
EUR_48	10000	EUR	96344658	96391048	46390
EUR_48	10000	EUR	97100087	97197807	97720
EUR_48	10000	EUR	97198885	97229983	31098
EUR_48	10000	EUR	97398476	97690281	291805
EUR_49	10000	EUR	994187	1010735	16548
EUR_49	10000	EUR	1443312	1474375	31063
EUR_49	10000	EUR	2267390	2417674	150284
EUR_49	10000	EUR	12436919	12518164	81245
EUR_49	10000	EUR	12541608	12571424	29816
EUR_49	10000	EUR	12672627	12699501	26874
EUR_49	10000	EUR	14599834	14744959	145125
EUR_49	10000	EUR	16273954	16340550	66596
EUR_49	10000	EUR	17270851	17323735	52884
EUR_49	10000	EUR	19347750	19446442	98692
EUR_49	10000	EUR	19524348	19575541	51193
EUR_49	10000	EUR	19666607	19720116	53509
EUR_49	10000	EUR	21737927	21766730	28803
EUR_49	10000	EUR	21773238	21828855	55617
EUR_49	10000	EUR	26757616	27016672	259056
EUR_49	10000	EUR	29256822	29403219	146397
EUR_49	10000	EUR	30838706	30852727	14021
EUR_49	10000	EUR	31061901	31134052	72151
EUR_49	10000	EUR	31332044	31383101	51057
EUR_49	10000	EUR	31929110	31976562	47452
EUR_49	10000	EUR	35825437	35904356	78919
EUR_49	10000	EUR	43750662	43785095	34433
EUR_49	10000	EUR	45919475	46077353	157878
EUR_49	10000	EUR	47672056	47744901	72845
EUR_49	10000	EUR	48273976	48321534	47558
EUR_49	10000	EUR	48855561	48858490	2929
EUR_49	10000	EUR	49039217	49084376	45159
EUR_49	10000	EUR	49720102	49982793	262691
EUR_49	10000	EUR	50079988	50086485	6497
EUR_49	10000	EUR	50097255	50255701	158446
EUR_49	10000	EUR	50651894	50675343	23449
EUR_49	10000	EUR	51819962	51826252	6290
EUR_49	10000	EUR	56981282	57026186	44904
EUR_49	10000	EUR	59749311	59778531	29220
EUR_49	10000	EUR	62482898	62546166	63268
EUR_49	10000	EUR	62570596	62648920	78324
EUR_49	10000	EUR	62707428	62877379	169951
EUR_49	10000	EUR	63007192	63107506	100314
EUR_49	10000	EUR	64689850	64699331	9481
EUR_49	10000	EUR	64928401	64968332	39931
EUR_49	10000	EUR	66848687	66882708	34021
EUR_49	10000	EUR	67516377	67550551	34174
EUR_49	10000	EUR	67890847	67938542	47695
EUR_49	10000	EUR	68109254	68234683	125429
EUR_49	10000	EUR	74704171	74756907	52736
EUR_49	10000	EUR	79970884	79977985	7101
EUR_49	10000	EUR	80817797	80831869	14072
EUR_49	10000	EUR	80947447	80965346	17899
EUR_49	10000	EUR	84307433	84331408	23975
EUR_49	10000	EUR	85051489	85157686	106197
EUR_49	10000	EUR	87004058	87035154	31096
EUR_49	10000	EUR	88020002	88073004	53002
EUR_49	10000	EUR	89233989	89360109	126120
EUR_49	10000	EUR	92520516	92580187	59671
EUR_49	10000	EUR	96252522	96313082	60560
EUR_49	10000	EUR	96752356	96969240	216884
EUR_49	10000	EUR	97227283	97229983	2700
EUR_49	10000	EUR	97398476	97442009	43533
EUR_49	10000	EUR	97516792	97575825	59033
EUR_49	10000	EUR	196934	206962	10028
EUR_49	10000	EUR	1443312	1474375	31063
EUR_49	10000	EUR	2267390	2417674	150284
EUR_49	10000	EUR	8846483	8958572	112089
EUR_49	10000	EUR	10310816	10435263	124447
EUR_49	10000	EUR	11155402	11182816	27414
EUR_49	10000	EUR	11309495	11324870	15375
EUR_49	10000	EUR	12405520	12614071	208551
EUR_49	10000	EUR	12957537	13085270	127733
EUR_49	10000	EUR	14760094	14813343	53249
EUR_49	10000	EUR	15678424	15834274	155850
EUR_49	10000	EUR	19373385	19430386	57001
EUR_49	10000	EUR	19637776	19677675	39899
EUR_49	10000	EUR	19771179	19815522	44343
EUR_49	10000	EUR	27030183	27120057	89874
EUR_49	10000	EUR	28447913	28454759	6846
EUR_49	10000	EUR	29342204	29344643	2439
EUR_49	10000	EUR	29885100	30020785	135685
EUR_49	10000	EUR	33352525	33355723	3198
EUR_49	10000	EUR	35842665	36017172	174507
EUR_49	10000	EUR	39871917	39913649	41732
EUR_49	10000	EUR	41190630	41244487	53857
EUR_49	10000	EUR	45261940	45295441	33501
EUR_49	10000	EUR	46254910	46287015	32105
EUR_49	10000	EUR	47616446	47655444	38998
EUR_49	10000	EUR	47729196	47760170	30974
EUR_49	10000	EUR	47917773	48089703	171930
EUR_49	10000	EUR	48974035	48976390	2355
EUR_49	10000	EUR	49039217	49084376	45159
EUR_49	10000	EUR	49108894	49211922	103028
EUR_49	10000	EUR	49716678	49823430	106752
EUR_49	10000	EUR	50079988	50086485	6497
EUR_49	10000	EUR	50097255	50255701	158446
EUR_49	10000	EUR	50651894	50675343	23449
EUR_49	10000	EUR	54352751	54424698	71947
EUR_49	10000	EUR	59025323	59087449	62126
EUR_49	10000	EUR	62583575	62662553	78978
EUR_49	10000	EUR	62808211	62809146	935
EUR_49	10000	EUR	63010595	63041174	30579
EUR_49	10000	EUR	63189307	63277354	88047
EUR_49	10000	EUR	63345194	63367008	21814
EUR_49	10000	EUR	67516377	67558609	42232
EUR_49	10000	EUR	67890847	68012425	121578
EUR_49	10000	EUR	68186638	68219989	33351
EUR_49	10000	EUR	68543110	68564643	21533
EUR_49	10000	EUR	70178120	70180545	2425
EUR_49	10000	EUR	71334879	71336069	1190
EUR_49	10000	EUR	75164494	75227717	63223
EUR_49	10000	EUR	80903139	80932876	29737
EUR_49	10000	EUR	81329834	81397143	67309
EUR_49	10000	EUR	84307433	84457650	150217
EUR_49	10000	EUR	84596514	84597943	1429
EUR_49	10000	EUR	96344658	96478190	133532
EUR_49	10000	EUR	96599275	96652091	52816
EUR_49	10000	EUR	96652259	96688015	35756
EUR_49	10000	EUR	96906437	96969240	62803
EUR_49	10000	EUR	97149005	97170445	21440
EUR_49	10000	EUR	97516792	97544370	27578
EUR_50	10000	EUR	7764477	7852331	87854
EUR_50	10000	EUR	11741022	11836160	95138
EUR_50	10000	EUR	12414121	12471082	56961
EUR_50	10000	EUR	12517970	12571424	53454
EUR_50	10000	EUR	12992001	13029529	37528
EUR_50	10000	EUR	13853765	13899355	45590
EUR_50	10000	EUR	15617938	15689350	71412
EUR_50	10000	EUR	15954482	16019493	65011
EUR_50	10000	EUR	19445931	19447994	2063
EUR_50	10000	EUR	19720323	19815522	95199
EUR_50	10000	EUR	21164886	21168829	3943
EUR_50	10000	EUR	23793798	23916509	122711
EUR_50	10000	EUR	29885100	30020785	135685
EUR_50	10000	EUR	31069796	31225571	155775
EUR_50	10000	EUR	31340450	31464998	124548
EUR_50	10000	EUR	31934278	31976562	42284
EUR_50	10000	EUR	43768000	43770888	2888
EUR_50	10000	EUR	44299125	44431264	132139
EUR_50	10000	EUR	44991454	45007478	16024
EUR_50	10000	EUR	46644585	46646042	1457
EUR_50	10000	EUR	49039217	49084376	45159
EUR_50	10000	EUR	49108894	49211922	103028
EUR_50	10000	EUR	49423645	49451224	27579
EUR_50	10000	EUR	49720102	50108086	387984
EUR_50	10000	EUR	50287644	50340188	52544
EUR_50	10000	EUR	55663984	55704084	40100
EUR_50	10000	EUR	55891681	55921875	30194
EUR_50	10000	EUR	62781664	62797882	16218
EUR_50	10000	EUR	62860595	63151646	291051
EUR_50	10000	EUR	63974015	64060264	86249
EUR_50	10000	EUR	64939632	64968332	28700
EUR_50	10000	EUR	67796826	68012425	215599
EUR_50	10000	EUR	70178120	70180545	2425
EUR_50	10000	EUR	73164377	73165766	1389
EUR_50	10000	EUR	76219599	76223870	4271
EUR_50	10000	EUR	78278359	78281355	2996
EUR_50	10000	EUR	82779823	82867077	87254
EUR_50	10000	EUR	86340983	86466441	125458
EUR_50	10000	EUR	92837215	92870243	33028
EUR_50	10000	EUR	96230890	96320937	90047
EUR_50	10000	EUR	9913	16835	6922
EUR_50	10000	EUR	305536	317557	12021
EUR_50	10000	EUR	5865668	5971269	105601
EUR_50	10000	EUR	8062404	8069680	7276
EUR_50	10000	EUR	10328334	10351635	23301
EUR_50	10000	EUR	10475874	10559629	83755
EUR_50	10000	EUR	12199512	12247078	47566
EUR_50	10000	EUR	12607169	12649905	42736
EUR_50	10000	EUR	16387387	16444740	57353
EUR_50	10000	EUR	19373601	19465227	91626
EUR_50	10000	EUR	20934893	20952589	17696
EUR_50	10000	EUR	21381193	21413207	32014
EUR_50	10000	EUR	23507155	23578786	71631
EUR_50	10000	EUR	30838706	30960757	122051
EUR_50	10000	EUR	31340450	31432165	91715
EUR_50	10000	EUR	31869080	31976562	107482
EUR_50	10000	EUR	40927141	41034990	107849
EUR_50	10000	EUR	43690494	43703982	13488
EUR_50	10000	EUR	44253582	44296925	43343
EUR_50	10000	EUR	48793399	48832663	39264
EUR_50	10000	EUR	49807803	49877351	69548
EUR_50	10000	EUR	50214714	50344415	129701
EUR_50	10000	EUR	56642327	56661029	18702
EUR_50	10000	EUR	59025323	59087449	62126
EUR_50	10000	EUR	60541769	60585416	43647
EUR_50	10000	EUR	60587632	60595221	7589
EUR_50	10000	EUR	60836692	60901803	65111
EUR_50	10000	EUR	62292834	62367041	74207
EUR_50	10000	EUR	62489657	62546166	56509
EUR_50	10000	EUR	62872963	62886738	13775
EUR_50	10000	EUR	64635938	64775972	140034
EUR_50	10000	EUR	68201188	68219989	18801
EUR_50	10000	EUR	69253738	69280158	26420
EUR_50	10000	EUR	70459841	70471952	12111
EUR_50	10000	EUR	72374762	72393031	18269
EUR_50	10000	EUR	73164377	73261259	96882
EUR_50	10000	EUR	73483646	73508952	25306
EUR_50	10000	EUR	74609427	74738201	128774
EUR_50	10000	EUR	78626655	78660130	33475
EUR_50	10000	EUR	80817797	80831869	14072
EUR_50	10000	EUR	80947447	80965346	17899
EUR_50	10000	EUR	81329834	81395863	66029
EUR_50	10000	EUR	84307433	84476006	168573
EUR_50	10000	EUR	86446184	86468527	22343
EUR_50	10000	EUR	93588756	93660617	71861
EUR_50	10000	EUR	95645847	95658276	12429
EUR_50	10000	EUR	96949071	96969240	20169
EUR_51	0	EUR	1443312	1474375	31063
EUR_51	0	EUR	7801499	8034150	232651
EUR_51	0	EUR	14713216	14731414	18198
EUR_51	0	EUR	14834975	14884113	49138
EUR_51	0	EUR	15571100	15608201	37101
EUR_51	0	EUR	17029181	17031678	2497
EUR_51	0	EUR	17270851	17280159	9308
EUR_51	0	EUR	19373385	19430386	57001
EUR_51	0	EUR	19602987	19651006	48019
EUR_51	0	EUR	21164886	21168829	3943
EUR_51	0	EUR	21224562	21230787	6225
EUR_51	0	EUR	21282427	21309916	27489
EUR_51	0	EUR	21406424	21582697	176273
EUR_51	0	EUR	21747694	21774213	26519
EUR_51	0	EUR	24662518	24693848	31330
EUR_51	0	EUR	27612645	27651507	38862
EUR_51	0	EUR	29750374	29765658	15284
EUR_51	0	EUR	30085525	30116933	31408
EUR_51	0	EUR	30548261	30559727	11466
EUR_51	0	EUR	43750662	43785095	34433
EUR_51	0	EUR	46603480	46692826	89346
EUR_51	0	EUR	46859500	46939223	79723
EUR_51	0	EUR	47616446	47655444	38998
EUR_51	0	EUR	47729196	47760170	30974
EUR_51	0	EUR	47917773	48089703	171930
EUR_51	0	EUR	48181642	48205062	23420
EUR_51	0	EUR	48276995	48322546	45551
EUR_51	0	EUR	48828898	48852598	23700
EUR_51	0	EUR	49063282	49170836	107554
EUR_51	0	EUR	49716678	49797331	80653
EUR_51	0	EUR	49816501	50150613	334112
EUR_51	0	EUR	50292505	50340188	47683
EUR_51	0	EUR	50474678	50560553	85875
EUR_51	0	EUR	50644699	50682125	37426
EUR_51	0	EUR	55925348	55926399	1051
EUR_51	0	EUR	60697771	60713933	16162
EUR_51	0	EUR	62635211	62648920	13709
EUR_51	0	EUR	62707428	62828758	121330
EUR_51	0	EUR	64162479	64213081	50602
EUR_51	0	EUR	64569161	64602184	33023
EUR_51	0	EUR	66827940	66897711	69771
EUR_51	0	EUR	67683259	67732388	49129
EUR_51	0	EUR	67796826	67897086	100260
EUR_51	0	EUR	68098959	68113243	14284
EUR_51	0	EUR	69262441	69296795	34354
EUR_51	0	EUR	70459841	70471952	12111
EUR_51	0	EUR	70490827	70504344	13517
EUR_51	0	EUR	71501268	71509363	8095
EUR_51	0	EUR	74270667	74332051	61384
EUR_51	0	EUR	74704171	74781759	77588
EUR_51	0	EUR	74791668	74797490	5822
EUR_51	0	EUR	80106200	80125347	19147
EUR_51	0	EUR	80903139	80961424	58285
EUR_51	0	EUR	84271016	84413705	142689
EUR_51	0	EUR	85095833	85104111	8278
EUR_51	0	EUR	92520516	92580187	59671
EUR_51	0	EUR	92728134	92911223	183089
EUR_51	0	EUR	93177388	93225072	47684
EUR_51	0	EUR	96344658	96551349	206691
EUR_51	0	EUR	96628171	96660713	32542
EUR_51	0	EUR	96681114	96688015	6901
EUR_51	0	EUR	96935175	96957114	21939
EUR_51	0	EUR	97516792	97575825	59033
EUR_51	0	EUR	1443312	1474375	31063
EUR_51	0	EUR	2267390	2385052	117662
EUR_51	0	EUR	4152972	4155031	2059
EUR_51	0	EUR	7801499	8034150	232651
EUR_51	0	EUR	10310816	10377560	66744
EUR_51	0	EUR	11747221	11784014	36793
EUR_51	0	EUR	12959122	12973343	14221
EUR_51	0	EUR	14713216	14731414	18198
EUR_51	0	EUR	15610665	15740215	129550
EUR_51	0	EUR	17203552	17323735	120183
EUR_51	0	EUR	21282427	21407839	125412
EUR_51	0	EUR	21737927	21766730	28803
EUR_51	0	EUR	23626899	23638658	11759
EUR_51	0	EUR	23841284	23992422	151138
EUR_51	0	EUR	24532214	24693848	161634
EUR_51	0	EUR	29255894	29403219	147325
EUR_51	0	EUR	29885100	30020785	135685
EUR_51	0	EUR	30838706	30842964	4258
EUR_51	0	EUR	30865475	30888971	23496
EUR_51	0	EUR	31028668	31136194	107526
EUR_51	0	EUR	31250345	31265497	15152
EUR_51	0	EUR	31353256	31389551	36295
EUR_51	0	EUR	31869080	31878432	9352
EUR_51	0	EUR	32040761	32043285	2524
EUR_51	0	EUR	35825437	35904356	78919
EUR_51	0	EUR	40975976	40977328	1352
EUR_51	0	EUR	41006007	41034990	28983
EUR_51	0	EUR	43298198	43308912	10714
EUR_51	0	EUR	43751615	43813419	61804
EUR_51	0	EUR	44182199	44210284	28085
EUR_51	0	EUR	44289775	44376469	86694
EUR_51	0	EUR	44486264	44569851	83587
EUR_51	0	EUR	45023383	45093802	70419
EUR_51	0	EUR	46821026	46854432	33406
EUR_51	0	EUR	49039217	49084376	45159
EUR_51	0	EUR	49135738	49184575	48837
EUR_51	0	EUR	49396758	49409796	13038
EUR_51	0	EUR	49482251	49501602	19351
EUR_51	0	EUR	49641162	49707032	65870
EUR_51	0	EUR	49720102	49900687	180585
EUR_51	0	EUR	50214714	50260453	45739
EUR_51	0	EUR	50446207	50450081	3874
EUR_51	0	EUR	50645711	50682125	36414
EUR_51	0	EUR	51767197	51826252	59055
EUR_51	0	EUR	54482373	54485919	3546
EUR_51	0	EUR	59025323	59087449	62126
EUR_51	0	EUR	59749311	59778531	29220
EUR_51	0	EUR	60314986	60335172	20186
EUR_51	0	EUR	62499163	62511197	12034
EUR_51	0	EUR	64699193	64699609	416
EUR_51	0	EUR	66870916	66900890	29974
EUR_51	0	EUR	67233773	67246845	13072
EUR_51	0	EUR	67683259	67732388	49129
EUR_51	0	EUR	67796826	67809401	12575
EUR_51	0	EUR	68014994	68056363	41369
EUR_51	0	EUR	68153010	68234683	81673
EUR_51	0	EUR	69253738	69254774	1036
EUR_51	0	EUR	69262441	69296795	34354
EUR_51	0	EUR	71108569	71258872	150303
EUR_51	0	EUR	71343782	71387487	43705
EUR_51	0	EUR	74070851	74226288	155437
EUR_51	0	EUR	74345860	74386200	40340
EUR_51	0	EUR	74609427	74689986	80559
EUR_51	0	EUR	74695445	74723577	28132
EUR_51	0	EUR	76219599	76292558	72959
EUR_51	0	EUR	80903139	80943322	40183
EUR_51	0	EUR	84349720	84414420	64700
EUR_51	0	EUR	85051489	85104111	52622
EUR_51	0	EUR	89233989	89353223	119234
EUR_51	0	EUR	92657968	92893775	235807
EUR_51	0	EUR	96252522	96313082	60560
EUR_51	0	EUR	96599275	96652091	52816
EUR_51	0	EUR	96652259	96688015	35756
EUR_51	0	EUR	96934735	96969240	34505
EUR_51	0	EUR	97149005	97170445	21440
EUR_52	0	EUR	7915705	8034150	118445
EUR_52	0	EUR	10527272	10559629	32357
EUR_52	0	EUR	11221129	11267811	46682
EUR_52	0	EUR	14713216	14884113	170897
EUR_52	0	EUR	14897229	14909313	12084
EUR_52	0	EUR	17270851	17304430	33579
EUR_52	0	EUR	17318810	17323735	4925
EUR_52	0	EUR	19373385	19430386	57001
EUR_52	0	EUR	19602987	19651006	48019
EUR_52	0	EUR	21737927	21914523	176596
EUR_52	0	EUR	23697124	23853580	156456
EUR_52	0	EUR	29152773	29190448	37675
EUR_52	0	EUR	29201265	29403219	201954
EUR_52	0	EUR	31203931	31261283	57352
EUR_52	0	EUR	31270356	31294111	23755
EUR_52	0	EUR	31336316	31349680	13364
EUR_52	0	EUR	39871169	39913649	42480
EUR_52	0	EUR	41241594	41341058	99464
EUR_52	0	EUR	41449292	41503009	53717
EUR_52	0	EUR	43751615	43813419	61804
EUR_52	0	EUR	44367887	44431264	63377
EUR_52	0	EUR	45919475	46077353	157878
EUR_52	0	EUR	46202405	46222689	20284
EUR_52	0	EUR	47874821	48177386	302565
EUR_52	0	EUR	48794122	48832663	38541
EUR_52	0	EUR	48974035	49018779	44744
EUR_52	0	EUR	49051657	49139016	87359
EUR_52	0	EUR	49716678	49806831	90153
EUR_52	0	EUR	50040990	50056894	15904
EUR_52	0	EUR	50079988	50086485	6497
EUR_52	0	EUR	50125413	50133902	8489
EUR_52	0	EUR	50167278	50340188	172910
EUR_52	0	EUR	51821757	51826252	4495
EUR_52	0	EUR	54377615	54392996	15381
EUR_52	0	EUR	59025323	59087449	62126
EUR_52	0	EUR	60360602	60623780	263178
EUR_52	0	EUR	62499163	62511197	12034
EUR_52	0	EUR	63354466	63517969	163503
EUR_52	0	EUR	64559645	64648825	89180
EUR_52	0	EUR	64891225	64968332	77107
EUR_52	0	EUR	66848687	66882708	34021
EUR_52	0	EUR	66966267	66984748	18481
EUR_52	0	EUR	67996165	68234683	238518
EUR_52	0	EUR	71501268	71509363	8095
EUR_52	0	EUR	72374762	72393031	18269
EUR_52	0	EUR	74276519	74289152	12633
EUR_52	0	EUR	78278359	78281355	2996
EUR_52	0	EUR	79759746	79763512	3766
EUR_52	0	EUR	84316084	84413705	97621
EUR_52	0	EUR	84485337	84585518	100181
EUR_52	0	EUR	84695221	84748669	53448
EUR_52	0	EUR	87105110	87192258	87148
EUR_52	0	EUR	88131499	88235236	103737
EUR_52	0	EUR	92821323	92870243	48920
EUR_52	0	EUR	95593010	95631393	38383
EUR_52	0	EUR	96719722	96818450	98728
EUR_52	0	EUR	97100087	97133265	33178
EUR_52	0	EUR	10314774	10351635	36861
EUR_52	0	EUR	11221129	11260836	39707
EUR_52	0	EUR	13845423	13899355	53932
EUR_52	0	EUR	15686234	15701244	15010
EUR_52	0	EUR	15783892	15918595	134703
EUR_52	0	EUR	17287888	17302285	14397
EUR_52	0	EUR	21735053	21774213	39160
EUR_52	0	EUR	29871842	29884548	12706
EUR_52	0	EUR	30678684	30730344	51660
EUR_52	0	EUR	30931120	31214224	283104
EUR_52	0	EUR	31321108	31349680	28572
EUR_52	0	EUR	31869080	31976562	107482
EUR_52	0	EUR	32453173	32511362	58189
EUR_52	0	EUR	43750662	43756156	5494
EUR_52	0	EUR	44915345	45093802	178457
EUR_52	0	EUR	45395889	45413157	17268
EUR_52	0	EUR	47874821	48095137	220316
EUR_52	0	EUR	48793399	48804986	11587
EUR_52	0	EUR	48980390	48992275	11885
EUR_52	0	EUR	49107941	49211922	103981
EUR_52	0	EUR	49641162	49707032	65870
EUR_52	0	EUR	49938053	49958565	20512
EUR_52	0	EUR	50244656	50300721	56065
EUR_52	0	EUR	50476481	50591506	115025
EUR_52	0	EUR	50596635	50675343	78708
EUR_52	0	EUR	53185452	53248662	63210
EUR_52	0	EUR	54327238	54429543	102305
EUR_52	0	EUR	54447874	54485919	38045
EUR_52	0	EUR	59025323	59087449	62126
EUR_52	0	EUR	60445678	60623780	178102
EUR_52	0	EUR	60680189	60703119	22930
EUR_52	0	EUR	62363965	62421852	57887
EUR_52	0	EUR	62489657	62534250	44593
EUR_52	0	EUR	62809352	62877379	68027
EUR_52	0	EUR	63007192	63107506	100314
EUR_52	0	EUR	63272864	63277354	4490
EUR_52	0	EUR	63345194	63367008	21814
EUR_52	0	EUR	64642406	64648825	6419
EUR_52	0	EUR	67720425	67747325	26900
EUR_52	0	EUR	67947267	68008460	61193
EUR_52	0	EUR	69283092	69303278	20186
EUR_52	0	EUR	70425266	70432857	7591
EUR_52	0	EUR	72313374	72338979	25605
EUR_52	0	EUR	74185839	74211177	25338
EUR_52	0	EUR	80903139	80932876	29737
EUR_52	0	EUR	81329834	81397143	67309
EUR_52	0	EUR	81849638	81865042	15404
EUR_52	0	EUR	84088018	84136758	48740
EUR_52	0	EUR	84271016	84413705	142689
EUR_52	0	EUR	85095833	85104111	8278
EUR_52	0	EUR	96454365	96464200	9835
EUR_52	0	EUR	97587852	97606042	18190
EUR_53	0	EUR	1658	38454	36796
EUR_53	0	EUR	149110	262455	113345
EUR_53	0	EUR	668948	697581	28633
EUR_53	0	EUR	5641307	5720427	79120
EUR_53	0	EUR	7801499	7829292	27793
EUR_53	0	EUR	10510641	10525722	15081
EUR_53	0	EUR	12436919	12462344	25425
EUR_53	0	EUR	12467549	12504242	36693
EUR_53	0	EUR	12801626	12870468	68842
EUR_53	0	EUR	14793913	14884113	90200
EUR_53	0	EUR	15678424	15702000	23576
EUR_53	0	EUR	15896526	15959302	62776
EUR_53	0	EUR	16026709	16040274	13565
EUR_53	0	EUR	21728654	21914523	185869
EUR_53	0	EUR	23507155	23562645	55490
EUR_53	0	EUR	23697124	23766373	69249
EUR_53	0	EUR	23961681	24026895	65214
EUR_53	0	EUR	28447913	28459172	11259
EUR_53	0	EUR	30528228	30561025	32797
EUR_53	0	EUR	30838706	30998466	159760
EUR_53	0	EUR	31048766	31088907	40141
EUR_53	0	EUR	31127128	31197466	70338
EUR_53	0	EUR	33352525	33355723	3198
EUR_53	0	EUR	35825437	35904356	78919
EUR_53	0	EUR	37432565	37455443	22878
EUR_53	0	EUR	39544730	39545103	373
EUR_53	0	EUR	43750662	43785095	34433
EUR_53	0	EUR	45948492	46017088	68596
EUR_53	0	EUR	46150248	46222689	72441
EUR_53	0	EUR	46516146	46626803	110657
EUR_53	0	EUR	47624392	47645619	21227
EUR_53	0	EUR	48152063	48182054	29991
EUR_53	0	EUR	48273976	48310647	36671
EUR_53	0	EUR	48828898	48852598	23700
EUR_53	0	EUR	48974035	49018779	44744
EUR_53	0	EUR	49051657	49139016	87359
EUR_53	0	EUR	49756462	50004887	248425
EUR_53	0	EUR	50095974	50145645	49671
EUR_53	0	EUR	50151559	50169892	18333
EUR_53	0	EUR	50472069	50516476	44407
EUR_53	0	EUR	50654897	50675343	20446
EUR_53	0	EUR	56646775	56670627	23852
EUR_53	0	EUR	60314986	60406009	91023
EUR_53	0	EUR	60675915	60703119	27204
EUR_53	0	EUR	62336325	62520941	184616
EUR_53	0	EUR	62652479	62657080	4601
EUR_53	0	EUR	64635938	64775972	140034
EUR_53	0	EUR	66932986	66984748	51762
EUR_53	0	EUR	67720425	67747325	26900
EUR_53	0	EUR	68053923	68056363	2440
EUR_53	0	EUR	68511938	68564643	52705
EUR_53	0	EUR	70314329	70323506	9177
EUR_53	0	EUR	74704171	74781759	77588
EUR_53	0	EUR	76219599	76292558	72959
EUR_53	0	EUR	80346144	80378472	32328
EUR_53	0	EUR	80903139	80932876	29737
EUR_53	0	EUR	81329834	81344715	14881
EUR_53	0	EUR	84176428	84340938	164510
EUR_53	0	EUR	84465074	84476006	10932
EUR_53	0	EUR	84706861	84737569	30708
EUR_53	0	EUR	86252507	86262769	10262
EUR_53	0	EUR	87069518	87192258	122740
EUR_53	0	EUR	89233989	89360109	126120
EUR_53	0	EUR	96344658	96403383	58725
EUR_53	0	EUR	97149005	97154451	5446
EUR_53	0	EUR	97772967	97850405	77438
EUR_53	0	EUR	10607	24714	14107
EUR_53	0	EUR	1349318	1525674	176356
EUR_53	0	EUR	5538353	5560949	22596
EUR_53	0	EUR	5948579	5963046	14467
EUR_53	0	EUR	7801499	7986175	184676
EUR_53	0	EUR	11221129	11260836	39707
EUR_53	0	EUR	11267672	11267811	139
EUR_53	0	EUR	12199512	12255463	55951
EUR_53	0	EUR	12436919	12518164	81245
EUR_53	0	EUR	12541608	12571424	29816
EUR_53	0	EUR	12959122	12989272	30150
EUR_53	0	EUR	16289550	16444740	155190
EUR_53	0	EUR	16960554	17115665	155111
EUR_53	0	EUR	17270851	17304430	33579
EUR_53	0	EUR	17318810	17323735	4925
EUR_53	0	EUR	17917703	17924864	7161
EUR_53	0	EUR	21218489	21221838	3349
EUR_53	0	EUR	21453345	21582697	129352
EUR_53	0	EUR	21728654	21914523	185869
EUR_53	0	EUR	23697124	23698161	1037
EUR_53	0	EUR	26970296	27028137	57841
EUR_53	0	EUR	29368986	29369784	798
EUR_53	0	EUR	29885100	30020785	135685
EUR_53	0	EUR	30678684	30730344	51660
EUR_53	0	EUR	30953172	30973126	19954
EUR_53	0	EUR	31340450	31464998	124548
EUR_53	0	EUR	43321108	43338312	17204
EUR_53	0	EUR	43750662	43785095	34433
EUR_53	0	EUR	45980594	46044606	64012
EUR_53	0	EUR	46135355	46167330	31975
EUR_53	0	EUR	46345940	46424629	78689
EUR_53	0	EUR	46603480	46692826	89346
EUR_53	0	EUR	46958473	46998835	40362
EUR_53	0	EUR	47665280	47665590	310
EUR_53	0	EUR	48828898	48852598	23700
EUR_53	0	EUR	48974035	49018779	44744
EUR_53	0	EUR	49051657	49139016	87359
EUR_53	0	EUR	50256105	50340188	84083
EUR_53	0	EUR	50405806	50516476	110670
EUR_53	0	EUR	50614311	50675343	61032
EUR_53	0	EUR	52677619	52686699	9080
EUR_53	0	EUR	59025323	59087449	62126
EUR_53	0	EUR	60314986	60406009	91023
EUR_53	0	EUR	60675915	60703119	27204
EUR_53	0	EUR	62342991	62387917	44926
EUR_53	0	EUR	62516312	62539071	22759
EUR_53	0	EUR	63248927	63268388	19461
EUR_53	0	EUR	63530056	63669658	139602
EUR_53	0	EUR	64689850	64713211	23361
EUR_53	0	EUR	67516377	67558609	42232
EUR_53	0	EUR	67632239	67659453	27214
EUR_53	0	EUR	67731956	67788309	56353
EUR_53	0	EUR	67792851	67861249	68398
EUR_53	0	EUR	67913266	67948941	35675
EUR_53	0	EUR	68110006	68174085	64079
EUR_53	0	EUR	69253738	69254774	1036
EUR_53	0	EUR	69262441	69296795	34354
EUR_53	0	EUR	70314329	70323506	9177
EUR_53	0	EUR	79834311	79835487	1176
EUR_53	0	EUR	80903139	80932876	29737
EUR_53	0	EUR	81329834	81357575	27741
EUR_53	0	EUR	84213501	84243440	29939
EUR_53	0	EUR	84376065	84711576	335511
EUR_53	0	EUR	84762165	84809687	47522
EUR_53	0	EUR	86183232	86262769	79537
EUR_53	0	EUR	93177388	93227052	49664
EUR_53	0	EUR	96215188	96313082	97894
EUR_53	0	EUR	96375906	96391048	15142
EUR_53	0	EUR	96731151	96795126	63975
EUR_53	0	EUR	96935175	96957114	21939
EUR_53	0	EUR	97262803	97359151	96348
EUR_53	0	EUR	97591041	97621479	30438
EUR_54	0	EUR	0	38454	38454
EUR_54	0	EUR	1291609	1354736	63127
EUR_54	0	EUR	1443312	1465074	21762
EUR_54	0	EUR	4152972	4155031	2059
EUR_54	0	EUR	5865668	5885621	19953
EUR_54	0	EUR	7801499	8020825	219326
EUR_54	0	EUR	8846483	8874923	28440
EUR_54	0	EUR	11309495	11324870	15375
EUR_54	0	EUR	13096243	13098263	2020
EUR_54	0	EUR	13943659	14132248	188589
EUR_54	0	EUR	16960554	17098245	137691
EUR_54	0	EUR	21406424	21582697	176273
EUR_54	0	EUR	21611581	21691175	79594
EUR_54	0	EUR	23480055	23525224	45169
EUR_54	0	EUR	23678834	23696381	17547
EUR_54	0	EUR	23923937	24026948	103011
EUR_54	0	EUR	24662518	24693848	31330
EUR_54	0	EUR	27030183	27059311	29128
EUR_54	0	EUR	28447913	28454759	6846
EUR_54	0	EUR	30594989	30655575	60586
EUR_54	0	EUR	31213935	31267996	54061
EUR_54	0	EUR	39536610	39538252	1642
EUR_54	0	EUR	40952583	41034990	82407
EUR_54	0	EUR	43321108	43338312	17204
EUR_54	0	EUR	43750662	43785095	34433
EUR_54	0	EUR	45330879	45405355	74476
EUR_54	0	EUR	45980594	46033072	52478
EUR_54	0	EUR	47874821	48229330	354509
EUR_54	0	EUR	48793399	48804986	11587
EUR_54	0	EUR	49074315	49126531	52216
EUR_54	0	EUR	49860747	50004887	144140
EUR_54	0	EUR	50079988	50086485	6497
EUR_54	0	EUR	50215570	50299995	84425
EUR_54	0	EUR	59025323	59087449	62126
EUR_54	0	EUR	60360602	60623780	263178
EUR_54	0	EUR	62363965	62421852	57887
EUR_54	0	EUR	62584114	62820719	236605
EUR_54	0	EUR	62934893	62937501	2608
EUR_54	0	EUR	63392714	63488070	95356
EUR_54	0	EUR	64736659	64775972	39313
EUR_54	0	EUR	65401205	65439431	38226
EUR_54	0	EUR	67648499	67659453	10954
EUR_54	0	EUR	68003563	68012425	8862
EUR_54	0	EUR	68340349	68341913	1564
EUR_54	0	EUR	69230927	69303491	72564
EUR_54	0	EUR	71187459	71260612	73153
EUR_54	0	EUR	71501268	71509363	8095
EUR_54	0	EUR	72313374	72338979	25605
EUR_54	0	EUR	73164377	73165766	1389
EUR_54	0	EUR	74165046	74332051	167005
EUR_54	0	EUR	80903139	80904640	1501
EUR_54	0	EUR	80947447	80965346	17899
EUR_54	0	EUR	84074915	84136758	61843
EUR_54	0	EUR	84276859	84281776	4917
EUR_54	0	EUR	84664205	84683027	18822
EUR_54	0	EUR	88131499	88235236	103737
EUR_54	0	EUR	95594113	95706836	112723
EUR_54	0	EUR	96215188	96313082	97894
EUR_54	0	EUR	96344658	96391048	46390
EUR_54	0	EUR	96938041	96985749	47708
EUR_54	0	EUR	97149005	97170445	21440
EUR_54	0	EUR	97368034	97434688	66654
EUR_54	0	EUR	97516792	97606042	89250
EUR_54	0	EUR	0	24714	24714
EUR_54	0	EUR	1443312	1474375	31063
EUR_54	0	EUR	8038172	8074467	36295
EUR_54	0	EUR	8922196	8953694	31498
EUR_54	0	EUR	10162900	10265441	102541
EUR_54	0	EUR	10504963	10525722	20759
EUR_54	0	EUR	11221129	11260836	39707
EUR_54	0	EUR	13096243	13098263	2020
EUR_54	0	EUR	14820933	14884113	63180
EUR_54	0	EUR	15697742	15701244	3502
EUR_54	0	EUR	15701864	15740215	38351
EUR_54	0	EUR	17029181	17031678	2497
EUR_54	0	EUR	17270851	17280159	9308
EUR_54	0	EUR	19373385	19430386	57001
EUR_54	0	EUR	19602987	19651006	48019
EUR_54	0	EUR	21406424	21582697	176273
EUR_54	0	EUR	21747694	21774213	26519
EUR_54	0	EUR	23507155	23562645	55490
EUR_54	0	EUR	24664847	24693848	29001
EUR_54	0	EUR	25625985	25637091	11106
EUR_54	0	EUR	26802769	27028137	225368
EUR_54	0	EUR	29378628	29403219	24591
EUR_54	0	EUR	29900404	29906215	5811
EUR_54	0	EUR	40937544	41034990	97446
EUR_54	0	EUR	43321108	43338312	17204
EUR_54	0	EUR	43750662	43785095	34433
EUR_54	0	EUR	44627203	44632425	5222
EUR_54	0	EUR	45023383	45093802	70419
EUR_54	0	EUR	46345940	46401248	55308
EUR_54	0	EUR	46557983	46563256	5273
EUR_54	0	EUR	48206458	48284798	78340
EUR_54	0	EUR	48980390	49018727	38337
EUR_54	0	EUR	49720102	50004887	284785
EUR_54	0	EUR	50123518	50340188	216670
EUR_54	0	EUR	51721135	51826252	105117
EUR_54	0	EUR	54262700	54290924	28224
EUR_54	0	EUR	56606415	56607009	594
EUR_54	0	EUR	56981282	57026186	44904
EUR_54	0	EUR	60697771	60713933	16162
EUR_54	0	EUR	60836692	60850995	14303
EUR_54	0	EUR	62336325	62520941	184616
EUR_54	0	EUR	62771027	62777510	6483
EUR_54	0	EUR	63010595	63041174	30579
EUR_54	0	EUR	63177292	63258025	80733
EUR_54	0	EUR	63354466	63392700	38234
EUR_54	0	EUR	64559645	64615923	56278
EUR_54	0	EUR	64689850	64713211	23361
EUR_54	0	EUR	64779628	64878760	99132
EUR_54	0	EUR	67257538	67343411	85873
EUR_54	0	EUR	67648499	67659453	10954
EUR_54	0	EUR	67946890	68012470	65580
EUR_54	0	EUR	68130778	68170606	39828
EUR_54	0	EUR	69253738	69280158	26420
EUR_54	0	EUR	73164377	73165766	1389
EUR_54	0	EUR	74185839	74211177	25338
EUR_54	0	EUR	76219599	76223870	4271
EUR_54	0	EUR	78630900	78660130	29230
EUR_54	0	EUR	80903139	80961424	58285
EUR_54	0	EUR	82779823	82867077	87254
EUR_54	0	EUR	84307433	84457650	150217
EUR_54	0	EUR	84483013	84508973	25960
EUR_54	0	EUR	93177388	93217929	40541
EUR_54	0	EUR	96599275	96610701	11426
EUR_54	0	EUR	96719722	96818450	98728
EUR_54	0	EUR	97799580	97850405	50825
EUR_55	0	EUR	0	38454	38454
EUR_55	0	EUR	2392450	2436497	44047
EUR_55	0	EUR	8022793	8069680	46887
EUR_55	0	EUR	10195098	10208942	13844
EUR_55	0	EUR	10477119	10515509	38390
EUR_55	0	EUR	11309495	11324870	15375
EUR_55	0	EUR	14713216	14731414	18198
EUR_55	0	EUR	15686234	15701244	15010
EUR_55	0	EUR	15783892	15879503	95611
EUR_55	0	EUR	16317541	16340550	23009
EUR_55	0	EUR	17026312	17091416	65104
EUR_55	0	EUR	19391339	19454354	63015
EUR_55	0	EUR	20614422	20624593	10171
EUR_55	0	EUR	23697124	23853580	156456
EUR_55	0	EUR	26757616	26784665	27049
EUR_55	0	EUR	29871842	29884548	12706
EUR_55	0	EUR	29981453	29982875	1422
EUR_55	0	EUR	30838706	31006796	168090
EUR_55	0	EUR	31342564	31464998	122434
EUR_55	0	EUR	39871169	39913649	42480
EUR_55	0	EUR	40975976	40983002	7026
EUR_55	0	EUR	41082532	41134854	52322
EUR_55	0	EUR	41323968	41330550	6582
EUR_55	0	EUR	43273165	43340494	67329
EUR_55	0	EUR	43776270	43805520	29250
EUR_55	0	EUR	45292333	45305694	13361
EUR_55	0	EUR	46238893	46318055	79162
EUR_55	0	EUR	48216505	48237148	20643
EUR_55	0	EUR	48988140	49229729	241589
EUR_55	0	EUR	49953599	50204377	250778
EUR_55	0	EUR	50287644	50340188	52544
EUR_55	0	EUR	54156560	54190763	34203
EUR_55	0	EUR	54241431	54273354	31923
EUR_55	0	EUR	55365672	55376432	10760
EUR_55	0	EUR	55925348	55926399	1051
EUR_55	0	EUR	59025323	59087449	62126
EUR_55	0	EUR	60314986	60406009	91023
EUR_55	0	EUR	62707428	62886738	179310
EUR_55	0	EUR	64736659	64775972	39313
EUR_55	0	EUR	70459841	70471952	12111
EUR_55	0	EUR	71108569	71231131	122562
EUR_55	0	EUR	74165046	74332051	167005
EUR_55	0	EUR	79834311	79835487	1176
EUR_55	0	EUR	80903139	80932876	29737
EUR_55	0	EUR	81329834	81357575	27741
EUR_55	0	EUR	84174413	84347352	172939
EUR_55	0	EUR	84385265	84423669	38404
EUR_55	0	EUR	84779402	84859626	80224
EUR_55	0	EUR	85089469	85104111	14642
EUR_55	0	EUR	87946387	87992882	46495
EUR_55	0	EUR	88992283	89057856	65573
EUR_55	0	EUR	96935175	96957114	21939
EUR_55	0	EUR	97398476	97442009	43533
EUR_55	0	EUR	97516792	97606042	89250
EUR_55	0	EUR	1443312	1474375	31063
EUR_55	0	EUR	5726744	5741613	14869
EUR_55	0	EUR	5914836	5971269	56433
EUR_55	0	EUR	8943880	8958572	14692
EUR_55	0	EUR	10162900	10351635	188735
EUR_55	0	EUR	11309495	11324870	15375
EUR_55	0	EUR	12541608	12571424	29816
EUR_55	0	EUR	13879741	13899355	19614
EUR_55	0	EUR	15711188	15740215	29027
EUR_55	0	EUR	17270851	17304430	33579
EUR_55	0	EUR	17318810	17323735	4925
EUR_55	0	EUR	19205162	19218710	13548
EUR_55	0	EUR	19445931	19447994	2063
EUR_55	0	EUR	21168069	21168829	760
EUR_55	0	EUR	21179486	21230787	51301
EUR_55	0	EUR	21282427	21309916	27489
EUR_55	0	EUR	21495136	21567089	71953
EUR_55	0	EUR	21935834	21965772	29938
EUR_55	0	EUR	23519809	23682065	162256
EUR_55	0	EUR	23793798	23870635	76837
EUR_55	0	EUR	25625985	25637091	11106
EUR_55	0	EUR	29255894	29345379	89485
EUR_55	0	EUR	30528228	30531547	3319
EUR_55	0	EUR	30550643	30641876	91233
EUR_55	0	EUR	31062988	31134052	71064
EUR_55	0	EUR	31190087	31216844	26757
EUR_55	0	EUR	31254911	31267996	13085
EUR_55	0	EUR	31340450	31398944	58494
EUR_55	0	EUR	41241594	41386596	145002
EUR_55	0	EUR	43690494	43703982	13488
EUR_55	0	EUR	45980594	46052925	72331
EUR_55	0	EUR	46600402	46692826	92424
EUR_55	0	EUR	47917773	47960163	42390
EUR_55	0	EUR	48163867	48177386	13519
EUR_55	0	EUR	48273976	48321534	47558
EUR_55	0	EUR	49063282	49170836	107554
EUR_55	0	EUR	50079988	50086485	6497
EUR_55	0	EUR	50292505	50340188	47683
EUR_55	0	EUR	50462409	50483962	21553
EUR_55	0	EUR	50537149	50675343	138194
EUR_55	0	EUR	53153857	53197187	43330
EUR_55	0	EUR	54570395	54580607	10212
EUR_55	0	EUR	60675915	60703119	27204
EUR_55	0	EUR	61977382	62000629	23247
EUR_55	0	EUR	63392714	63488070	95356
EUR_55	0	EUR	64736659	64775972	39313
EUR_55	0	EUR	65401205	65439431	38226
EUR_55	0	EUR	66900632	66900890	258
EUR_55	0	EUR	67099623	67136085	36462
EUR_55	0	EUR	67726807	67807658	80851
EUR_55	0	EUR	67993239	68079858	86619
EUR_55	0	EUR	68153010	68234683	81673
EUR_55	0	EUR	68501694	68528735	27041
EUR_55	0	EUR	69253738	69280158	26420
EUR_55	0	EUR	70314329	70323506	9177
EUR_55	0	EUR	70425266	70443249	17983
EUR_55	0	EUR	70459841	70471952	12111
EUR_55	0	EUR	74165046	74213902	48856
EUR_55	0	EUR	74294086	74332051	37965
EUR_55	0	EUR	74704171	74781759	77588
EUR_55	0	EUR	74791668	74797490	5822
EUR_55	0	EUR	84307433	84457650	150217
EUR_55	0	EUR	84483013	84508973	25960
EUR_55	0	EUR	87946387	87992882	46495
EUR_55	0	EUR	96215188	96313082	97894
EUR_55	0	EUR	96628171	96660713	32542
EUR_55	0	EUR	96681114	96688015	6901
EUR_55	0	EUR	96935175	96957114	21939
EUR_55	0	EUR	97670105	97737896	67791
EUR_56	0	EUR	10310816	10335227	24411
EUR_56	0	EUR	12436919	12462344	25425
EUR_56	0	EUR	12467549	12504242	36693
EUR_56	0	EUR	12801626	12870468	68842
EUR_56	0	EUR	13943659	13985521	41862
EUR_56	0	EUR	15678424	15702000	23576
EUR_56	0	EUR	15896526	15959302	62776
EUR_56	0	EUR	16026709	16040274	13565
EUR_56	0	EUR	17270851	17280159	9308
EUR_56	0	EUR	17917703	17924864	7161
EUR_56	0	EUR	19569358	19651006	81648
EUR_56	0	EUR	21489581	21543648	54067
EUR_56	0	EUR	23793798	23870635	76837
EUR_56	0	EUR	27041168	27059311	18143
EUR_56	0	EUR	29750374	29765658	15284
EUR_56	0	EUR	29981453	30020785	39332
EUR_56	0	EUR	31049866	31088907	39041
EUR_56	0	EUR	31127128	31197466	70338
EUR_56	0	EUR	32056141	32101976	45835
EUR_56	0	EUR	41698837	41768904	70067
EUR_56	0	EUR	43751615	43808041	56426
EUR_56	0	EUR	45919475	45922183	2708
EUR_56	0	EUR	45988603	45999654	11051
EUR_56	0	EUR	47588227	47619485	31258
EUR_56	0	EUR	47874821	47900802	25981
EUR_56	0	EUR	48793399	48804986	11587
EUR_56	0	EUR	48980390	48992275	11885
EUR_56	0	EUR	49107941	49211922	103981
EUR_56	0	EUR	49641162	49707032	65870
EUR_56	0	EUR	49724753	50108086	383333
EUR_56	0	EUR	50215570	50230993	15423
EUR_56	0	EUR	50499580	50600707	101127
EUR_56	0	EUR	55925348	55926399	1051
EUR_56	0	EUR	60314986	60366947	51961
EUR_56	0	EUR	60465746	60473482	7736
EUR_56	0	EUR	61977382	62000629	23247
EUR_56	0	EUR	62025489	62049844	24355
EUR_56	0	EUR	62328189	62360303	32114
EUR_56	0	EUR	62571477	62571923	446
EUR_56	0	EUR	62672738	62886738	214000
EUR_56	0	EUR	63156537	63182770	26233
EUR_56	0	EUR	63345194	63367008	21814
EUR_56	0	EUR	64213067	64326150	113083
EUR_56	0	EUR	66932986	66984748	51762
EUR_56	0	EUR	67729110	67747325	18215
EUR_56	0	EUR	68003563	68012425	8862
EUR_56	0	EUR	70314329	70323506	9177
EUR_56	0	EUR	71197734	71260612	62878
EUR_56	0	EUR	72313374	72338979	25605
EUR_56	0	EUR	73164377	73165766	1389
EUR_56	0	EUR	74614046	74797490	183444
EUR_56	0	EUR	79636078	79676585	40507
EUR_56	0	EUR	84051369	84087948	36579
EUR_56	0	EUR	84385265	84423669	38404
EUR_56	0	EUR	85095833	85104111	8278
EUR_56	0	EUR	87069518	87192258	122740
EUR_56	0	EUR	88067512	88235236	167724
EUR_56	0	EUR	92590099	92705931	115832
EUR_56	0	EUR	93179489	93227052	47563
EUR_56	0	EUR	93343223	93437672	94449
EUR_56	0	EUR	95127554	95186895	59341
EUR_56	0	EUR	96344658	96391048	46390
EUR_56	0	EUR	96496460	96545731	49271
EUR_56	0	EUR	96962941	96970993	8052
EUR_56	0	EUR	0	24714	24714
EUR_56	0	EUR	1443312	1474375	31063
EUR_56	0	EUR	12195294	12394574	199280
EUR_56	0	EUR	13017869	13029529	11660
EUR_56	0	EUR	13099541	13191657	92116
EUR_56	0	EUR	13845423	13859671	14248
EUR_56	0	EUR	14071365	14132248	60883
EUR_56	0	EUR	14713216	14731414	18198
EUR_56	0	EUR	15695543	15743283	47740
EUR_56	0	EUR	17067299	17105733	38434
EUR_56	0	EUR	19373820	19446442	72622
EUR_56	0	EUR	19490258	19640640	150382
EUR_56	0	EUR	20645018	20693514	48496
EUR_56	0	EUR	21869330	21914523	45193
EUR_56	0	EUR	23297565	23324559	26994
EUR_56	0	EUR	23626899	23638658	11759
EUR_56	0	EUR	27030183	27059311	29128
EUR_56	0	EUR	27563461	27803948	240487
EUR_56	0	EUR	29255894	29345379	89485
EUR_56	0	EUR	29900404	29906215	5811
EUR_56	0	EUR	30953172	30988149	34977
EUR_56	0	EUR	31329205	31367228	38023
EUR_56	0	EUR	31862751	31933275	70524
EUR_56	0	EUR	39481376	39516157	34781
EUR_56	0	EUR	40952583	41034990	82407
EUR_56	0	EUR	41698837	41704843	6006
EUR_56	0	EUR	43273165	43340494	67329
EUR_56	0	EUR	43751615	43808041	56426
EUR_56	0	EUR	44627203	44632425	5222
EUR_56	0	EUR	46345940	46348272	2332
EUR_56	0	EUR	46821026	46878762	57736
EUR_56	0	EUR	47874821	47900802	25981
EUR_56	0	EUR	49161242	49211922	50680
EUR_56	0	EUR	50123518	50198959	75441
EUR_56	0	EUR	50654897	50675343	20446
EUR_56	0	EUR	51721135	51826252	105117
EUR_56	0	EUR	55662959	55747582	84623
EUR_56	0	EUR	55892211	55943914	51703
EUR_56	0	EUR	56649097	56688585	39488
EUR_56	0	EUR	60675915	60703119	27204
EUR_56	0	EUR	60773332	60825923	52591
EUR_56	0	EUR	62172857	62323374	150517
EUR_56	0	EUR	62427365	62491526	64161
EUR_56	0	EUR	62516312	62546166	29854
EUR_56	0	EUR	62679237	62680258	1021
EUR_56	0	EUR	62714552	62844978	130426
EUR_56	0	EUR	63364127	63367008	2881
EUR_56	0	EUR	64642406	64648825	6419
EUR_56	0	EUR	66827940	66897711	69771
EUR_56	0	EUR	67469783	67484763	14980
EUR_56	0	EUR	68002714	68056363	53649
EUR_56	0	EUR	69253738	69254774	1036
EUR_56	0	EUR	69262441	69296795	34354
EUR_56	0	EUR	69976346	69993399	17053
EUR_56	0	EUR	70425266	70432857	7591
EUR_56	0	EUR	71187459	71214726	27267
EUR_56	0	EUR	71316162	71371297	55135
EUR_56	0	EUR	71411050	71427923	16873
EUR_56	0	EUR	72313374	72338979	25605
EUR_56	0	EUR	74609427	74738201	128774
EUR_56	0	EUR	76720252	76763688	43436
EUR_56	0	EUR	80307017	80378472	71455
EUR_56	0	EUR	80903139	80932876	29737
EUR_56	0	EUR	84176428	84340938	164510
EUR_56	0	EUR	84466844	84592202	125358
EUR_56	0	EUR	85119454	85157686	38232
EUR_56	0	EUR	93343223	93366866	23643
EUR_56	0	EUR	93627195	93686534	59339
EUR_56	0	EUR	95696854	95706836	9982
EUR_56	0	EUR	96344658	96391048	46390
EUR_56	0	EUR	96938041	96985749	47708
EUR_56	0	EUR	97149005	97170445	21440
EUR_56	0	EUR	97401837	97434688	32851
EUR_56	0	EUR	97516792	97548589	31797
EUR_56	0	EUR	97591041	97621479	30438
EUR_57	0	EUR	0	24714	24714
EUR_57	0	EUR	994187	1024498	30311
EUR_57	0	EUR	2343926	2436497	92571
EUR_57	0	EUR	10389120	10459835	70715
EUR_57	0	EUR	11309495	11324870	15375
EUR_57	0	EUR	12376950	12394574	17624
EUR_57	0	EUR	12517970	12541493	23523
EUR_57	0	EUR	15921301	16036609	115308
EUR_57	0	EUR	16235802	16340550	104748
EUR_57	0	EUR	16960554	17058271	97717
EUR_57	0	EUR	19211100	19218710	7610
EUR_57	0	EUR	19435723	19454354	18631
EUR_57	0	EUR	19519830	19634557	114727
EUR_57	0	EUR	19720323	19815522	95199
EUR_57	0	EUR	21737927	21914523	176596
EUR_57	0	EUR	23472367	23528102	55735
EUR_57	0	EUR	23958200	24070707	112507
EUR_57	0	EUR	27563461	27803948	240487
EUR_57	0	EUR	28447913	28473925	26012
EUR_57	0	EUR	28909134	28912719	3585
EUR_57	0	EUR	30085525	30116933	31408
EUR_57	0	EUR	30528228	30590405	62177
EUR_57	0	EUR	31869080	31976562	107482
EUR_57	0	EUR	32453173	32511362	58189
EUR_57	0	EUR	43298198	43340494	42296
EUR_57	0	EUR	43750662	43771347	20685
EUR_57	0	EUR	45023383	45093802	70419
EUR_57	0	EUR	45980594	46044606	64012
EUR_57	0	EUR	46135355	46167330	31975
EUR_57	0	EUR	46345940	46424629	78689
EUR_57	0	EUR	46603480	46692826	89346
EUR_57	0	EUR	47672056	47744901	72845
EUR_57	0	EUR	48065016	48237148	172132
EUR_57	0	EUR	48777473	48788773	11300
EUR_57	0	EUR	48957046	48987944	30898
EUR_57	0	EUR	49105400	49121767	16367
EUR_57	0	EUR	50069146	50467501	398355
EUR_57	0	EUR	50654897	50675343	20446
EUR_57	0	EUR	53261159	53302464	41305
EUR_57	0	EUR	61922896	62298109	375213
EUR_57	0	EUR	62626144	62710548	84404
EUR_57	0	EUR	64695270	64713211	17941
EUR_57	0	EUR	64779628	64816918	37290
EUR_57	0	EUR	64928378	64968332	39954
EUR_57	0	EUR	67469783	67497679	27896
EUR_57	0	EUR	67536791	67558609	21818
EUR_57	0	EUR	67640204	67659453	19249
EUR_57	0	EUR	67731956	67788309	56353
EUR_57	0	EUR	67792851	67816606	23755
EUR_57	0	EUR	67947267	68008460	61193
EUR_57	0	EUR	68065343	68234683	169340
EUR_57	0	EUR	74165046	74332051	167005
EUR_57	0	EUR	79724839	79803495	78656
EUR_57	0	EUR	81863285	81877251	13966
EUR_57	0	EUR	84174413	84347352	172939
EUR_57	0	EUR	84385265	84501788	116523
EUR_57	0	EUR	88992283	89057856	65573
EUR_57	0	EUR	96677706	96831567	153861
EUR_57	0	EUR	97226584	97235404	8820
EUR_57	0	EUR	0	38454	38454
EUR_57	0	EUR	2310091	2311679	1588
EUR_57	0	EUR	7801499	8034150	232651
EUR_57	0	EUR	10162900	10299389	136489
EUR_57	0	EUR	10310816	10371329	60513
EUR_57	0	EUR	10547168	10559629	12461
EUR_57	0	EUR	12382157	12442704	60547
EUR_57	0	EUR	12471707	12641459	169752
EUR_57	0	EUR	14713216	14884113	170897
EUR_57	0	EUR	15697742	15701244	3502
EUR_57	0	EUR	19445931	19447994	2063
EUR_57	0	EUR	21282427	21582697	300270
EUR_57	0	EUR	24664847	24693848	29001
EUR_57	0	EUR	25625985	25637091	11106
EUR_57	0	EUR	28447913	28454759	6846
EUR_57	0	EUR	28909134	28912719	3585
EUR_57	0	EUR	29400124	29403219	3095
EUR_57	0	EUR	29885100	30020785	135685
EUR_57	0	EUR	30909748	31020966	111218
EUR_57	0	EUR	31102656	31134052	31396
EUR_57	0	EUR	31349043	31354726	5683
EUR_57	0	EUR	33352525	33353174	649
EUR_57	0	EUR	41310351	41386596	76245
EUR_57	0	EUR	45980594	46058398	77804
EUR_57	0	EUR	46150248	46222689	72441
EUR_57	0	EUR	48098055	48124160	26105
EUR_57	0	EUR	48273976	48291671	17695
EUR_57	0	EUR	48988140	49229729	241589
EUR_57	0	EUR	49807803	49877351	69548
EUR_57	0	EUR	50214714	50340188	125474
EUR_57	0	EUR	50618884	50652765	33881
EUR_57	0	EUR	53185452	53248662	63210
EUR_57	0	EUR	55697610	55704084	6474
EUR_57	0	EUR	55891681	55921875	30194
EUR_57	0	EUR	60582515	60623780	41265
EUR_57	0	EUR	62342962	62428484	85522
EUR_57	0	EUR	62529233	62546944	17711
EUR_57	0	EUR	63156537	63227147	70610
EUR_57	0	EUR	63371917	63397067	25150
EUR_57	0	EUR	64786335	64809344	23009
EUR_57	0	EUR	67053456	67160970	107514
EUR_57	0	EUR	68501694	68528735	27041
EUR_57	0	EUR	69253738	69280158	26420
EUR_57	0	EUR	72313374	72338979	25605
EUR_57	0	EUR	80438129	80466548	28419
EUR_57	0	EUR	86466315	86466441	126
EUR_57	0	EUR	93177388	93227052	49664
EUR_57	0	EUR	93343223	93437672	94449
EUR_57	0	EUR	95127554	95236450	108896
EUR_57	0	EUR	95701360	95770835	69475
EUR_57	0	EUR	96719722	96818450	98728
EUR_57	0	EUR	97199338	97229460	30122
EUR_57	0	EUR	97566177	97575825	9648
EUR_58	0	EUR	1443312	1474375	31063
EUR_58	0	EUR	2267390	2436497	169107
EUR_58	0	EUR	5738269	5741613	3344
EUR_58	0	EUR	8022793	8069680	46887
EUR_58	0	EUR	10195098	10229013	33915
EUR_58	0	EUR	10477119	10539676	62557
EUR_58	0	EUR	12517970	12571424	53454
EUR_58	0	EUR	14713216	14731414	18198
EUR_58	0	EUR	15896526	15959302	62776
EUR_58	0	EUR	16309874	16392692	82818
EUR_58	0	EUR	17270851	17280159	9308
EUR_58	0	EUR	19445931	19447994	2063
EUR_58	0	EUR	21406424	21549180	142756
EUR_58	0	EUR	23507155	23562645	55490
EUR_58	0	EUR	23793798	23810060	16262
EUR_58	0	EUR	28447913	28496302	48389
EUR_58	0	EUR	29378628	29403219	24591
EUR_58	0	EUR	29981453	29997960	16507
EUR_58	0	EUR	30528228	30561025	32797
EUR_58	0	EUR	31188077	31225571	37494
EUR_58	0	EUR	31340450	31464998	124548
EUR_58	0	EUR	31877961	31976562	98601
EUR_58	0	EUR	35825437	35904356	78919
EUR_58	0	EUR	43751615	43813419	61804
EUR_58	0	EUR	45023383	45084731	61348
EUR_58	0	EUR	45980594	46067124	86530
EUR_58	0	EUR	46202917	46277139	74222
EUR_58	0	EUR	46664058	46672190	8132
EUR_58	0	EUR	47610552	47611006	454
EUR_58	0	EUR	48836469	48852598	16129
EUR_58	0	EUR	49105400	49211922	106522
EUR_58	0	EUR	49860747	50031530	170783
EUR_58	0	EUR	50079988	50086485	6497
EUR_58	0	EUR	50215570	50270346	54776
EUR_58	0	EUR	50283074	50289602	6528
EUR_58	0	EUR	50446207	50474545	28338
EUR_58	0	EUR	50474678	50560553	85875
EUR_58	0	EUR	50644699	50682125	37426
EUR_58	0	EUR	56606415	56623847	17432
EUR_58	0	EUR	56981282	57026186	44904
EUR_58	0	EUR	60552837	60609459	56622
EUR_58	0	EUR	62358424	62360148	1724
EUR_58	0	EUR	62384821	62405059	20238
EUR_58	0	EUR	62516312	62546166	29854
EUR_58	0	EUR	64690778	64713211	22433
EUR_58	0	EUR	64779628	64968332	188704
EUR_58	0	EUR	67271768	67371632	99864
EUR_58	0	EUR	67720425	67747325	26900
EUR_58	0	EUR	67947267	68008460	61193
EUR_58	0	EUR	68146842	68164991	18149
EUR_58	0	EUR	72313374	72338979	25605
EUR_58	0	EUR	74609427	74656895	47468
EUR_58	0	EUR	77940158	77981834	41676
EUR_58	0	EUR	79714947	79772869	57922
EUR_58	0	EUR	80817797	80831869	14072
EUR_58	0	EUR	87069518	87192258	122740
EUR_58	0	EUR	93177388	93208473	31085
EUR_58	0	EUR	96344658	96403383	58725
EUR_58	0	EUR	96599275	96660713	61438
EUR_58	0	EUR	96950026	96969240	19214
EUR_58	0	EUR	97295440	97321820	26380
EUR_58	0	EUR	5633934	5741613	107679
EUR_58	0	EUR	7801499	8020825	219326
EUR_58	0	EUR	10195098	10229013	33915
EUR_58	0	EUR	12436919	12518164	81245
EUR_58	0	EUR	12541608	12571424	29816
EUR_58	0	EUR	14713216	14731414	18198
EUR_58	0	EUR	15697742	15701244	3502
EUR_58	0	EUR	15701864	15740215	38351
EUR_58	0	EUR	17029181	17031678	2497
EUR_58	0	EUR	17318810	17323735	4925
EUR_58	0	EUR	21218489	21258286	39797
EUR_58	0	EUR	21346331	21582697	236366
EUR_58	0	EUR	21935834	21965772	29938
EUR_58	0	EUR	23480055	23525224	45169
EUR_58	0	EUR	23678834	23696381	17547
EUR_58	0	EUR	26915868	27028137	112269
EUR_58	0	EUR	29380470	29403219	22749
EUR_58	0	EUR	29755007	29767219	12212
EUR_58	0	EUR	31321108	31349680	28572
EUR_58	0	EUR	35866099	35904356	38257
EUR_58	0	EUR	43273165	43340494	67329
EUR_58	0	EUR	43800917	43813419	12502
EUR_58	0	EUR	46043417	46069871	26454
EUR_58	0	EUR	46821026	46878762	57736
EUR_58	0	EUR	47688826	47761411	72585
EUR_58	0	EUR	47965639	48089703	124064
EUR_58	0	EUR	48793399	48804986	11587
EUR_58	0	EUR	48952912	48960159	7247
EUR_58	0	EUR	49480075	49645607	165532
EUR_58	0	EUR	49966488	49995130	28642
EUR_58	0	EUR	50215570	50270346	54776
EUR_58	0	EUR	50283074	50289602	6528
EUR_58	0	EUR	50446207	50480411	34204
EUR_58	0	EUR	50659811	50684992	25181
EUR_58	0	EUR	54360569	54422822	62253
EUR_58	0	EUR	54570395	54580607	10212
EUR_58	0	EUR	56642327	56661029	18702
EUR_58	0	EUR	59025323	59087449	62126
EUR_58	0	EUR	60401729	60501936	100207
EUR_58	0	EUR	62298928	62360303	61375
EUR_58	0	EUR	63354466	63436101	81635
EUR_58	0	EUR	66942688	67022791	80103
EUR_58	0	EUR	67043600	67128290	84690
EUR_58	0	EUR	67648499	67659453	10954
EUR_58	0	EUR	68055902	68056789	887
EUR_58	0	EUR	68533102	68564643	31541
EUR_58	0	EUR	69283668	69315282	31614
EUR_58	0	EUR	70090968	70140681	49713
EUR_58	0	EUR	70178120	70180545	2425
EUR_58	0	EUR	71108569	71231131	122562
EUR_58	0	EUR	74185839	74195965	10126
EUR_58	0	EUR	74609427	74689986	80559
EUR_58	0	EUR	74695445	74723577	28132
EUR_58	0	EUR	76219599	76336677	117078
EUR_58	0	EUR	76736930	76763688	26758
EUR_58	0	EUR	79508567	79533168	24601
EUR_58	0	EUR	80351527	80355866	4339
EUR_58	0	EUR	80817797	80831869	14072
EUR_58	0	EUR	81329834	81357575	27741
EUR_58	0	EUR	84074915	84095270	20355
EUR_58	0	EUR	84193471	84272292	78821
EUR_58	0	EUR	84307433	84457650	150217
EUR_58	0	EUR	84483013	84508973	25960
EUR_58	0	EUR	88020002	88073004	53002
EUR_58	0	EUR	92657968	92893775	235807
EUR_58	0	EUR	96628171	96660713	32542
EUR_58	0	EUR	96938041	96985749	47708
EUR_58	0	EUR	97561435	97606042	44607
EUR_59	0	EUR	1658	38454	36796
EUR_59	0	EUR	2403879	2436497	32618
EUR_59	0	EUR	5623952	5720427	96475
EUR_59	0	EUR	7801499	7820138	18639
EUR_59	0	EUR	14599834	14699483	99649
EUR_59	0	EUR	15571100	15608201	37101
EUR_59	0	EUR	16960554	17021252	60698
EUR_59	0	EUR	19395138	19439044	43906
EUR_59	0	EUR	21168069	21168829	760
EUR_59	0	EUR	21179486	21230787	51301
EUR_59	0	EUR	21282427	21309916	27489
EUR_59	0	EUR	21476031	21565644	89613
EUR_59	0	EUR	21712454	21732547	20093
EUR_59	0	EUR	21737927	21739071	1144
EUR_59	0	EUR	21751783	21877833	126050
EUR_59	0	EUR	21935834	21965772	29938
EUR_59	0	EUR	23923937	24061376	137439
EUR_59	0	EUR	24655151	24693848	38697
EUR_59	0	EUR	28447913	28454759	6846
EUR_59	0	EUR	29750374	29765658	15284
EUR_59	0	EUR	31062988	31134052	71064
EUR_59	0	EUR	31190087	31216844	26757
EUR_59	0	EUR	31254911	31267996	13085
EUR_59	0	EUR	31340450	31398944	58494
EUR_59	0	EUR	31967174	31976562	9388
EUR_59	0	EUR	41082532	41103899	21367
EUR_59	0	EUR	43273165	43340494	67329
EUR_59	0	EUR	45064382	45093802	29420
EUR_59	0	EUR	45248451	45295441	46990
EUR_59	0	EUR	48988140	49057058	68918
EUR_59	0	EUR	49197898	49211922	14024
EUR_59	0	EUR	50079988	50148912	68924
EUR_59	0	EUR	50244656	50300721	56065
EUR_59	0	EUR	50505922	50514335	8413
EUR_59	0	EUR	50618884	50682125	63241
EUR_59	0	EUR	56642327	56661029	18702
EUR_59	0	EUR	60314986	60363981	48995
EUR_59	0	EUR	60675915	60681059	5144
EUR_59	0	EUR	60697771	60715320	17549
EUR_59	0	EUR	62145966	62212401	66435
EUR_59	0	EUR	62427365	62482787	55422
EUR_59	0	EUR	62516312	62546166	29854
EUR_59	0	EUR	64831271	64853959	22688
EUR_59	0	EUR	66827940	66897711	69771
EUR_59	0	EUR	68124552	68219989	95437
EUR_59	0	EUR	68511938	68556045	44107
EUR_59	0	EUR	69976346	70054764	78418
EUR_59	0	EUR	71343782	71387487	43705
EUR_59	0	EUR	72313374	72338979	25605
EUR_59	0	EUR	74269035	74332051	63016
EUR_59	0	EUR	75195082	75227717	32635
EUR_59	0	EUR	76321922	76350618	28696
EUR_59	0	EUR	78278359	78281355	2996
EUR_59	0	EUR	81329834	81397143	67309
EUR_59	0	EUR	82777601	82808198	30597
EUR_59	0	EUR	84120494	84134162	13668
EUR_59	0	EUR	84271016	84413705	142689
EUR_59	0	EUR	84762165	84809687	47522
EUR_59	0	EUR	86340983	86343443	2460
EUR_59	0	EUR	93177388	93227052	49664
EUR_59	0	EUR	93579639	93661778	82139
EUR_59	0	EUR	96629989	96795126	165137
EUR_59	0	EUR	96935175	96957114	21939
EUR_59	0	EUR	9913	16835	6922
EUR_59	0	EUR	257772	309123	51351
EUR_59	0	EUR	5693494	5720427	26933
EUR_59	0	EUR	5865668	5877135	11467
EUR_59	0	EUR	8040668	8074467	33799
EUR_59	0	EUR	12436919	12518164	81245
EUR_59	0	EUR	12541608	12571424	29816
EUR_59	0	EUR	12838563	12870468	31905
EUR_59	0	EUR	15607322	15740215	132893
EUR_59	0	EUR	17002809	17115665	112856
EUR_59	0	EUR	19569358	19651006	81648
EUR_59	0	EUR	19794816	19815522	20706
EUR_59	0	EUR	21793054	21854646	61592
EUR_59	0	EUR	21935834	21958294	22460
EUR_59	0	EUR	23507155	23562645	55490
EUR_59	0	EUR	23639213	23696381	57168
EUR_59	0	EUR	23995828	24019885	24057
EUR_59	0	EUR	24690259	24693848	3589
EUR_59	0	EUR	26941318	27027989	86671
EUR_59	0	EUR	28447913	28459172	11259
EUR_59	0	EUR	29750374	29765658	15284
EUR_59	0	EUR	31062988	31134052	71064
EUR_59	0	EUR	31190087	31216844	26757
EUR_59	0	EUR	31254911	31267996	13085
EUR_59	0	EUR	31340450	31464998	124548
EUR_59	0	EUR	32482310	32532337	50027
EUR_59	0	EUR	43321108	43337414	16306
EUR_59	0	EUR	43726568	43749060	22492
EUR_59	0	EUR	45065607	45093802	28195
EUR_59	0	EUR	46204155	46222689	18534
EUR_59	0	EUR	47573262	47611006	37744
EUR_59	0	EUR	48793399	48804986	11587
EUR_59	0	EUR	48948395	48955905	7510
EUR_59	0	EUR	48980390	48992275	11885
EUR_59	0	EUR	49056296	49084376	28080
EUR_59	0	EUR	49108894	49211922	103028
EUR_59	0	EUR	50079988	50086485	6497
EUR_59	0	EUR	50215570	50231640	16070
EUR_59	0	EUR	50244656	50300721	56065
EUR_59	0	EUR	50505922	50514335	8413
EUR_59	0	EUR	50654897	50675343	20446
EUR_59	0	EUR	51721135	51826252	105117
EUR_59	0	EUR	56660894	56661029	135
EUR_59	0	EUR	56998012	57026186	28174
EUR_59	0	EUR	59052228	59087449	35221
EUR_59	0	EUR	60314986	60367440	52454
EUR_59	0	EUR	60391758	60473482	81724
EUR_59	0	EUR	62363965	62421852	57887
EUR_59	0	EUR	62489657	62534250	44593
EUR_59	0	EUR	62735597	62763590	27993
EUR_59	0	EUR	64786335	64809344	23009
EUR_59	0	EUR	67993239	68056363	63124
EUR_59	0	EUR	69253738	69280158	26420
EUR_59	0	EUR	71121594	71294859	173265
EUR_59	0	EUR	74270667	74332051	61384
EUR_59	0	EUR	74634499	74635401	902
EUR_59	0	EUR	74651141	74789545	138404
EUR_59	0	EUR	76255850	76508147	252297
EUR_59	0	EUR	79724839	79803495	78656
EUR_59	0	EUR	82777601	82866809	89208
EUR_59	0	EUR	84051369	84087948	36579
EUR_59	0	EUR	84454434	84508973	54539
EUR_59	0	EUR	86183232	86262769	79537
EUR_59	0	EUR	88067512	88235236	167724
EUR_59	0	EUR	89233989	89360109	126120
EUR_59	0	EUR	93210081	93231856	21775
EUR_59	0	EUR	93673610	93686534	12924
EUR_59	0	EUR	95594113	95706836	112723
EUR_59	0	EUR	96229657	96276332	46675
EUR_59	0	EUR	96344658	96551349	206691
EUR_59	0	EUR	96628171	96660713	32542
EUR_59	0	EUR	96934735	96969240	34505
EUR_59	0	EUR	97149005	97170445	21440
EUR_59	0	EUR	97368034	97434688	66654
EUR_59	0	EUR	97516792	97606042	89250
EUR_60	0	EUR	1658	38454	36796
EUR_60	0	EUR	149110	218251	69141
EUR_60	0	EUR	4152972	4155031	2059
EUR_60	0	EUR	7801499	7815019	13520
EUR_60	0	EUR	7965531	7986929	21398
EUR_60	0	EUR	12438062	12482114	44052
EUR_60	0	EUR	14599834	14699483	99649
EUR_60	0	EUR	15607322	15640899	33577
EUR_60	0	EUR	19205162	19218710	13548
EUR_60	0	EUR	19375630	19454354	78724
EUR_60	0	EUR	19519830	19573587	53757
EUR_60	0	EUR	21562696	21649200	86504
EUR_60	0	EUR	21793054	21854646	61592
EUR_60	0	EUR	21935834	21958294	22460
EUR_60	0	EUR	23626899	23638658	11759
EUR_60	0	EUR	23874190	23901362	27172
EUR_60	0	EUR	27563461	27637833	74372
EUR_60	0	EUR	28447913	28496302	48389
EUR_60	0	EUR	29871842	29884548	12706
EUR_60	0	EUR	29981453	30020785	39332
EUR_60	0	EUR	30942828	30969476	26648
EUR_60	0	EUR	31321108	31349680	28572
EUR_60	0	EUR	41082532	41134854	52322
EUR_60	0	EUR	41698837	41768904	70067
EUR_60	0	EUR	43750662	43813419	62757
EUR_60	0	EUR	44915345	45007478	92133
EUR_60	0	EUR	46617726	46628408	10682
EUR_60	0	EUR	47874821	48095137	220316
EUR_60	0	EUR	48793399	48804986	11587
EUR_60	0	EUR	48980390	48992275	11885
EUR_60	0	EUR	49107941	49211922	103981
EUR_60	0	EUR	49693701	49737279	43578
EUR_60	0	EUR	49884766	49940575	55809
EUR_60	0	EUR	53307869	53387076	79207
EUR_60	0	EUR	60314986	60406009	91023
EUR_60	0	EUR	60522994	60623780	100786
EUR_60	0	EUR	60697771	60715320	17549
EUR_60	0	EUR	61977382	62000629	23247
EUR_60	0	EUR	63010595	63041174	30579
EUR_60	0	EUR	63177292	63277354	100062
EUR_60	0	EUR	64689850	64713211	23361
EUR_60	0	EUR	64779628	64968332	188704
EUR_60	0	EUR	67796826	67821788	24962
EUR_60	0	EUR	69228939	69230695	1756
EUR_60	0	EUR	71197734	71260612	62878
EUR_60	0	EUR	73164377	73165766	1389
EUR_60	0	EUR	74270667	74332051	61384
EUR_60	0	EUR	74634499	74635401	902
EUR_60	0	EUR	74661597	74663374	1777
EUR_60	0	EUR	78026183	78031382	5199
EUR_60	0	EUR	79759746	79763512	3766
EUR_60	0	EUR	82712051	82718602	6551
EUR_60	0	EUR	82850211	82867077	16866
EUR_60	0	EUR	84307433	84331408	23975
EUR_60	0	EUR	84779402	84797472	18070
EUR_60	0	EUR	86464439	86466441	2002
EUR_60	0	EUR	93210081	93293706	83625
EUR_60	0	EUR	96938041	96970993	32952
EUR_60	0	EUR	97670105	97695638	25533
EUR_60	0	EUR	1312802	1474375	161573
EUR_60	0	EUR	2267390	2417674	150284
EUR_60	0	EUR	5633934	5741613	107679
EUR_60	0	EUR	7974775	8034150	59375
EUR_60	0	EUR	10504963	10525722	20759
EUR_60	0	EUR	11806694	11836160	29466
EUR_60	0	EUR	12195294	12394574	199280
EUR_60	0	EUR	12517970	12541493	23523
EUR_60	0	EUR	13943659	14014184	70525
EUR_60	0	EUR	15675475	15740215	64740
EUR_60	0	EUR	16289550	16444740	155190
EUR_60	0	EUR	19445931	19447994	2063
EUR_60	0	EUR	23697124	23828153	131029
EUR_60	0	EUR	27595814	27803948	208134
EUR_60	0	EUR	28447913	28473925	26012
EUR_60	0	EUR	28909134	28912719	3585
EUR_60	0	EUR	30953172	30988149	34977
EUR_60	0	EUR	31118464	31136194	17730
EUR_60	0	EUR	31340450	31370213	29763
EUR_60	0	EUR	40952583	41034990	82407
EUR_60	0	EUR	43300726	43340494	39768
EUR_60	0	EUR	43751615	43808041	56426
EUR_60	0	EUR	45980594	46044606	64012
EUR_60	0	EUR	46135355	46167330	31975
EUR_60	0	EUR	46345940	46424629	78689
EUR_60	0	EUR	46603480	46692826	89346
EUR_60	0	EUR	46958473	46998835	40362
EUR_60	0	EUR	48806513	48831623	25110
EUR_60	0	EUR	49039217	49084376	45159
EUR_60	0	EUR	49091260	49211922	120662
EUR_60	0	EUR	49455843	49460677	4834
EUR_60	0	EUR	49488939	49645607	156668
EUR_60	0	EUR	50079988	50086485	6497
EUR_60	0	EUR	50215570	50231640	16070
EUR_60	0	EUR	50244656	50300721	56065
EUR_60	0	EUR	50505922	50514335	8413
EUR_60	0	EUR	50654897	50675343	20446
EUR_60	0	EUR	54327238	54429543	102305
EUR_60	0	EUR	54447874	54485919	38045
EUR_60	0	EUR	60314986	60366947	51961
EUR_60	0	EUR	60567912	60623780	55868
EUR_60	0	EUR	62427707	62455504	27797
EUR_60	0	EUR	63010595	63041174	30579
EUR_60	0	EUR	64690778	64713211	22433
EUR_60	0	EUR	64779628	64885947	106319
EUR_60	0	EUR	66900632	66900890	258
EUR_60	0	EUR	67099623	67113280	13657
EUR_60	0	EUR	69225884	69257859	31975
EUR_60	0	EUR	70314329	70323506	9177
EUR_60	0	EUR	71466177	71480877	14700
EUR_60	0	EUR	74070851	74114411	43560
EUR_60	0	EUR	74609427	74656895	47468
EUR_60	0	EUR	74733587	74756907	23320
EUR_60	0	EUR	80903139	80904640	1501
EUR_60	0	EUR	80947447	80965346	17899
EUR_60	0	EUR	82859836	82901545	41709
EUR_60	0	EUR	84174413	84347352	172939
EUR_60	0	EUR	84385265	84501788	116523
EUR_60	0	EUR	86999163	87004998	5835
EUR_60	0	EUR	96215188	96313082	97894
EUR_60	0	EUR	96935175	96957114	21939
